player,mu,sigma,wins,losses,sets
superboomfan,51.7104035184,1.39365336541,106,4,110
wario,46.8011037125,2.77164036346,10,1,11
alvin,46.5172936672,1.99406059553,17,3,20
mariguas,45.7060630612,1.50499384488,41,10,51
isai,45.669063451,1.77882884358,27,6,33
tr3gthez,44.9675699979,1.36110389332,45,13,58
wangera,44.6470838933,2.06238191453,16,5,21
tacos,44.3159669395,1.52065544352,39,12,51
wizzrobe,43.8638683578,1.26046599431,54,15,69
stranded,43.843941638,1.75191278917,26,6,32
kerokeroppi,43.6923204534,1.2334432249,61,19,80
dext3r,43.5632871654,1.62657479065,28,9,37
revan,42.3775426196,1.24232923032,53,17,70
kurabba,42.0987178707,2.93076791952,7,2,9
barksanchez,41.8025845568,1.51095927038,30,12,42
prince,41.1225279802,2.98295454567,7,2,9
fox,40.5677329846,1.99079645936,17,7,24
dtan,39.91981855,2.17108562754,14,5,19
zantetsu,39.8527674818,2.48207244336,13,4,17
bark the shark,39.6407336444,1.42373471163,39,15,54
fireblaster,39.6024753459,1.1172625427,68,26,94
banze,39.1874486014,2.4245784114,11,5,16
kort,39.1771161909,2.32133655785,11,6,17
derek #squats,39.003851609,1.45732088033,25,11,36
jaimehr,38.9518726932,1.84611145233,21,9,30
firo,38.8987029292,1.95367631333,15,8,23
star king,38.692479494,2.28316954387,11,6,17
vinsanity,38.255477341,3.36436188716,6,2,8
marbles,38.1318334418,1.77212479901,23,9,32
hero pie,38.1145653459,2.32976665887,11,6,17
lowww,38.096822507,3.22544505059,7,2,9
combo blaze,38.0727462327,1.84407542306,20,10,30
nta,38.0305202567,2.28047928149,11,5,16
zero,37.9280052412,2.34388620207,11,6,17
shalaka,37.873322751,2.47336377945,10,6,16
ybombb,37.6703459776,1.98923366172,19,9,28
bonobono,37.6507588221,3.26552157921,5,2,7
heropie,37.5746972022,2.39222598441,12,4,16
handsometom,36.9743433339,1.76932566394,19,11,30
nacl,36.9578262047,2.34841153337,12,6,18
lord narwhal,36.9074998934,1.99490092218,14,9,23
nintendude,36.8459134892,1.42644378611,29,19,48
$$$ jim $$$,36.7495460812,2.17453633563,12,5,17
mojomonkey,36.7050642007,3.22501756668,6,2,8
cobr,36.6588106883,1.98043173187,15,8,23
kimimaru,36.6476942215,2.40084041993,13,5,18
kyle tree,36.6451201131,2.58502043343,9,5,14
shears,36.5464808497,1.19198613864,50,28,78
sotoh,36.2297814026,1.95230404512,18,9,27
janco,36.0338983994,2.02163555008,14,11,25
near,35.8498770122,3.02497758911,7,3,10
janitor,35.7493746487,1.80503919365,24,9,33
lorenzo,35.7354589841,2.04011424591,15,7,22
clubbadubba,35.5997930816,2.45877400461,9,6,15
sheermadness,35.5933529261,3.31983852226,5,2,7
wookiee,35.5379505378,1.94450447147,18,9,27
robert,35.2840252916,2.16206646915,15,7,22
fumbles,35.2664123588,3.14182311258,5,3,8
jason,35.173257275,1.87756404456,19,9,28
nothing,35.1727025149,2.23578060096,15,6,21
letsgo,35.0767939385,3.98332262498,3,3,6
amida,34.9656731388,2.24915884064,13,7,20
finio,34.8189861313,3.57863799976,5,2,7
hipstur,34.8144725989,1.76679069528,24,11,35
sextc,34.7919731146,1.84400095637,15,9,24
a$,34.7767748017,3.59474194312,4,2,6
b link,34.7644827835,2.00025133245,12,9,21
dajjal,34.642369467,2.01274593836,15,9,24
spark,34.1849499621,3.34677426187,5,2,7
kyle,34.1352692786,2.37541981288,9,6,15
saltsizzle,34.0105127437,2.18783984644,10,8,18
loto,34.0062240886,3.75401774972,4,2,6
monte,33.9836279271,3.26627792594,4,3,7
battlecow,33.7481752037,3.11170265713,5,3,8
jay-r,33.6986723234,3.67430439323,5,2,7
fishaman p,33.6793901814,2.43125478704,9,6,15
preston,33.6261391843,1.66281427623,20,15,35
satan [turner],33.5785760511,3.29370485743,4,3,7
sax,33.5424875665,3.13567059651,5,3,8
darkhorse,33.5392550393,1.85813526758,18,12,30
the big d,33.535068922,2.3942307915,12,6,18
facechew,33.5159474865,3.93223341888,5,2,7
stonefallow,33.4885922943,3.3527050658,7,4,11
sunnyb,33.4665147887,3.27505920864,5,3,8
jay_mute$,33.4428482224,2.53418571138,9,5,14
zeppelin,33.4129709692,3.02943221735,5,3,8
bowl,33.3915280939,2.74739399969,8,5,13
dark gentleman,33.3470718973,2.89589833076,7,4,11
snorlax,33.3372507437,1.68870516308,18,14,32
fck vwls,33.2965252035,1.89809592536,14,14,28
pugs,33.2592129915,2.5227119409,8,5,13
poobearninja,33.2536349535,2.81585295972,9,4,13
jimmy joe,33.2217502554,1.81099232883,18,13,31
nesskhalifa,33.2005400454,2.2483348923,11,8,19
b0n,33.1779790456,2.3402699401,12,6,18
socrates,33.1370694633,2.60609697424,9,6,15
freean,33.1221192917,2.34933073047,12,7,19
yobolight,33.1079091761,2.40405528696,12,7,19
ivor,33.0560047466,2.4354482421,9,6,15
connor,33.0215930902,2.29900234677,12,7,19
box765,32.9054880188,3.17656260828,6,3,9
gravyfingers,32.8850387228,3.33464973493,4,3,7
smash jesus,32.8402073094,2.6953203166,10,4,14
sedda,32.8071483436,2.33453399661,11,7,18
the dark gentleman,32.7400244337,3.4874976041,4,3,7
nattybroh,32.7062450504,2.57074085317,9,4,13
hotline,32.6568442852,3.71631057603,4,2,6
madrush21,32.6480231311,1.55252559731,24,19,43
knitephox,32.5955887246,2.39356948166,10,7,17
dogg,32.5731391598,2.55598025188,8,6,14
eg,32.5546471681,2.23474122901,11,6,17
masterhandjob,32.5101354675,2.02167660816,15,11,26
yunque,32.3469447492,2.87365394258,6,5,11
mr.sir,32.2469788114,1.30974065995,34,26,60
dogs_johnson,32.2405867872,2.3872106147,11,7,18
cyoonit,32.1853768613,3.48883026286,4,3,7
rossi,32.1802476436,4.06898192551,3,2,5
josephzander,32.1649644631,3.27822155046,6,3,9
llcstoism,32.1317195775,2.55932421397,9,6,15
bard,32.1122468141,2.02038681565,16,9,25
mokkori,32.1114700357,3.91308839434,4,2,6
the protagonist,32.067825914,2.72250800441,7,6,13
tyhiggz,32.0406901145,2.33125667213,9,8,17
spongy,32.0113154061,2.6001583039,9,4,13
dfx,31.9926589768,1.90919161085,15,12,27
daniel,31.9585687739,2.31055515993,11,8,19
kaz,31.9196731766,2.8309625469,8,5,13
a to the z,31.8188309204,2.09774447654,11,10,21
d35,31.8088985172,1.96026415615,17,11,28
rith,31.7710413189,3.64186631047,4,3,7
bread,31.7241415153,2.63158741189,8,6,14
ctg,31.7176955364,2.1260931865,14,11,25
onski,31.6911943848,2.23951229967,15,10,25
scoback,31.6272855477,2.90248055928,6,6,12
eggmode,31.5634626243,2.32696099943,11,8,19
limesoda,31.5239937287,2.37717358931,9,7,16
tot,31.4564404974,3.01820822621,7,6,13
g0d,31.4506190385,4.47264732733,2,2,4
shanks,31.4261280276,2.89049232148,7,5,12
esid,31.4203829707,3.07945798212,6,3,9
natendo,31.3467436189,3.8250735603,4,2,6
studstill,31.3453191009,2.99406996,7,4,11
pete,31.2596994468,3.62257992679,4,3,7
se√±orhen10r,31.2010368412,3.46108022097,4,3,7
shihman,31.1578573453,1.9396811536,18,10,28
kirbstomper,31.0885176736,3.44632113396,5,4,9
bamster,31.0778483007,4.60518867746,3,2,5
piratetrips,31.0262189492,2.65454965103,8,4,12
v,30.9234997874,3.8028353107,4,2,6
waxy:joe,30.7970579001,2.88545254077,6,4,10
th3kuzinator,30.7811578962,2.98616020719,6,6,12
fancy,30.777785003,4.14446544852,3,2,5
supa,30.7648392859,2.43283249121,8,7,15
rusty,30.7336389366,2.36990905105,9,8,17
broly,30.7318611578,2.49324379426,9,6,15
xyk,30.6786988061,4.29092056412,4,2,6
gildo,30.5933788615,2.41361624543,12,6,18
purtle,30.5498824699,3.47652965661,3,3,6
captain l,30.4644663251,2.97692795313,6,6,12
b.i.,30.445861407,2.70331530497,7,4,11
elel,30.4215657473,3.17858633775,6,4,10
jxc,30.3614976485,3.69968756482,4,2,6
maliki,30.3605935399,2.58744598664,7,6,13
moogle,30.1767981464,4.27200437518,3,2,5
morino,30.1506617443,3.72732224827,3,3,6
chuck lubs,30.1247928969,4.4348265097,3,2,5
b33f,30.1152248454,2.4204551118,11,6,17
commander,30.0903503895,4.16362587737,3,2,5
bon,30.0804979987,2.98155879143,6,6,12
the american patriot,30.0060419557,4.2415889838,4,2,6
smurf,29.9358126186,1.94094549591,17,12,29
skyfire,29.9340563264,4.28980497948,3,2,5
greeno,29.9043216909,2.19661634188,13,8,21
gt,29.8744670104,1.69584511028,18,14,32
duffman,29.7741142713,4.32759443006,3,2,5
heny935,29.747188932,3.78751268999,4,2,6
mr. wang,29.7107399065,4.09964872741,4,2,6
subtle,29.6797614903,3.62909910354,5,5,10
umbra,29.6657513578,3.25173522248,6,4,10
mustard tiger,29.6204154263,3.3243447137,6,4,10
freddy cougar,29.6190154715,4.80369636988,3,2,5
whitejesus,29.5759371727,2.53165660458,6,8,14
korobeniki,29.5584770473,2.70077366151,7,8,15
darkneon,29.4985544498,4.29757594604,3,2,5
toro,29.4673459647,4.33897118409,3,2,5
elvis,29.4555529987,4.07815083408,4,2,6
travkid,29.4458157483,4.98927851621,1,1,2
tank,29.42965499,4.14507127951,2,3,5
p21/c,29.4294777648,2.60697092862,9,6,15
komotonoto,29.3725166892,3.12424303457,5,4,9
pewpewu,29.3702269524,3.31339503311,5,4,9
zyrg,29.3214552489,2.98961477749,6,4,10
pathall,29.308972806,4.64863868758,2,2,4
annex,29.3062469287,2.20836912806,12,9,21
dpb,29.301464693,4.54089378478,3,2,5
enneielle,29.2814608157,2.17769003262,9,9,18
bp,29.2574361344,3.60349394701,3,3,6
fudgeball,29.2414397986,3.80820128723,3,2,5
a la carte,29.2286575854,3.50381360165,5,4,9
dizzle,29.1178324078,2.81993857375,7,7,14
tonester,29.0435423767,3.48214256679,7,4,11
justin,29.0426893252,4.11306400048,3,2,5
jamjar,28.9727583052,2.0635656256,16,14,30
sebula4,28.9023810355,4.36434305545,3,2,5
jam,28.8601759784,2.50145083593,6,9,15
touque,28.8545878899,4.23069820177,3,2,5
professor_wizard,28.8249536295,2.30052393805,9,7,16
ibc,28.777627178,3.33492019258,4,4,8
zuko,28.7579335693,2.24265265159,12,11,23
quickcav,28.7428179853,3.01255711911,6,3,9
iheartqueso,28.6691770787,3.67631521538,5,4,9
the (.)(.),28.6459603427,3.52717425325,3,3,6
kelvinheit,28.6438902468,2.39687676412,9,7,16
phut,28.6168777725,3.9989661326,3,3,6
peasantloaf,28.5581490294,4.23333842567,3,2,5
vudujin,28.5358925715,4.51236308597,3,2,5
captain fabulous,28.5259264187,2.00637939665,12,14,26
toronto joe,28.5159878507,4.46472143658,3,2,5
tvdonk,28.5159878507,4.46472143658,3,2,5
cmull,28.4225583851,3.20177131954,4,4,8
coin chaser,28.3398804873,4.41338713391,3,2,5
kabal,28.3246175391,3.82277180882,4,3,7
tafokints,28.3195828096,5.26100664541,2,1,3
scratch,28.2608006333,2.26528187181,8,11,19
thrillhouse,28.2408931665,3.03506915857,5,4,9
killahertz,28.2252999537,2.9395187859,7,6,13
dragoniota,28.2167689426,4.41112725804,3,2,5
blaise,28.2055181803,4.52219949795,3,2,5
marlwolfe,28.1892558898,2.19323964125,9,9,18
q!,28.1795105279,2.09549464929,11,13,24
autobaun,28.1529055021,4.53845634446,3,2,5
miniohh!,28.1482746492,4.74853701292,2,2,4
nattyb,28.1340321176,4.41412338,3,2,5
spamus,28.1192118618,4.54159624094,2,2,4
handles,28.1062279701,2.54154428481,9,6,15
batterybird,28.0646892936,4.53376969681,3,2,5
mr. slimey,28.0373529268,4.69518764727,2,2,4
pizza,27.953683731,2.41105671578,10,10,20
no~m,27.9361005125,2.75438601431,9,6,15
1000,27.9254909398,3.36821793042,9,6,15
horbie,27.9138739191,4.03796491632,3,3,6
daniels,27.904363884,1.85191776449,17,15,32
t brett,27.9038671926,3.45191302306,5,4,9
bigbeaver,27.8858921022,1.81854820151,13,15,28
shyboy,27.8855005042,4.52522270394,3,2,5
xor,27.8477909423,4.54391781032,3,2,5
starchild,27.8331064643,2.67373919865,9,6,15
meerkat,27.8153438524,2.26572339547,9,10,19
tbq,27.7121606744,3.1776848213,5,4,9
dr. lampy,27.7012340579,4.3858154803,3,2,5
kraines,27.699637938,4.73802636933,3,1,4
zbl_mystic,27.6631041329,4.70623537305,3,2,5
giraphe,27.639581377,4.34572772,3,2,5
rizner,27.6181119649,2.42243750276,10,9,19
zergos,27.5864731702,2.92439817227,9,6,15
sheick,27.560447432,4.57676738624,3,2,5
stonehaus,27.5430321008,4.55246260635,3,2,5
grahamaglam,27.5281999337,2.66514074648,5,6,11
t0mmii,27.5268971516,4.50511998972,3,2,5
stevie g$üëåüëåüëåüëåüëåüëåüëåüëå,27.4572173509,5.05325565079,2,2,4
elated,27.4355004211,3.16977274572,6,4,10
boomalready1,27.4338144052,3.43537607437,5,4,9
dubs,27.4289482146,2.95639097794,7,5,12
king lumsy,27.418245167,4.5754327375,3,2,5
mando,27.4060611412,3.10377819327,4,6,10
kingkool,27.3741879199,4.51626367599,3,2,5
wincancel,27.3540797686,3.0450763727,6,6,12
ern,27.3334373546,4.52651953183,3,2,5
dount,27.2785343939,3.85885516945,3,3,6
shishkabobs5,27.2326031408,5.00032712262,2,2,4
razz,27.202235941,2.84009146465,6,6,12
breakthrough,27.1618806592,4.70796929188,2,2,4
wazzberry,27.1536110551,4.72588493458,3,2,5
vanillarin,27.0361198682,2.62069113787,9,8,17
blondekid,26.9924098797,4.35755839457,3,3,6
vanddar,26.9855379943,4.89754342669,2,2,4
pluto,26.9787226361,4.68441234521,2,2,4
aisengobay,26.9702761305,4.32629775484,2,2,4
drewgong,26.9602743253,3.29946872242,4,6,10
nasian,26.9370625526,4.20539063643,2,2,4
white,26.9291959779,2.64907609217,6,9,15
gaijilla,26.8736402356,5.2649564721,2,2,4
mr.watchandlearn,26.8444761175,5.1399503369,2,2,4
kaladin,26.8193794291,4.85733180033,2,2,4
bunz,26.8036918773,4.75346859704,2,2,4
village mascot,26.7929490268,2.39080574632,8,9,17
sonicfuzz,26.7877842203,3.14082481264,8,6,14
rgood,26.7536597029,4.4073946799,3,2,5
barron,26.7476278258,4.88747466006,2,2,4
deathcpo,26.7467367359,2.64523790334,7,7,14
moonshoe,26.7368806227,3.10141244655,5,4,9
hotahota,26.7321026989,4.42131328712,3,2,5
hypa,26.6816382247,4.66585667073,2,2,4
synth,26.6172088673,4.33607340791,2,2,4
droc,26.6102769011,4.82342193526,2,2,4
neth,26.5913639896,3.07304243609,6,6,12
k-nut,26.5561845406,3.80031097908,4,3,7
hhhhhhhhhhhhhhh,26.5287302238,4.8977151627,2,2,4
lookalike,26.5051808211,3.57644160317,4,4,8
spunker,26.4968506048,5.39996179118,1,2,3
duncs,26.4404298313,2.60252622828,8,8,16
mmneggs,26.430301868,3.34250199126,2,6,8
beans,26.4058529365,2.58692411383,7,9,16
hariballz,26.3992994859,3.37425910747,4,4,8
mistertizye,26.3501929944,4.37056611862,1,2,3
notlightningrunner,26.3052248951,4.25446835385,3,2,5
thissidedown,26.229930095,5.24317585284,1,2,3
pandemonium,26.202037118,4.47583908036,2,2,4
whuck,26.1788721339,3.79308635956,3,3,6
jc_chill,26.1657816519,4.53095069877,2,2,4
dusttin,26.161861276,2.82523630125,7,7,14
sandman,26.1362804608,4.62754522802,3,2,5
bacorn,26.1074342669,2.24889260664,10,12,22
cwic-beam,26.0949588561,2.67479135518,8,8,16
jsmirk,26.0943375225,2.85798307988,6,7,13
purple fox,26.0922316313,4.68189431557,2,2,4
reptar,26.0589247219,3.6778450728,4,4,8
bringdaruckus312,26.0585891092,4.93971246405,2,2,4
leavescat,26.0109321783,3.48886699953,4,4,8
poptartplug,25.9477188032,5.02533654522,2,2,4
7blanks,25.934125801,3.95263836732,3,3,6
bflakes,25.9163695424,4.48265698201,2,2,4
stark,25.901915598,4.63543834479,2,2,4
imdabes,25.8391116057,4.92746511244,2,2,4
spaghetti,25.7735697639,4.02913069357,2,3,5
moosh_da_moosh,25.7431022309,4.82317890765,2,2,4
bre,25.7349492464,4.60562823618,2,2,4
therapture_,25.7113062928,4.91600928402,2,2,4
hoofydough,25.7113062928,4.91600928402,2,2,4
mixxedvegetables,25.6809593844,4.72851595519,2,2,4
brny,25.6707802897,4.80813518088,2,2,4
salt,25.6678434192,3.2059090227,6,6,12
hoofy,25.6526088594,3.72880295965,4,4,8
yrn,25.6402583515,5.03302233421,1,2,3
kd3,25.6376666632,4.82702882106,2,2,4
goosewithsocks,25.5817947658,3.47425433027,2,4,6
qubit,25.5807008818,4.90407462887,2,2,4
blueman,25.561001228,3.18655377657,6,6,12
funkykong,25.5398938921,4.87632287103,2,2,4
capos,25.5398504506,2.43031109693,8,8,16
karlthemarx,25.5170909525,4.82004371416,2,2,4
kman,25.5120111883,5.15176625924,2,2,4
beguiler,25.4879888842,4.93887434678,2,2,4
tootmoses,25.4501639569,4.79855601461,2,2,4
sunflower,25.422175144,2.43546047209,8,11,19
z-rex,25.4160816139,5.77661270191,1,2,3
snowstorm,25.3934923152,4.93156978565,2,2,4
dankestdad,25.3934923152,4.93156978565,2,2,4
geekliftus,25.3934923152,4.93156978565,2,2,4
zhu,25.3889699467,5.08796094963,1,2,3
gamer4life,25.3313054204,4.74160906926,2,2,4
rythemretrn,25.3104630178,2.95457803438,6,6,12
kristoff,25.291760386,2.75634084853,6,8,14
swiftbass,25.2622368269,4.89216411198,2,2,4
klms,25.2540556461,4.9265753216,2,2,4
wowzers,25.2437136137,4.68685155708,2,2,4
cyan can,25.2420067743,4.83238090016,2,2,4
tauvalian,25.2420048651,4.89068256503,2,2,4
yass2queen,25.2380514589,5.60889632979,1,2,3
sun vulcan,25.2272295754,3.50426106102,4,4,8
cortese187,25.1935697975,3.0673092299,6,6,12
kaddy,25.1935464266,6.17369305993,1,1,2
jazzy jinx,25.1859806704,4.69769232408,2,2,4
moist,25.1501241142,4.84335647834,2,2,4
bottle opener guy,25.1395919037,4.88048177123,2,2,4
maniac379,25.1391080443,2.4117638002,7,11,18
dwreck,25.0918745664,5.05514075948,2,2,4
quitrage,25.0918745664,5.05514075948,2,2,4
apparition the ambassador,25.0287588445,2.26860505674,8,13,21
hayrow,25.0282756767,5.62746911502,1,2,3
jinjo,25.0281977457,5.37474552702,1,2,3
savior,25.0226412845,4.94438727798,2,2,4
mahie,25.0,8.33333333333,0,0,0
luka,24.962131765,3.38631719927,6,6,12
clefairy as mew,24.9612859904,4.8678161245,2,2,4
dezno,24.9542466833,6.26500222621,1,1,2
gato,24.9485914857,5.09950726202,1,2,3
collin the conqueror,24.9470442643,5.04933891529,2,2,4
pizzajokes,24.9470442643,5.04933891529,2,2,4
ngwn,24.853127997,5.69709158185,1,2,3
soulbroker,24.8226272215,4.78694436349,1,2,3
bonerstorm,24.8185774428,4.07470170292,3,3,6
j9d2,24.7918456344,4.36500508943,2,2,4
smashg0d,24.7898265298,5.51965307737,1,2,3
rawdog,24.7852843053,3.94609435295,3,3,6
h2o,24.7693668194,2.99263160714,6,6,12
prime,24.7276601343,2.44601248543,7,12,19
reese,24.7156006132,4.44726321122,2,2,4
costaricancool,24.7109304786,4.47492582702,2,3,5
logic,24.6832872387,5.02118010428,2,2,4
weedwack,24.677484977,4.7003546321,2,2,4
chicken,24.6622258125,2.64980591467,6,8,14
lldl,24.6408296169,4.92675042597,2,2,4
shake,24.632061035,3.22400962406,6,6,12
aces,24.6310450894,2.71265159261,6,10,16
tetsu0,24.6262993259,5.03796166079,2,2,4
nalgas,24.6083537309,4.09284507658,3,3,6
leaf fc,24.542814831,3.85644210104,3,4,7
fanboy,24.5158318759,5.71965181017,1,2,3
blue bear,24.5086320598,4.98700425871,2,2,4
satch,24.4819306349,5.0466665946,2,2,4
jlo,24.4788461412,4.23618089962,3,3,6
steamfriedasian,24.4582480014,5.06356359914,2,2,4
nuggzy,24.4517511005,4.68631702429,2,2,4
rocket,24.4134212455,3.35869801098,3,4,7
cagt,24.335738994,3.26313532649,4,5,9
bhol,24.3302189521,3.58389332104,3,4,7
han,24.3188992937,4.70763422455,2,2,4
jungle,24.2965993238,4.77557346742,2,2,4
butcher of bakersfield,24.2631282307,3.32928051955,4,5,9
frostbyte,24.2333661155,4.03168541742,3,4,7
paco,24.2230517301,2.8791699357,5,7,12
ocelot,24.1702426928,2.93481553889,4,8,12
waldo,24.1685852163,4.11372709721,2,3,5
hamburglar,24.1550871841,5.00463769789,2,2,4
little bill,24.1323287263,5.25476036577,1,2,3
fingerblast,24.1135201228,3.91384500813,3,3,6
lecceo,24.1110541172,4.9150888099,1,2,3
ravioli,24.0938144638,5.04758146343,2,2,4
mrpoo,24.0938144638,5.04758146343,2,2,4
truffleshuffle,24.0857535063,4.52055272159,2,3,5
frogman [charette],24.0673993662,5.72119732611,1,2,3
nich,24.051848558,5.03396569322,2,2,4
mr. biz,24.0325158375,5.05035439798,2,2,4
crazyk115,24.0236264376,4.58502916019,2,3,5
probers,24.0170930716,4.65908183593,2,2,4
kevine,24.0017500823,5.64096387295,1,2,3
hotsauce,23.9920880429,5.53089851051,1,2,3
sombrero,23.9311044655,5.34585268912,1,2,3
pokeiman_master,23.9230181265,5.35897660643,1,2,3
billbacon420,23.9182113525,5.67728798298,1,2,3
pochilin,23.913884547,3.92436656001,3,5,8
jaquarium,23.8986516109,5.19013016581,2,2,4
kriskringle,23.8985341592,4.44708424244,2,2,4
sebastian,23.8885902714,5.6272249848,1,2,3
rebel scum,23.8514175309,3.22637665669,4,5,9
lalo,23.8378412292,3.74800890797,3,4,7
dankey kang,23.8367041586,5.36114312866,1,2,3
pintoa,23.8325330672,3.68936003335,3,5,8
weirdy man,23.82333402,4.89076757683,2,2,4
cormander,23.7982704228,3.06085141573,4,7,11
zenaga,23.6995468826,5.51041351297,1,2,3
wal,23.6712234119,5.78652450812,1,2,3
yolochi,23.6569368072,5.73709256507,1,2,3
khakis,23.6064174759,2.85606700888,6,8,14
maps,23.5766818328,2.73362362029,4,8,12
train_town,23.4647443738,5.11424738884,1,2,3
nuro,23.4632583232,4.05222416114,3,3,6
macintosh,23.4267008724,4.38067783725,2,3,5
moze,23.4128335847,4.99336456923,1,2,3
cbones,23.4118466893,5.3741936705,1,2,3
sph,23.3803554407,4.50954608102,2,3,5
qapples,23.3665454411,5.36348527265,1,2,3
bodacious,23.352876492,4.02601646314,3,4,7
adrian,23.3232793074,3.16373875714,6,6,12
derstuk,23.3220658825,3.50213394487,4,6,10
 ô·¥è·¥Ö·¥Ä·¥Ñ…™·¥è·¥ús,23.3118546517,3.40843525516,2,6,8
daddy's milk,23.2938575747,3.53288280537,4,5,9
kzidek,23.2863119817,5.35136986949,1,2,3
birdlordmasterbeak,23.2702484149,5.51423154169,1,2,3
qtip,23.1910720358,5.96847661703,1,1,2
ardent rage,23.1356590704,5.34723184218,1,2,3
highlyeducational,23.1230966872,4.83378241111,1,2,3
lucky_hamburger,23.1092298546,5.22545555971,1,2,3
-philip coast philip-,23.0884343049,5.19054268343,1,2,3
elitescoringguy,23.0843212923,3.60903203072,3,5,8
masquerade,23.0815344789,5.51632806959,1,2,3
hiv+,23.0810959537,5.25158556308,1,2,3
prism,23.08102187,5.7565063532,1,2,3
keagsbsmashin,23.0543397161,2.96475560626,6,6,12
cuppajoe,23.02482811,3.98943471156,3,4,7
brotherly,22.972908425,5.22754461773,1,2,3
maaron,22.9572305343,5.22840872562,1,2,3
slartibartfast42,22.9398519011,4.0176712361,3,4,7
icactusdog,22.9374497553,2.99920037802,4,9,13
xanz,22.8990129641,5.11642038207,1,2,3
the amazing busterino,22.8926262715,4.97058004014,2,2,4
gera,22.8571289183,5.36765458914,1,2,3
nigel_thornberry,22.8539770509,5.25544613076,1,2,3
big d [hamiel],22.8470048959,5.21813092743,1,2,3
v-bomber,22.8346027366,3.94477700004,3,4,7
littlespoon,22.7931450025,5.44754183403,1,2,3
precookedbread,22.7806286309,5.29131673702,1,2,3
hsf,22.7794083236,5.27172626087,1,2,3
boh,22.7537792016,5.25427043161,1,2,3
blahguy,22.7500395176,5.60834644142,1,2,3
myninja,22.7163269767,3.7834020777,2,4,6
blackf00t,22.7080967111,4.30529310428,2,4,6
paco [larkin],22.6968882364,5.51846737646,1,2,3
changed man,22.6867102224,5.67101579923,1,2,3
cooljoe,22.6802801661,5.236808055,1,2,3
ondas,22.6740704138,3.5164804014,3,5,8
miken,22.6678574677,7.1633429549,0,1,1
zibba,22.6173969986,5.39195617113,1,2,3
dimension,22.6098200907,5.48554280672,1,2,3
dasit mane,22.5626727981,3.91024469391,2,5,7
schlag,22.5591096649,5.64858483375,1,2,3
jmabate,22.5458647751,3.14516116105,3,6,9
robnu,22.5169761884,4.40814489241,2,4,6
walkrofsky,22.4445642931,3.6826379929,2,4,6
damp,22.4350196777,4.27659079116,2,3,5
banana fiend,22.4029054514,4.97439431407,1,2,3
silentknight,22.3963231402,4.53845669734,1,4,5
dankpank,22.3959662992,3.09409696258,4,7,11
tmakk,22.3675843646,2.95662859721,5,8,13
midgetto,22.3518370078,3.91924159839,3,4,7
mortech,22.3484309671,3.81263599327,3,5,8
xiivi,22.3195834508,3.11350719059,5,7,12
chiefreaper,22.3061587368,5.36519924366,1,2,3
yakal,22.2950630033,5.45881954507,1,2,3
dr. grin,22.2950630033,5.45881954507,1,2,3
superkirby,22.2628403412,5.37999956699,1,2,3
shasta,22.1955803154,5.07941061826,1,2,3
stew,22.1859555575,3.35312472311,4,5,9
boogie!,22.1626309484,3.55121615963,3,5,8
capsui,22.1598170777,5.53610295583,1,2,3
elmustachio,22.1428206537,5.28728445604,1,2,3
castaway,22.1135108422,5.63313169905,1,2,3
firefly,22.0832446758,5.52720444839,1,2,3
flare,22.0738376453,5.55336859451,1,2,3
hbrw-hammer,22.0696857207,5.17684579369,1,2,3
zarc,22.0377862324,5.36833885926,1,2,3
squible,22.0239874865,3.518494933,3,4,7
r.o.m.,22.0128787597,5.554682334,1,2,3
spt,22.0052203535,5.52903520153,1,2,3
sadu,21.9559792197,5.59457975533,1,2,3
zad,21.9070704181,3.40279419871,3,7,10
chai,21.8985480648,7.01618057864,0,1,1
malkasaur,21.8970233354,7.00839318003,0,1,1
scruffy mcwonder crumpet,21.8759699486,5.34615935173,1,2,3
blisstex,21.8642622165,4.34920945869,2,4,6
mr_sharpie93,21.8403664208,5.36966362332,1,2,3
mulkster,21.7904849304,5.33558898091,1,2,3
evals,21.7327747782,3.49409295776,3,6,9
trevman,21.7074057939,5.17842140613,1,2,3
burnt out ninja,21.6867950646,5.49425252058,1,2,3
fawnco,21.6867950646,5.49425252058,1,2,3
hungrybox,21.6860773411,5.47985703048,1,2,3
leet,21.6651871705,5.53367073128,1,2,3
jaws,21.6304666756,5.16163626235,1,2,3
evab,21.5855008588,5.46498187956,1,2,3
mourin,21.5575334011,3.68268955306,3,6,9
yaron,21.5487917808,3.73260058213,1,6,7
maestro,21.5424663615,5.48103394783,1,2,3
zombie!,21.5047657545,5.52858492613,1,2,3
jirachinick,21.5047657545,5.52858492613,1,2,3
k-man,21.5047657545,5.52858492613,1,2,3
dhir,21.5047657545,5.52858492613,1,2,3
zwephy,21.5047657545,5.52858492613,1,2,3
eggmcmuffin888,21.5047657545,5.52858492613,1,2,3
nathansandwich,21.5047657545,5.52858492613,1,2,3
kossismoss,21.5047657545,5.52858492613,1,2,3
giraffe,21.5047657545,5.52858492613,1,2,3
anathema,21.5047657545,5.52858492613,1,2,3
drlight,21.5047657545,5.52858492613,1,2,3
gumbolaya!,21.4928983443,5.12659455688,1,2,3
thenuge,21.4917968153,3.54688837843,3,5,8
godspeed,21.4138774868,3.07775550878,4,7,11
drewskii55,21.4121457178,5.11850231436,1,2,3
dirtcruncher,21.4119047871,3.04774989486,4,8,12
vidya_james,21.4033184027,3.56555664202,3,6,9
bubby,21.3970332671,5.36171151221,1,2,3
rhubarb,21.3751432365,2.9792779151,4,8,12
izoo,21.3750476551,3.69601443785,3,6,9
arctic,21.3680768984,3.70531585155,3,6,9
esuma,21.3511290771,5.46780250884,1,2,3
pastor,21.3422581477,5.51129103904,1,2,3
napkins,21.3422581477,5.51129103904,1,2,3
myroknpancakes,21.3422581477,5.51129103904,1,2,3
chaos pro,21.3422581477,5.51129103904,1,2,3
heartsdealer,21.3422581477,5.51129103904,1,2,3
barrels,21.3037609218,3.0930523393,3,8,11
krypto,21.2558467058,4.43464169964,2,4,6
astumpycow,21.2447548091,5.41810096423,1,3,4
throwz?!,21.2159587192,5.15868220368,1,2,3
pzero39,21.2014942235,5.34825217268,1,2,3
chinstrap,21.1039973139,4.07731458866,2,4,6
ir,21.1021121028,3.54283482857,3,6,9
andy,21.070209472,5.51002169606,1,2,3
kavon,21.070209472,5.51002169606,1,2,3
nyx,21.070209472,5.51002169606,1,2,3
flatline,21.070209472,5.51002169606,1,2,3
15(ichigo),21.070209472,5.51002169606,1,2,3
iceking,21.0424773365,4.44061291576,2,4,6
sunshinetk,20.9652073312,4.27054499001,2,4,6
hotpocket,20.9485239209,5.52816440754,1,2,3
massimo,20.9371756287,5.15625974543,1,3,4
hipo,20.866582837,5.25073016534,1,2,3
snazzy,20.7904753738,5.43576157592,1,2,3
jollie,20.7853788135,3.79242951067,2,5,7
java boy,20.7057800576,5.49053736546,1,2,3
kingcool,20.6918259832,3.44795830949,3,6,9
redribb0n,20.6905799049,6.83924500234,0,1,1
yungpurp,20.684464169,6.65120622593,0,1,1
shyguyking,20.6729036879,3.74204294521,3,5,8
ego,20.6640845455,3.72676223878,3,6,9
bohemian milk,20.6537113152,5.33473118741,1,2,3
god,20.60416798,7.17147558733,0,1,1
yung,20.60416798,7.17147558733,0,1,1
bunmira,20.60416798,7.17147558733,0,1,1
the cfb,20.60416798,7.17147558733,0,1,1
akito555,20.60416798,7.17147558733,0,1,1
masterofzoroark,20.60416798,7.17147558733,0,1,1
akajumo,20.60416798,7.17147558733,0,1,1
uprowr,20.60416798,7.17147558733,0,1,1
dishier wand,20.60416798,7.17147558733,0,1,1
4sk,20.60416798,7.17147558733,0,1,1
neverpullout,20.60416798,7.17147558733,0,1,1
ragingcherry,20.60416798,7.17147558733,0,1,1
nfreak,20.60416798,7.17147558733,0,1,1
garv,20.60416798,7.17147558733,0,1,1
branchan,20.60416798,7.17147558733,0,1,1
adubz,20.60416798,7.17147558733,0,1,1
big tone,20.60416798,7.17147558733,0,1,1
patty-wagon,20.5876097381,6.78784393705,0,1,1
spaff,20.5610555606,6.47389141057,0,2,2
krutchby,20.5043728215,5.46331845492,1,2,3
flat nat,20.5034894816,6.94591406318,0,1,1
schmerka berl,20.5014891461,3.52979007802,3,8,11
bronze_sun,20.4938607321,6.92549349541,0,1,1
eliot,20.453370898,3.63718068538,2,7,9
tdp,20.391878954,5.2318583381,1,2,3
astumpyzombie,20.3838379998,4.43942693556,1,4,5
cardoso,20.378259761,3.73771603983,3,6,9
mattatari,20.3728408526,5.23299737103,1,2,3
homemadewaffles,20.3612733202,6.92690169084,0,1,1
imperium,20.3612733202,6.92690169084,0,1,1
fil,20.3612733202,6.92690169084,0,1,1
rice,20.3612733202,6.92690169084,0,1,1
mojo,20.2444324023,4.3995150807,2,3,5
pika,20.2404399247,4.54487743774,1,4,5
swankeaboo,20.2402561334,5.20156078642,1,2,3
danno,20.2401166603,5.2691944166,1,2,3
spell,20.1469440433,6.85953951868,0,1,1
hans_mawell,20.1279428502,6.89704561133,0,1,1
stephanie,20.1279428502,6.89704561133,0,1,1
i use tap jump,20.1279428502,6.89704561133,0,1,1
weatherman,20.1244141944,4.83231838453,1,4,5
the professor,20.1094622962,3.46544354897,3,7,10
et,19.9865723905,6.74398184354,0,1,1
woof,19.9737613742,3.51713695387,2,7,9
dmolz,19.9229931655,3.97462759666,1,6,7
lou sanus,19.9125369939,3.87008656036,1,6,7
yolft,19.8876566816,3.63863598291,2,6,8
nami,19.8726186176,6.69818244663,0,2,2
brambramjam,19.8191933376,4.77366265566,1,3,4
depressed eagle,19.7821090704,4.60868179082,1,4,5
husker,19.7046616717,4.27653352742,1,5,6
elu,19.6656260261,3.96584390619,2,6,8
taiko,19.6469858276,3.28968760579,3,8,11
bogmyer,19.6396088713,4.36497762512,1,4,5
the drew,19.6308698314,3.08520659909,3,8,11
grrg,19.6037144755,2.9694858011,4,10,14
tallyshell,19.5933648235,4.78673609463,1,3,4
luwolf,19.5855079222,6.20795705331,0,2,2
jedipanda,19.5690668748,4.31933588913,1,5,6
general1712,19.5654287531,4.74959417034,1,5,6
multiball,19.4739068198,3.24592710128,3,8,11
jose,19.3900010576,6.56882410874,0,1,1
shug,19.3150091162,4.58958327365,1,4,5
missingn0,19.245468504,6.11521213932,0,2,2
bear,19.2372076042,4.23429858317,1,4,5
nagurnimaster,19.2343577323,6.23400172038,0,2,2
twunt,19.1729037293,4.68531232901,1,4,5
jad,19.1626714233,6.43674265554,0,2,2
mariokartmoney,19.1263628643,4.93003836048,1,4,5
magnus combosen,19.1094838087,4.77481021436,1,4,5
kobra,19.0906594211,4.89608178096,1,4,5
mello,19.0556900497,6.61249886872,0,2,2
kevorkian,19.0373198859,3.95115743557,2,6,8
esmod,19.0176497094,6.51974552938,0,2,2
maximum can,18.9967716023,6.29853518768,0,2,2
milleneum,18.9915504985,4.29512948533,1,4,5
sabo,18.9895447961,6.83048033888,0,1,1
jedisalazar,18.9473738327,6.41962051679,0,2,2
scootieloo,18.9157091146,6.08967430513,0,2,2
jackmehoff,18.8851326495,6.02708671302,0,2,2
refriedjeans,18.8775515834,6.8141203941,0,1,1
jgin,18.8577838007,5.96798294913,0,2,2
whoopiecow,18.8414486628,3.54679273315,3,6,9
stdangerous,18.8406171389,6.22979084872,0,2,2
brendanhall,18.7970867362,6.54992705426,0,1,1
pugdaddyfre$hlyfeogg*flva,18.794269799,6.35024058644,0,2,2
moustasher,18.7569743007,3.40216173783,3,7,10
pilot,18.7550467167,6.63971746947,0,1,1
spicky,18.683665227,6.78798900948,0,1,1
pidgezero_one,18.6073421431,3.4953607329,2,7,9
tbone,18.5774730416,6.29260400231,0,2,2
kl3an,18.5588529466,6.38820575423,0,2,2
lukem,18.5506348171,6.71127333949,0,1,1
broonz,18.4990766458,3.72585632916,2,6,8
hotspank,18.4720523429,3.45220009591,3,6,9
youtwo,18.4585701402,6.47051486517,0,2,2
lloyd-black,18.4444995546,3.37331498197,2,8,10
bus,18.4033731809,6.21857036024,0,2,2
tydye,18.4017260176,6.39908449938,0,2,2
master jay,18.3790600321,6.39548886025,0,2,2
charlie harper,18.341005986,6.3852507322,0,2,2
nokto,18.335783984,6.20788613905,0,2,2
whitegrizzly,18.321642546,6.02218472055,0,2,2
quinceprince,18.32105969,6.2418644638,0,2,2
swerve,18.2269383987,6.35593574731,0,2,2
avian,18.2135081597,6.35266839978,0,2,2
putpasswordhere,18.208521352,4.78720455508,1,4,5
jdeezel,18.111353808,6.31953289734,0,2,2
tylenol jones,18.110103572,6.32861787932,0,2,2
instacover,18.0500741902,6.31453002242,0,2,2
izze,18.0428187692,6.46387437135,0,2,2
warmachine1919,18.0428187692,6.46387437135,0,2,2
fen,18.0280431471,4.35906342505,1,5,6
locamash,18.0183196563,6.3229292674,0,2,2
electricgazelle,18.0054623606,6.70491637149,0,1,1
turtle,17.9987963086,6.06520869122,0,2,2
drhino,17.9980023599,6.32119878345,0,2,2
snack?,17.9980023599,6.32119878345,0,2,2
jpoptosis,17.9980023599,6.32119878345,0,2,2
zarfon,17.9980023599,6.32119878345,0,2,2
phex,17.9980023599,6.32119878345,0,2,2
astropancakes,17.9980023599,6.32119878345,0,2,2
dennysgrandslambreakfast,17.9980023599,6.32119878345,0,2,2
big d squirrels,17.9980023599,6.32119878345,0,2,2
duckpimp,17.9980023599,6.32119878345,0,2,2
yam$,17.9980023599,6.32119878345,0,2,2
fry,17.9980023599,6.32119878345,0,2,2
fmax,17.9980023599,6.32119878345,0,2,2
akiva,17.9980023599,6.32119878345,0,2,2
laugh,17.9980023599,6.32119878345,0,2,2
lights,17.9816499173,6.29750892389,0,2,2
seantos,17.9648951682,3.65197532222,2,8,10
beaver,17.958835544,6.31200221875,0,2,2
wolfcry,17.9230213746,6.16381175236,0,2,2
alex,17.9195658899,6.27586139291,0,2,2
black rob,17.9115274115,6.28018259574,0,2,2
erk,17.9107525074,6.27770945867,0,2,2
pigwick,17.9085248734,5.83873928228,0,2,2
maxi,17.8471382488,6.27199149472,0,2,2
holosly,17.8405629898,6.27988339032,0,2,2
ebay,17.8359797122,6.26745356674,0,2,2
5000candlesinthewind,17.8270005524,6.29388615473,0,2,2
harmless,17.8270005524,6.29388615473,0,2,2
legoman,17.8270005524,6.29388615473,0,2,2
flash,17.8270005524,6.29388615473,0,2,2
jfm,17.8270005524,6.29388615473,0,2,2
oljace,17.8270005524,6.29388615473,0,2,2
jojohnson,17.8270005524,6.29388615473,0,2,2
armor,17.8270005524,6.29388615473,0,2,2
giggitoxin,17.8270005524,6.29388615473,0,2,2
mrryanness,17.8012990057,4.75126295633,1,4,5
zane,17.7546889757,6.37991001333,0,2,2
fs shampoomaster,17.6774015461,6.23226422632,0,2,2
liam_butler,17.6673384456,6.26628461383,0,2,2
matt47,17.6673384456,6.26628461383,0,2,2
frogge,17.6650802957,5.82977554578,0,2,2
oxycontin,17.6102672634,3.51628935149,2,6,8
uncle onion,17.6088232344,6.2344399148,0,2,2
xlax,17.5511609899,4.72964768438,1,4,5
gambit,17.5381058359,6.04022060431,0,2,2
blank,17.5157993115,5.9797827329,0,2,2
mechanicalmarine,17.4505874795,6.30645860531,0,2,2
magfmur,17.4412025514,5.99671252336,0,2,2
levity,17.4227481495,6.18855031691,0,2,2
tokaji,17.4183735531,3.38884940386,3,6,9
goomah,17.4129916516,6.18520774262,0,2,2
thegoat,17.4096777088,6.29959968662,0,2,2
amaya,17.367539317,6.28792502463,0,2,2
draxsel,17.358477432,6.16091093994,0,2,2
juan doe,17.3404381349,6.28087507417,0,2,2
sad,17.3380949431,6.2826186222,0,2,2
jerzilla,17.3178420049,6.08100101259,0,2,2
bozz,17.2550251036,6.269075413,0,2,2
fig,17.2321252263,4.24654840611,1,5,6
4 phri,17.2235887762,6.2635158315,0,2,2
puddn,17.2084788552,6.2591236046,0,2,2
master j.j.,17.1716911112,6.24522720772,0,2,2
marfslayer 3000,17.1573329149,6.26923433457,0,2,2
jobook,17.1539451157,6.24125860026,0,2,2
driftintheabyss,17.1230201462,6.24558798543,0,2,2
sianvar,17.0894053364,6.05344972626,0,2,2
lunchy,17.0699686222,6.08232004122,0,2,2
superduperfanofboom,17.0550131584,6.22449836909,0,2,2
russellsprouts,17.007664599,5.32846333968,0,4,4
lonk,17.0073866723,6.02726524418,0,2,2
sam,17.0019455012,5.88634539385,0,2,2
kayo,16.9813134888,6.21916743945,0,2,2
scraggus,16.9692373492,6.09909420682,0,2,2
caelan,16.9617885972,5.5103023105,0,3,3
rocktimus crime,16.9348974157,4.9171510152,0,5,5
redwolf,16.9341628101,5.7877824751,0,2,2
irish,16.9273178368,6.23983584333,0,2,2
miles,16.9273178368,6.23983584333,0,2,2
azzy,16.9273178368,6.23983584333,0,2,2
grunyan,16.9273178368,6.23983584333,0,2,2
monk,16.9273178368,6.23983584333,0,2,2
sambook,16.9273178368,6.23983584333,0,2,2
abc,16.9273178368,6.23983584333,0,2,2
gaymer,16.9273178368,6.23983584333,0,2,2
j,16.9273178368,6.23983584333,0,2,2
zurdo,16.9273178368,6.23983584333,0,2,2
bean,16.9273178368,6.23983584333,0,2,2
voidstar,16.9273178368,6.23983584333,0,2,2
yuxminato,16.9273178368,6.23983584333,0,2,2
grraffe,16.9273178368,6.23983584333,0,2,2
fs mook,16.9273178368,6.23983584333,0,2,2
hail_sagan,16.9273178368,6.23983584333,0,2,2
red,16.9273178368,6.23983584333,0,2,2
zombieheart84,16.9273178368,6.23983584333,0,2,2
aubfox,16.9273178368,6.23983584333,0,2,2
deku,16.9273178368,6.23983584333,0,2,2
waffles,16.9273178368,6.23983584333,0,2,2
paper tiger,16.9273178368,6.23983584333,0,2,2
mr.e [rohr],16.9273178368,6.23983584333,0,2,2
scuttlebug jamboree,16.9273178368,6.23983584333,0,2,2
riseup93,16.9273178368,6.23983584333,0,2,2
skubtard,16.9273178368,6.23983584333,0,2,2
thac0,16.9273178368,6.23983584333,0,2,2
shadow light master,16.9273178368,6.23983584333,0,2,2
benbook,16.9273178368,6.23983584333,0,2,2
atari,16.9273178368,6.23983584333,0,2,2
dd,16.9273178368,6.23983584333,0,2,2
heisenberg,16.9273178368,6.23983584333,0,2,2
muthaluva777,16.9273178368,6.23983584333,0,2,2
raxcity,16.9273178368,6.23983584333,0,2,2
sharktoast,16.9273178368,6.23983584333,0,2,2
d-tek,16.9273178368,6.23983584333,0,2,2
sleeh,16.9273178368,6.23983584333,0,2,2
whiz kid,16.9273178368,6.23983584333,0,2,2
ferrero64,16.9273178368,6.23983584333,0,2,2
blues,16.9273178368,6.23983584333,0,2,2
rickter_scale,16.9273178368,6.23983584333,0,2,2
themickeynick,16.9273178368,6.23983584333,0,2,2
edwin...,16.9273178368,6.23983584333,0,2,2
searcher,16.9273178368,6.23983584333,0,2,2
aperture,16.9273178368,6.23983584333,0,2,2
beekle,16.9273178368,6.23983584333,0,2,2
sfgman,16.9273178368,6.23983584333,0,2,2
kezzup,16.9273178368,6.23983584333,0,2,2
jazz,16.9273178368,6.23983584333,0,2,2
uh what,16.9273178368,6.23983584333,0,2,2
digital cannon,16.9273178368,6.23983584333,0,2,2
phalanx,16.9093882126,6.20923233147,0,2,2
m2cain,16.8971608593,6.21019865504,0,2,2
bunnyblast,16.8822801378,6.20385470448,0,2,2
mookie,16.850806745,6.18793626323,0,2,2
ham,16.8478103341,4.35188687456,1,6,7
rabizkoshik,16.8426869985,4.44375782152,1,5,6
darv,16.8172633686,6.2067889521,0,2,2
werewyatt,16.8065666371,4.02802351779,1,5,6
da bear,16.7851248289,6.06238612483,0,2,2
karl,16.6585237579,5.54721753999,0,3,3
scott,16.6001481067,6.15339317878,0,2,2
scaryman,16.5977043009,3.92569082806,1,6,7
mikeyg,16.5937644067,5.89073429109,0,2,2
dk dredd,16.5503723221,5.74320977261,0,2,2
bc_burns,16.5383659216,6.12783790491,0,2,2
curiousplaces,16.4946314178,5.98428371546,0,2,2
robslabgod,16.4487166061,5.61273683324,0,2,2
charlie,16.4090681063,5.78906980336,0,2,2
pvc,16.400476286,5.99329902216,0,2,2
fumofuu,16.3030542888,5.91672443964,0,2,2
dunos_,16.2878779255,5.97763085216,0,2,2
kraken,16.2658891577,5.86023295168,0,2,2
papa,16.2346404823,5.22533961494,0,4,4
juno,16.2311025997,5.97438046955,0,2,2
recneps,16.1900599607,4.01553596271,1,7,8
katiebug (sfk),16.1755080806,5.97577040854,0,2,2
yung god,16.0856347547,6.08379213154,0,2,2
turtlpower,15.9975782782,5.029634122,0,6,6
thedarkdreamer,15.8117426471,6.01673635797,0,2,2
bulldog,15.7875607058,6.01539646542,0,2,2
nyani,15.6516188915,5.45870487973,0,5,5
ohhhbreezy,15.6471233545,3.91289721399,1,6,7
guccipivotmaster4000,15.6305053744,4.96784580569,0,6,6
tweli,15.6023696662,5.97570740059,0,2,2
jet fuel,15.5882747204,3.83167293977,1,7,8
bennyboy98,15.499706068,5.82178901354,0,2,2
kohenbro,15.4047986868,4.99951426716,0,5,5
mike4real,15.392848689,5.62234627806,0,2,2
failcant,15.357851223,5.8152051293,0,2,2
sweaters,15.3576121017,6.06819483028,0,2,2
vondo,15.2158720067,4.51412293495,0,6,6
cr0ak,15.1875993065,5.90448236514,0,2,2
hyperbole,15.1648833,5.91820734303,0,2,2
thisisgettingold,15.115537955,5.93072884891,0,2,2
nikku,15.0675350673,5.86549289052,0,2,2
urpasmash,15.0548093947,4.92454797594,0,6,6
ryden hope,15.0465713965,5.70803561869,0,2,2
rf!,15.0378472619,5.38489161732,0,3,3
ppdmd,14.9247578391,5.84013101842,0,2,2
falln,14.9048821729,5.66955197427,0,2,2
adulix,14.894363068,5.00342255587,0,5,5
deep dimples,14.8883490421,4.54562518066,0,5,5
djltheescapade,14.7887887506,4.94113244058,0,5,5
neph_girl,14.7712848129,4.29416751341,0,7,7
tuna,14.568440935,4.855398277,0,6,6
sugaaku,14.4458284627,5.37156501497,0,4,4
elrond,14.3858775721,4.20942489716,0,7,7
dude,14.3709296667,5.26282076406,0,3,3
dr gibs,14.3420275196,4.69369080388,0,5,5
link,14.1665568654,5.7580728291,0,2,2
mjim,14.1531881934,4.47710195596,0,5,5
bung0o,14.1252618932,4.65746676774,0,6,6
duck chris,14.083241994,4.78132453937,0,6,6
cat,14.0798507803,4.75028887024,0,5,5
jpeghero,14.0029047341,3.73743955095,1,8,9
nardwell,13.950005536,2.79136609799,2,19,21
myk,13.8397278746,5.36213805829,0,4,4
jonnjonn,13.7952925049,4.66523378573,0,5,5
2%gay,13.776021098,4.99420580386,0,6,6
paul d,13.6466561774,5.22967484951,0,4,4
jeremy,13.5998797658,5.0743836646,0,4,4
nnaughtydogg,13.5520312879,4.35011817607,0,6,6
bagel,13.4852569161,4.52611290365,0,6,6
hero,13.4560783753,4.67460736994,0,6,6
starcutter,13.3757017308,4.55297607511,0,6,6
shwang,13.3686879443,4.6571491862,0,6,6
tehz,13.2923558452,4.7045726583,0,6,6
smashlopez64,13.1076499154,4.6928401233,0,6,6
sven stormbeard,12.9604799749,4.6649721875,0,6,6
blizz,12.9523229867,4.6484805035,0,6,6
qk shkz,12.9392346646,4.65877219452,0,6,6
blanco mano,12.8605561802,4.39699663883,0,6,6
golfclubninja,12.4484316181,4.60648792714,0,8,8
jimbot,12.378565999,4.42592111142,0,7,7
sunshine,12.2035392602,4.59474589588,0,6,6
ubll black mage,12.0949993278,4.51629440985,0,6,6
polarbair,11.2743836866,4.45773405347,0,6,6
theycallmechris,11.229167796,4.3882283786,0,6,6
umi,11.22494584,4.38749705927,0,6,6
colt,11.190655646,4.34997256497,0,6,6
