player,mu,sigma,wins,losses,sets
superboomfan,51.2293918766,1.44229593676,90,4,94
wario,46.8011037125,2.77164036346,10,1,11
alvin,46.422806753,2.00142651559,17,3,20
mariguas,45.6767956461,1.50018875442,41,10,51
isai,45.5880007326,1.7774895511,27,6,33
wangera,44.6933132177,2.0699006457,16,5,21
tr3gthez,44.6836307554,1.8710688394,23,6,29
wizzrobe,44.547920888,1.4068480305,44,11,55
tacos,44.1943979335,1.51732017881,39,12,51
stranded,43.7943878861,1.75312149383,26,6,32
dext3r,43.514079935,1.62522431455,28,9,37
kerokeroppi,43.5095850499,1.34808330181,49,15,64
revan,42.1030319304,1.40837455176,39,13,52
kurabba,42.0181566998,2.96538071527,7,2,9
barksanchez,41.7702858127,1.51455698761,30,12,42
prince,41.2099680307,2.99186989514,7,2,9
fox,40.5162859644,1.98705043528,17,7,24
zantetsu,39.9763854906,2.49312568186,13,4,17
dtan,39.9312050439,2.17447389198,14,5,19
fireblaster,39.8010713296,1.18573593484,60,22,82
bark the shark,39.7389677303,1.68977369069,29,11,40
derek #squats,39.4079960365,2.14268926473,11,5,16
banze,39.258988909,2.41941653538,11,5,16
kort,39.0952872089,2.31902818137,11,6,17
jaimehr,38.9430723955,1.84580638017,21,9,30
firo,38.9007072104,1.96418763705,15,8,23
star king,38.6938227513,2.29429656475,11,6,17
vinsanity,38.2518545617,3.36265415547,6,2,8
handsometom,38.2009155898,2.44836630082,11,5,16
marbles,38.1381501923,1.76697462921,23,9,32
hero pie,38.1280069773,2.32822853975,11,6,17
lowww,38.0481442601,3.21558367957,7,2,9
tr3g the z,38.0332987758,3.08423204428,6,3,9
combo blaze,37.995604034,1.84181822344,20,10,30
nta,37.952073591,2.29390259646,11,5,16
zero,37.946761388,2.34289634992,11,6,17
shalaka,37.9065361139,2.45095605417,10,6,16
heropie,37.6153143397,2.40285014916,12,4,16
bonobono,37.580013631,3.26494995285,5,2,7
shears,37.1103461733,1.261654084,46,22,68
nintendude,37.0230761203,1.64729430543,23,13,36
nacl,36.991690894,2.35058932591,12,6,18
lord narwhal,36.8709108171,1.99719047102,14,9,23
$$$ jim $$$,36.8569264176,2.19381210077,12,5,17
cobr,36.8114229095,2.00042100657,15,8,23
mojomonkey,36.7893332995,3.23657504263,6,2,8
kyle tree,36.7513708717,2.59447383249,9,5,14
kimimaru,36.7239640036,2.40078940378,13,5,18
sotoh,36.1768337245,1.95325572912,18,9,27
near,35.8652750654,3.02048458983,7,3,10
ybombb,35.7733680274,2.7111789761,9,5,14
janitor,35.7601412153,1.80370622242,24,9,33
clubbadubba,35.6912461195,2.46211849614,9,6,15
lorenzo,35.6650066672,2.04590445766,15,7,22
sheermadness,35.6047505786,3.31868141748,5,2,7
wookiee,35.5719379525,1.95222904535,18,9,27
janco,35.5584516088,2.74592785424,8,5,13
robert,35.3193620654,2.15867106787,15,7,22
jason,35.2879123505,1.87972239691,19,9,28
fumbles,35.2728942642,3.13888049762,5,3,8
nothing,35.1725102758,2.23682294709,15,6,21
letsgo,35.1046005807,3.95825476915,3,3,6
amida,34.9965769974,2.25154653987,13,7,20
hipstur,34.8422432161,1.76914871047,24,11,35
finio,34.742591721,3.56306148307,5,2,7
dajjal,34.6642672825,2.01264910255,15,9,24
a$,34.6407775672,3.59129913895,4,2,6
snorlax,34.2207546822,2.18705672928,12,8,20
spark,34.2070893978,3.34878669409,5,2,7
saltsizzle,34.074195702,2.20619414936,10,8,18
sextc,34.0603159236,3.22483747476,5,3,8
loto,34.0053996533,3.75393426893,4,2,6
monte,33.9176544296,3.26737062285,4,3,7
fishaman p,33.7469417392,2.43267449802,9,6,15
battlecow,33.7251822555,3.11683272692,5,3,8
sax,33.7238649029,3.1638936344,5,3,8
jay-r,33.6986723234,3.67430439323,5,2,7
b link,33.6868075429,3.41702516984,4,3,7
satan [turner],33.5912157029,3.29586468343,4,3,7
darkhorse,33.5456906286,1.85832419886,18,12,30
sunnyb,33.512155872,3.33062234688,5,3,8
facechew,33.4815165791,3.92673758562,5,2,7
stonefallow,33.4552934653,3.33882167874,7,4,11
zeppelin,33.4448691639,3.03435842737,5,3,8
jay_mute$,33.4346588226,2.55304235417,9,5,14
dark gentleman,33.4216194061,2.89348250017,7,4,11
pugs,33.303104838,2.51939066426,8,5,13
poobearninja,33.229408432,2.81945834431,9,4,13
jimmy joe,33.212402247,1.81452533756,18,13,31
bowl,33.1562348906,2.78538712506,8,5,13
yobolight,33.1473631798,2.40343149921,12,7,19
freean,33.1364947601,2.35032493601,12,7,19
preston,33.0552634901,2.10342903735,14,9,23
connor,33.0085889187,2.30200561731,12,7,19
box765,32.9856577031,3.18441782978,6,3,9
gravyfingers,32.8826968839,3.33461808583,4,3,7
sedda,32.8535016705,2.34276152797,11,7,18
smash jesus,32.8284611044,2.69677005526,10,4,14
the dark gentleman,32.7287014691,3.49374598767,4,3,7
nattybroh,32.6578134357,2.58174517091,9,4,13
madrush21,32.6546216213,1.55435091951,24,19,43
knitephox,32.6486646007,2.39986553587,10,7,17
dogg,32.6466496405,2.56084140636,8,6,14
hotline,32.604355019,3.71062526904,4,2,6
mr.sir,32.588439681,1.4688863821,28,20,48
the big d,32.5647297015,4.10768684903,4,2,6
masterhandjob,32.5360975642,2.02328435754,15,11,26
eg,32.3364843111,2.25358632034,11,6,17
yunque,32.3317883272,2.87207336161,6,5,11
dogs_johnson,32.306413818,2.39325698914,11,7,18
bard,32.2504976747,2.02509805335,16,9,25
kaz,32.2139484447,2.80815237184,8,5,13
josephzander,32.2128643847,3.27899055637,6,3,9
cyoonit,32.1891431199,3.49426852221,4,3,7
rossi,32.162980636,4.07442588108,3,2,5
tyhiggz,32.142307252,2.34089264036,9,8,17
llcstoism,32.1387104828,2.55260163174,9,6,15
mokkori,32.1114700357,3.91308839434,4,2,6
b0n,32.078710441,3.98036627094,4,2,6
socrates,32.0687813897,4.20159416395,3,2,5
the protagonist,32.0271116171,2.7352254313,7,6,13
spongy,32.0171590911,2.6008868387,9,4,13
dfx,31.9768184311,1.92284913861,15,12,27
daniel,31.9178297127,2.3144834245,11,8,19
scoback,31.8266265818,2.90869565085,6,6,12
d35,31.8038511194,1.96042071915,17,11,28
a to the z,31.788077222,2.09888612905,11,10,21
rith,31.7710413189,3.64186631047,4,3,7
bread,31.737442819,2.6316069585,8,6,14
ctg,31.7289905763,2.12737366029,14,11,25
eggmode,31.6062275232,2.33339827929,11,8,19
onski,31.586705407,2.24991431505,15,10,25
limesoda,31.5332198251,2.37707770851,9,7,16
g0d,31.4982458889,4.47999248726,2,2,4
natendo,31.476907084,3.84594956413,4,2,6
tot,31.4563954522,3.01820395232,7,6,13
shanks,31.4220361826,2.88949429079,7,5,12
esid,31.4206043186,3.07122043716,6,3,9
kyle,31.4139103813,4.04438002411,3,2,5
studstill,31.3308934161,2.99230826159,7,4,11
shihman,31.2646431517,1.92852974304,18,10,28
pete,31.2596994468,3.62257992679,4,3,7
se√±orhen10r,31.1902521971,3.46134161802,4,3,7
ivor,31.0638722446,3.96338747014,3,2,5
piratetrips,30.9983122244,2.65514731897,8,4,12
fck vwls,30.9862886534,2.61426616918,8,8,16
v,30.9282179819,3.80359468341,4,2,6
kirbstomper,30.9025993448,3.44236708071,5,4,9
th3kuzinator,30.8118079286,3.00351584426,6,6,12
waxy:joe,30.7895995492,2.88231809839,6,4,10
supa,30.770322414,2.44064899668,8,7,15
rusty,30.767958173,2.37295429245,9,8,17
bamster,30.7599987719,4.70739895842,3,2,5
heny935,30.6947936663,3.85760830246,4,2,6
fancy,30.6741825192,4.16381907732,3,2,5
purtle,30.614647568,3.48494693671,3,3,6
xyk,30.5968130679,4.27655384246,4,2,6
gildo,30.5672284576,2.41103304772,12,6,18
b.i.,30.5291045886,2.69818956655,7,4,11
captain l,30.4564431866,2.97782237768,6,6,12
maliki,30.4458689012,2.60123671878,7,6,13
elel,30.4208155268,3.17861409573,6,4,10
jxc,30.3188903536,3.69649258137,4,2,6
moogle,30.1832527688,4.27309142742,3,2,5
morino,30.1506617443,3.72732224827,3,3,6
bon,30.0916520948,2.98638475869,6,6,12
b33f,30.0909618167,2.42131773568,11,6,17
commander,30.0903978114,4.16362316732,3,2,5
nesskhalifa,30.0592521168,3.46063768488,5,4,9
chuck lubs,30.0494191833,4.42706222458,3,2,5
the american patriot,30.0005642251,4.24193886246,4,2,6
skyfire,29.9528054971,4.29290045732,3,2,5
smurf,29.9156006791,1.94639318451,17,12,29
gt,29.884827268,1.69644424191,18,14,32
greeno,29.864101076,2.19141171971,13,8,21
broly,29.8107162742,4.30923040572,3,2,5
duffman,29.7615830226,4.32623992122,3,2,5
subtle,29.7176882596,3.63198210115,5,5,10
mr. wang,29.7107399065,4.09964872741,4,2,6
umbra,29.6653170631,3.25168602252,6,4,10
korobeniki,29.6599141213,2.71549235438,7,8,15
freddy cougar,29.6190154715,4.80369636988,3,2,5
mustard tiger,29.6155549636,3.32380229543,6,4,10
whitejesus,29.5488130941,2.53248616554,6,8,14
darkneon,29.5365019367,4.3073172857,3,2,5
zyrg,29.4995017558,2.99623490288,6,4,10
elvis,29.4623674799,4.07744799896,4,2,6
toro,29.4593125068,4.337648463,3,2,5
travkid,29.4512028308,4.98913685818,1,1,2
tank,29.42965499,4.14507127951,2,3,5
quickcav,29.4140418001,3.08139865852,6,3,9
p21/c,29.4024463023,2.60741626272,9,6,15
komotonoto,29.3516021024,3.12184077348,5,4,9
annex,29.3191570722,2.20736939629,12,9,21
pewpewu,29.3030617798,3.31170724906,5,4,9
dpb,29.3016556221,4.54090564678,3,2,5
pathall,29.2962561936,4.64739026241,2,2,4
captain fabulous,29.2928098968,2.52662084415,8,8,16
bp,29.2549258027,3.60349525571,3,3,6
a la carte,29.2239589563,3.50225386633,5,4,9
dizzle,29.0728733477,2.8196916586,7,7,14
tonester,29.0420274064,3.47915375139,7,4,11
justin,29.0289813615,4.11234033085,3,2,5
fudgeball,29.0141234132,3.83210323447,3,2,5
jamjar,28.9993061089,2.0652845306,16,14,30
sebula4,28.8842672647,4.36409786902,3,2,5
touque,28.8588380035,4.23070732017,3,2,5
professor_wizard,28.7936252485,2.30321702438,9,7,16
ibc,28.7765456188,3.3349795067,4,4,8
zuko,28.7427716446,2.24308565095,12,11,23
iheartqueso,28.66837569,3.67561670436,5,4,9
1000,28.6446165202,4.96232019835,3,2,5
kelvinheit,28.6288172601,2.39541762858,9,7,16
the (.)(.),28.628498076,3.52700037096,3,3,6
phut,28.6116826065,3.99940000235,3,3,6
peasantloaf,28.5367363545,4.23416083238,3,2,5
vudujin,28.5358925715,4.51236308597,3,2,5
toronto joe,28.5159878507,4.46472143658,3,2,5
tvdonk,28.5159878507,4.46472143658,3,2,5
enneielle,28.407797227,3.8228297591,3,3,6
coin chaser,28.3398804873,4.41338713391,3,2,5
kabal,28.3246175391,3.82277180882,4,3,7
cmull,28.3094458385,3.19242290932,4,4,8
sunflower,28.2946942769,2.77442631522,6,7,13
marlwolfe,28.256038765,3.81013431879,3,3,6
thrillhouse,28.2515460415,3.03581833271,5,4,9
scratch,28.2479468624,2.26736968727,8,11,19
dragoniota,28.2167689426,4.41112725804,3,2,5
blaise,28.2055181803,4.52219949795,3,2,5
killahertz,28.19137529,2.93730523263,7,6,13
autobaun,28.1529055021,4.53845634446,3,2,5
nattyb,28.1340321176,4.41412338,3,2,5
spamus,28.0965348074,4.53710222038,2,2,4
handles,28.0917001979,2.54184381597,9,6,15
q!,28.0828762969,2.10151536401,11,13,24
batterybird,28.0646892936,4.53376969681,3,2,5
mr. slimey,28.0610795641,4.70397270799,2,2,4
pizza,28.0092529289,2.4063550974,10,10,20
horbie,27.9293627855,4.04337083903,3,3,6
t brett,27.9151040795,3.45339434221,5,4,9
bigbeaver,27.8972102458,1.81758776751,13,15,28
shyboy,27.8855005042,4.52522270394,3,2,5
tbq,27.8498352596,3.17356656265,5,4,9
xor,27.8477909423,4.54391781032,3,2,5
starchild,27.8267493243,2.67329495487,9,6,15
meerkat,27.7921057626,2.26635002638,9,10,19
cwic-beam,27.7631735102,3.7552050292,4,4,8
dr. lampy,27.7012340579,4.3858154803,3,2,5
kraines,27.699637938,4.73802636933,3,1,4
zbl_mystic,27.651687301,4.70392001086,3,2,5
rizner,27.6302919427,2.42615871301,10,9,19
giraphe,27.6269542257,4.34732774048,3,2,5
moonshoe,27.6006864611,3.18547872788,5,4,9
sheick,27.560447432,4.57676738624,3,2,5
miniohh!,27.5375455774,4.69717726742,2,2,4
no~m,27.5287408935,4.54448982974,3,2,5
t0mmii,27.5268971516,4.50511998972,3,2,5
stonehaus,27.5188185853,4.54952573603,3,2,5
tafokints,27.4431132349,5.24771854895,2,1,3
dubs,27.4288813335,2.95638767957,7,5,12
elated,27.4245254864,3.16984474971,6,4,10
king lumsy,27.418245167,4.5754327375,3,2,5
boomalready1,27.4103436122,3.43053874435,5,4,9
stevie g$üëåüëåüëåüëåüëåüëåüëåüëå,27.4099119317,5.03382280974,2,2,4
mando,27.4048565324,3.10868660514,4,6,10
kingkool,27.3741879199,4.51626367599,3,2,5
vanillarin,27.3521521582,3.56691852247,5,4,9
ern,27.3334373546,4.52651953183,3,2,5
razz,27.3155185858,2.84879274558,6,6,12
dount,27.3036538569,3.86254382882,3,3,6
jam,27.2604595159,4.17145944147,2,3,5
shishkabobs5,27.2335804711,5.00079689291,2,2,4
breakthrough,27.1619301196,4.70797608036,2,2,4
wazzberry,27.1536110551,4.72588493458,3,2,5
zergos,27.1269678944,4.66386416268,3,2,5
grahamaglam,27.0551838358,2.71003363381,5,6,11
vanddar,27.0268996773,4.91030356763,2,2,4
pluto,26.9902702865,4.68709511822,2,2,4
blondekid,26.9795453544,4.35773017278,3,3,6
drewgong,26.9784232741,3.30170817931,4,6,10
deathcpo,26.9770635366,2.62433915613,7,7,14
mr.watchandlearn,26.9147445445,5.14985090774,2,2,4
aisengobay,26.8992779577,4.33549229019,2,2,4
daniels,26.8841707244,2.30349883488,11,11,22
gaijilla,26.8550243442,5.24555362548,2,2,4
kaladin,26.8193794291,4.85733180033,2,2,4
sonicfuzz,26.7824993607,3.13875561024,8,6,14
barron,26.7803207614,4.90962716169,2,2,4
village mascot,26.7663121656,2.3893824665,8,9,17
rgood,26.7603794343,4.4084531791,3,2,5
hotahota,26.7321026989,4.42131328712,3,2,5
bunz,26.7170611289,4.74945097191,2,2,4
nasian,26.6984791405,4.24315367912,2,2,4
hypa,26.6916738247,4.66766050695,2,2,4
droc,26.6168366553,4.8244197971,2,2,4
synth,26.6158535604,4.33584648916,2,2,4
k-nut,26.5537255858,3.80008562138,4,3,7
spunker,26.5145125738,5.40628094017,1,2,3
lookalike,26.5108301161,3.57722133175,4,4,8
hhhhhhhhhhhhhhh,26.5011013958,4.89296867577,2,2,4
beans,26.4435037303,2.58841588065,7,9,16
hariballz,26.4358513111,3.37658039171,4,4,8
duncs,26.4231184464,2.59871495186,8,8,16
mistertizye,26.3626419335,4.3822815288,1,2,3
mmneggs,26.3445129759,3.35226904802,2,6,8
notlightningrunner,26.3052248951,4.25446835385,3,2,5
luka,26.2941117225,5.15669574491,2,2,4
white,26.2424899964,4.46351234283,2,3,5
pandemonium,26.2265049053,4.47828554476,2,2,4
thissidedown,26.2198881883,5.24110573749,1,2,3
bacorn,26.1939134287,2.25198503091,10,12,22
whuck,26.1896678791,3.79344987954,3,3,6
jc_chill,26.1657816519,4.53095069877,2,2,4
dusttin,26.1548995283,2.82435803534,7,7,14
sandman,26.1362804608,4.62754522802,3,2,5
leavescat,26.1265435212,3.5034818101,4,4,8
neth,26.1213675888,4.7806822114,2,2,4
jsmirk,26.0850104699,2.85825570417,6,7,13
purple fox,26.0826358421,4.68063097985,2,2,4
reptar,26.0587386467,3.67783084524,4,4,8
bringdaruckus312,26.0585891092,4.93971246405,2,2,4
spaghetti,26.0423958019,4.05694148923,2,3,5
rythemretrn,26.0177939388,4.92002604664,2,2,4
wincancel,25.9837040849,4.72723742945,2,2,4
poptartplug,25.9480674158,5.02543268409,2,2,4
7blanks,25.934125801,3.95263836732,3,3,6
bflakes,25.9163695424,4.48265698201,2,2,4
imdabes,25.8391116057,4.92746511244,2,2,4
bre,25.7321354149,4.60528889667,2,2,4
moosh_da_moosh,25.7313666845,4.82139778845,2,2,4
therapture_,25.7113062928,4.91600928402,2,2,4
hoofydough,25.7113062928,4.91600928402,2,2,4
mixxedvegetables,25.6809593844,4.72851595519,2,2,4
kd3,25.6720917415,4.83390306689,2,2,4
brny,25.6647022607,4.80791865852,2,2,4
hoofy,25.6522501531,3.72875224538,4,4,8
qubit,25.5807008818,4.90407462887,2,2,4
yrn,25.5537886468,5.07229787165,1,2,3
capos,25.5484096404,2.4299001354,8,8,16
funkykong,25.5326130833,4.87518534618,2,2,4
karlthemarx,25.5170909525,4.82004371416,2,2,4
kman,25.5120111883,5.15176625924,2,2,4
beguiler,25.4894652571,4.93982458685,2,2,4
tootmoses,25.450455786,4.79859512208,2,2,4
goosewithsocks,25.4452422501,3.50260356341,2,4,6
z-rex,25.4169987496,5.77723913049,1,2,3
geekliftus,25.3934923152,4.93156978565,2,2,4
snowstorm,25.3934923152,4.93156978565,2,2,4
dankestdad,25.3934923152,4.93156978565,2,2,4
reese,25.380170454,4.60178025652,2,2,4
stark,25.3531604313,4.58471520521,2,2,4
salt,25.3053977954,4.96499721356,2,2,4
blueman,25.2983107659,4.9639791191,2,2,4
h2o,25.2659073664,4.86007916983,2,2,4
swiftbass,25.2622368269,4.89216411198,2,2,4
klms,25.2540556461,4.9265753216,2,2,4
wowzers,25.2437136137,4.68685155708,2,2,4
cyan can,25.2420067743,4.83238090016,2,2,4
tauvalian,25.2420048651,4.89068256503,2,2,4
kristoff,25.240917547,2.76522113012,6,8,14
yass2queen,25.2084664708,5.60458524797,1,2,3
kaddy,25.1935464266,6.17369305993,1,1,2
jazzy jinx,25.1772394415,4.69638063498,2,2,4
moist,25.1501241142,4.84335647834,2,2,4
sun vulcan,25.14397372,3.50974176895,4,4,8
bottle opener guy,25.1395919037,4.88048177123,2,2,4
maniac379,25.1133888449,2.40875016626,7,11,18
quitrage,25.0918745664,5.05514075948,2,2,4
dwreck,25.0918745664,5.05514075948,2,2,4
apparition the ambassador,25.0503888326,2.27018180722,8,13,21
jinjo,25.0463891895,5.3782458148,1,2,3
hayrow,25.0290724109,5.62804872668,1,2,3
mahie,25.0,8.33333333333,0,0,0
cortese187,24.9849240387,4.81497526303,2,2,4
clefairy as mew,24.9612859904,4.8678161245,2,2,4
dezno,24.9542466833,6.26500222621,1,1,2
gato,24.9487627695,5.09953087366,1,2,3
pizzajokes,24.9470442643,5.04933891529,2,2,4
collin the conqueror,24.9470442643,5.04933891529,2,2,4
shake,24.8261577155,5.03571932629,2,2,4
soulbroker,24.8226272215,4.78694436349,1,2,3
bonerstorm,24.8185774428,4.07470170292,3,3,6
rawdog,24.8183057415,3.94975495085,3,3,6
j9d2,24.8061581083,4.367234251,2,2,4
gamer4life,24.7422888371,4.65893004419,2,2,4
ngwn,24.7400771525,5.68800775072,1,2,3
smashg0d,24.7241943197,5.49589277687,1,2,3
prime,24.6940129938,2.44365078492,7,12,19
zhu,24.6928600116,5.26457393881,1,2,3
logic,24.6832872387,5.02118010428,2,2,4
chicken,24.6786045747,2.65194680549,6,8,14
weedwack,24.677484977,4.7003546321,2,2,4
costaricancool,24.6656700982,4.46928107806,2,3,5
lldl,24.6408296169,4.92675042597,2,2,4
tetsu0,24.6262993259,5.03796166079,2,2,4
aces,24.6102644635,2.70976811836,6,10,16
nalgas,24.6011771315,4.09164421347,3,3,6
fanboy,24.5598042771,5.75385804859,1,2,3
leaf fc,24.542814831,3.85644210104,3,4,7
savior,24.5299713381,4.87200900025,2,2,4
blue bear,24.5087653862,4.98702512648,2,2,4
satch,24.4809063071,5.04650088228,2,2,4
jlo,24.4788461412,4.23618089962,3,3,6
steamfriedasian,24.4582480014,5.06356359914,2,2,4
nuggzy,24.4575444514,4.68584967656,2,2,4
rocket,24.3928191236,3.35941285613,3,4,7
bhol,24.3762910247,3.58760097788,3,4,7
adrian,24.3747996475,5.02034202978,2,2,4
cagt,24.3592688314,3.26136656658,4,5,9
han,24.3188992937,4.70763422455,2,2,4
butcher of bakersfield,24.2663267796,3.32848559426,4,5,9
frostbyte,24.2227417018,4.04359827929,3,4,7
jungle,24.1987083155,4.80610199671,2,2,4
waldo,24.178344371,4.11383441939,2,3,5
paco,24.1770285253,2.88307285084,5,7,12
keagsbsmashin,24.1694684192,4.79629526784,2,2,4
ocelot,24.1646442524,2.93443966276,4,8,12
hamburglar,24.1621871638,5.00571927599,2,2,4
fingerblast,24.1235241637,3.91675398091,3,3,6
lecceo,24.1110541172,4.9150888099,1,2,3
little bill,24.1090450985,5.25750712251,1,2,3
truffleshuffle,24.1042280373,4.52021918979,2,3,5
mrpoo,24.0938144638,5.04758146343,2,2,4
ravioli,24.0938144638,5.04758146343,2,2,4
nich,24.051848558,5.03396569322,2,2,4
probers,24.0382376556,4.66436792513,2,2,4
mr. biz,24.0325158375,5.05035439798,2,2,4
crazyk115,24.0236264376,4.58502916019,2,3,5
frogman [charette],24.0134463994,5.69184486955,1,2,3
sombrero,23.9882455398,5.35855988643,1,2,3
kevine,23.9732167964,5.62105501648,1,2,3
billbacon420,23.9153569037,5.67217186491,1,2,3
pochilin,23.913884547,3.92436656001,3,5,8
pokeiman_master,23.9037499387,5.35491583185,1,2,3
kriskringle,23.9016114032,4.44643108264,2,2,4
jaquarium,23.8986516109,5.19013016581,2,2,4
cormander,23.8972143773,3.0628676504,4,7,11
sebastian,23.8859933624,5.62488448684,1,2,3
hotsauce,23.8709879556,5.54419846727,1,2,3
rebel scum,23.8559625912,3.22676779915,4,5,9
dankey kang,23.8313791546,5.35783159384,1,2,3
lalo,23.8252234346,3.74669247255,3,4,7
weirdy man,23.8139127997,4.88907707487,2,2,4
pintoa,23.801240203,3.69040503702,3,5,8
zenaga,23.6995468826,5.51041351297,1,2,3
wal,23.6807749887,5.78786588895,1,2,3
yolochi,23.6570326002,5.73711166748,1,2,3
maps,23.5774057597,2.73282751238,4,8,12
izoo,23.5614870398,5.43011146819,1,2,3
jmabate,23.5505229459,5.13344476411,1,2,3
arctic,23.5412110525,5.42581543263,1,2,3
train_town,23.4595165571,5.11354614262,1,2,3
nuro,23.457554417,4.05144679071,3,3,6
moze,23.4294733678,4.99530838353,1,2,3
cbones,23.4118466893,5.3741936705,1,2,3
sph,23.3803554407,4.50954608102,2,3,5
macintosh,23.3720322049,4.37268055098,2,3,5
qapples,23.3613224979,5.36174155738,1,2,3
bodacious,23.352876492,4.02601646314,3,4,7
ir,23.3499798037,5.33364103374,1,2,3
derstuk,23.3245778513,3.5035165835,4,6,10
 ô·¥è·¥Ö·¥Ä·¥Ñ…™·¥è·¥ús,23.299781273,3.40720037909,2,6,8
kzidek,23.2863119817,5.35136986949,1,2,3
daddy's milk,23.2794486781,3.53136439193,4,5,9
birdlordmasterbeak,23.2475227796,5.51630495927,1,2,3
lucky_hamburger,23.2187185866,5.26213689994,1,2,3
ego,23.194541687,5.57174097001,1,2,3
qtip,23.1910720358,5.96847661703,1,1,2
evals,23.1715819438,5.29058144113,1,2,3
ardent rage,23.1356590704,5.34723184218,1,2,3
vidya_james,23.1296702163,5.46105161925,1,2,3
highlyeducational,23.1231075617,4.83378371822,1,2,3
-philip coast philip-,23.0877850428,5.19060985782,1,2,3
prism,23.085735086,5.74627069193,1,2,3
masquerade,23.0816859193,5.51639811381,1,2,3
hiv+,23.0811868742,5.25160690192,1,2,3
elitescoringguy,23.0733325774,3.6095434196,3,5,8
cuppajoe,23.02482811,3.98943471156,3,4,7
maaron,22.9835684557,5.23321789549,1,2,3
brotherly,22.9743679126,5.2278206018,1,2,3
icactusdog,22.9662843292,3.00472895703,4,9,13
slartibartfast42,22.9398519011,4.0176712361,3,4,7
nigel_thornberry,22.919404235,5.25910056172,1,2,3
xanz,22.9036557395,5.11740333774,1,2,3
the amazing busterino,22.8926262715,4.97058004014,2,2,4
v-bomber,22.8346027366,3.94477700004,3,4,7
gera,22.8208248771,5.36801749948,1,2,3
littlespoon,22.7937638732,5.44785540229,1,2,3
big d [hamiel],22.780807114,5.20868429284,1,2,3
precookedbread,22.7806286309,5.29131673702,1,2,3
hsf,22.7763938002,5.27129512331,1,2,3
boh,22.753888783,5.25428691057,1,2,3
blahguy,22.7192867727,5.60197708006,1,2,3
blackf00t,22.7068101709,4.3054097037,2,4,6
myninja,22.7018784894,3.7814841444,2,4,6
paco [larkin],22.6973772445,5.51841825729,1,2,3
ondas,22.6964006076,3.52363428078,3,5,8
changed man,22.6867102224,5.67101579923,1,2,3
cooljoe,22.6781882067,5.23651426547,1,2,3
miken,22.6774784952,7.1667063439,0,1,1
squible,22.6686732875,3.55621094485,3,4,7
zibba,22.6173969986,5.39195617113,1,2,3
dimension,22.5873152295,5.48181178147,1,2,3
damp,22.5825104187,4.26632374153,2,3,5
robnu,22.5594235503,4.41436532885,2,4,6
schlag,22.5497659868,5.64627274095,1,2,3
dasit mane,22.5424560677,3.9136160642,2,5,7
xiivi,22.5230381429,3.12237895635,5,7,12
silentknight,22.4150081394,4.54314024104,1,4,5
walkrofsky,22.4093279095,3.68186265429,2,4,6
banana fiend,22.3953470708,4.97315845935,1,2,3
dankpank,22.3906871874,3.09291051375,4,7,11
tmakk,22.3896566512,2.9617653978,5,8,13
midgetto,22.3514078853,3.91914530116,3,4,7
mourin,22.3362774999,5.52092281217,1,2,3
mortech,22.3350370272,3.81434108372,3,5,8
chiefreaper,22.3061587368,5.36519924366,1,2,3
yakal,22.2950630033,5.45881954507,1,2,3
dr. grin,22.2950630033,5.45881954507,1,2,3
superkirby,22.2628403412,5.37999956699,1,2,3
shasta,22.1955803154,5.07941061826,1,2,3
stew,22.1751609738,3.35340047162,4,5,9
hbrw-hammer,22.1640100362,5.22629600092,1,2,3
capsui,22.1598170777,5.53610295583,1,2,3
elmustachio,22.1428206537,5.28728445604,1,2,3
zarc,22.1192348257,5.40168414873,1,2,3
castaway,22.1140233633,5.63326144726,1,2,3
firefly,22.0832446758,5.52720444839,1,2,3
flare,22.0738376453,5.55336859451,1,2,3
boogie!,22.0647179953,3.55134410923,3,5,8
sadu,22.0371863907,5.60508068339,1,2,3
r.o.m.,22.0128787597,5.554682334,1,2,3
chai,21.8985480648,7.01618057864,0,1,1
malkasaur,21.8970233354,7.00839318003,0,1,1
zad,21.8752153796,3.39095129857,3,7,10
blisstex,21.8568479873,4.34737234701,2,4,6
scruffy mcwonder crumpet,21.8038888501,5.3383308517,1,2,3
spt,21.7950653918,5.49713248136,1,2,3
khakis,21.7912271073,4.2764290609,2,4,6
mulkster,21.7904849304,5.33558898091,1,2,3
leet,21.7161212231,5.54398917657,1,2,3
trevman,21.7053287847,5.17763636001,1,2,3
burnt out ninja,21.6867950646,5.49425252058,1,2,3
fawnco,21.6867950646,5.49425252058,1,2,3
hungrybox,21.6860773411,5.47985703048,1,2,3
jaws,21.6311673822,5.16115171042,1,2,3
mr_sharpie93,21.624550491,5.33730259116,1,2,3
evab,21.5855008588,5.46498187956,1,2,3
cardoso,21.5660778322,5.4610452728,1,2,3
maestro,21.5424663615,5.48103394783,1,2,3
drlight,21.5047657545,5.52858492613,1,2,3
giraffe,21.5047657545,5.52858492613,1,2,3
kossismoss,21.5047657545,5.52858492613,1,2,3
zwephy,21.5047657545,5.52858492613,1,2,3
dhir,21.5047657545,5.52858492613,1,2,3
k-man,21.5047657545,5.52858492613,1,2,3
nathansandwich,21.5047657545,5.52858492613,1,2,3
anathema,21.5047657545,5.52858492613,1,2,3
jirachinick,21.5047657545,5.52858492613,1,2,3
eggmcmuffin888,21.5047657545,5.52858492613,1,2,3
zombie!,21.5047657545,5.52858492613,1,2,3
thenuge,21.4831175108,3.54628823421,3,5,8
dirtcruncher,21.4645402345,3.04907764163,4,8,12
drewskii55,21.4121457178,5.11850231436,1,2,3
godspeed,21.4006133566,3.07464386071,4,7,11
bubby,21.3970332671,5.36171151221,1,2,3
yaron,21.3748576307,3.73701249138,1,6,7
esuma,21.3511290771,5.46780250884,1,2,3
rhubarb,21.348895384,2.98037062066,4,8,12
pastor,21.3422581477,5.51129103904,1,2,3
napkins,21.3422581477,5.51129103904,1,2,3
chaos pro,21.3422581477,5.51129103904,1,2,3
whoopiecow,21.3422581477,5.51129103904,1,2,3
myroknpancakes,21.3422581477,5.51129103904,1,2,3
heartsdealer,21.3422581477,5.51129103904,1,2,3
barrels,21.2579035574,3.08897285142,3,8,11
krypto,21.2366675584,4.43061605261,2,4,6
gumbolaya!,21.2317190972,5.24050044189,1,2,3
astumpycow,21.2209467723,5.41105727371,1,3,4
throwz?!,21.2116178134,5.1591243084,1,2,3
pzero39,21.1999739408,5.34798194269,1,2,3
caelan,21.148080321,7.07591989995,0,1,1
chinstrap,21.1039973139,4.07731458866,2,4,6
kavon,21.070209472,5.51002169606,1,2,3
flatline,21.070209472,5.51002169606,1,2,3
15(ichigo),21.070209472,5.51002169606,1,2,3
andy,21.070209472,5.51002169606,1,2,3
nyx,21.070209472,5.51002169606,1,2,3
iceking,21.0359882225,4.43879769747,2,4,6
sunshinetk,20.9652073312,4.27054499001,2,4,6
hotpocket,20.9561353125,5.52943180194,1,2,3
massimo,20.9371756287,5.15625974543,1,3,4
hipo,20.8704025547,5.25166667051,1,2,3
jollie,20.7689382303,3.78912139748,2,5,7
yungpurp,20.7087378608,6.65579508138,0,1,1
java boy,20.7055384255,5.49052833403,1,2,3
redribb0n,20.6905799049,6.83924500234,0,1,1
kingcool,20.6889882927,3.44743456109,3,6,9
snazzy,20.6705072568,5.43533874556,1,2,3
bohemian milk,20.6559674291,5.33528540292,1,2,3
shyguyking,20.6178886426,3.73211330243,3,5,8
ragingcherry,20.60416798,7.17147558733,0,1,1
nfreak,20.60416798,7.17147558733,0,1,1
yung,20.60416798,7.17147558733,0,1,1
akito555,20.60416798,7.17147558733,0,1,1
4sk,20.60416798,7.17147558733,0,1,1
garv,20.60416798,7.17147558733,0,1,1
masterofzoroark,20.60416798,7.17147558733,0,1,1
god,20.60416798,7.17147558733,0,1,1
dishier wand,20.60416798,7.17147558733,0,1,1
bunmira,20.60416798,7.17147558733,0,1,1
akajumo,20.60416798,7.17147558733,0,1,1
uprowr,20.60416798,7.17147558733,0,1,1
branchan,20.60416798,7.17147558733,0,1,1
neverpullout,20.60416798,7.17147558733,0,1,1
big tone,20.60416798,7.17147558733,0,1,1
adubz,20.60416798,7.17147558733,0,1,1
the cfb,20.60416798,7.17147558733,0,1,1
patty-wagon,20.5876097381,6.78784393705,0,1,1
spaff,20.5610555606,6.47389141057,0,2,2
flat nat,20.5080019423,6.94673678859,0,1,1
krutchby,20.5020504639,5.4629960484,1,2,3
bronze_sun,20.4938607321,6.92549349541,0,1,1
schmerka berl,20.4365496775,3.52338930246,3,8,11
tdp,20.3924975827,5.23203237747,1,2,3
eliot,20.3864327974,3.62807594556,2,7,9
astumpyzombie,20.382381148,4.43920652443,1,4,5
mattatari,20.3728408526,5.23299737103,1,2,3
fil,20.3612733202,6.92690169084,0,1,1
homemadewaffles,20.3612733202,6.92690169084,0,1,1
imperium,20.3612733202,6.92690169084,0,1,1
rice,20.3612733202,6.92690169084,0,1,1
mojo,20.2456865654,4.39971989246,2,3,5
pika,20.2404399247,4.54487743774,1,4,5
swankeaboo,20.2402561334,5.20156078642,1,2,3
danno,20.2393559356,5.26908818759,1,2,3
spell,20.1512639365,6.86040200605,0,1,1
hans_mawell,20.1279428502,6.89704561133,0,1,1
stephanie,20.1279428502,6.89704561133,0,1,1
i use tap jump,20.1279428502,6.89704561133,0,1,1
weatherman,20.0949002068,4.82620178152,1,4,5
the professor,20.0903170908,3.46393232272,3,7,10
hotspank,20.087540935,5.15684123528,1,2,3
et,19.9865723905,6.74398184354,0,1,1
woof,19.9729828114,3.51701081194,2,7,9
tokaji,19.9579729502,5.31736686858,1,2,3
dmolz,19.9262900542,3.97455766825,1,6,7
lou sanus,19.9213112507,3.86709950354,1,6,7
yolft,19.8775993979,3.6394654146,2,6,8
brambramjam,19.7906868836,4.76990762367,1,3,4
depressed eagle,19.7821090704,4.60868179082,1,4,5
nami,19.7754280134,6.66348085345,0,2,2
guccipivotmaster4000,19.7611884188,6.45038251077,0,2,2
elu,19.7119215404,3.96793788422,2,6,8
husker,19.7112978668,4.27776889011,1,5,6
taiko,19.6709984293,3.29254529552,3,8,11
bogmyer,19.6481001497,4.36574720848,1,4,5
the drew,19.6330099927,3.085487972,3,8,11
grrg,19.6040394525,2.97018918432,4,10,14
tallyshell,19.5929863809,4.78639849853,1,3,4
luwolf,19.5861764234,6.20865264586,0,2,2
jedipanda,19.5816610764,4.31853588039,1,5,6
general1712,19.5486356326,4.74399226721,1,5,6
dude,19.5026638594,6.91123888483,0,1,1
multiball,19.4739068198,3.24592710128,3,8,11
jose,19.3900010576,6.56882410874,0,1,1
shug,19.3150091162,4.58958327365,1,4,5
missingn0,19.2450810243,6.11512963311,0,2,2
bear,19.237033301,4.23425902337,1,4,5
nagurnimaster,19.2343577323,6.23400172038,0,2,2
twunt,19.1742189112,4.68545157804,1,4,5
jad,19.1548553974,6.43398380502,0,2,2
mariokartmoney,19.1263628643,4.93003836048,1,4,5
kobra,19.0906594211,4.89608178096,1,4,5
magnus combosen,19.0711661093,4.76840606739,1,4,5
mello,19.0547267353,6.60906208561,0,2,2
kevorkian,19.0362028395,3.95091950423,2,6,8
esmod,19.020238073,6.53317499455,0,2,2
rf!,19.0028728103,6.87267909617,0,1,1
maximum can,19.0000593386,6.29868745177,0,2,2
milleneum,18.9914157727,4.29511985012,1,4,5
duck chris,18.991102856,6.52889642219,0,2,2
sabo,18.9895447961,6.83048033888,0,1,1
jedisalazar,18.9561341962,6.43085715912,0,2,2
scootieloo,18.9090827787,6.0881610881,0,2,2
jgin,18.8690313029,5.97062779492,0,2,2
jackmehoff,18.862851665,6.02003437921,0,2,2
refriedjeans,18.8541960641,6.81026887543,0,1,1
stdangerous,18.8357541558,6.22894838646,0,2,2
brendanhall,18.7970867362,6.54992705426,0,1,1
pugdaddyfre$hlyfeogg*flva,18.7925634474,6.34973247445,0,2,2
moustasher,18.7684595535,3.40472868912,3,7,10
pilot,18.7550467167,6.63971746947,0,1,1
urpasmash,18.6892117664,6.49071121113,0,2,2
spicky,18.6582124812,6.7839805528,0,1,1
pidgezero_one,18.6041961502,3.50180474031,2,7,9
tbone,18.5774730416,6.29260400231,0,2,2
kl3an,18.5588529466,6.38820575423,0,2,2
broonz,18.5485167208,3.74159855968,2,6,8
lukem,18.5143618339,6.70590625739,0,1,1
youtwo,18.4585701402,6.47051486517,0,2,2
lloyd-black,18.439104923,3.3724607587,2,8,10
bus,18.4033731809,6.21857036024,0,2,2
master jay,18.3790600321,6.39548886025,0,2,2
tydye,18.3702110693,6.39108269428,0,2,2
charlie harper,18.341005986,6.3852507322,0,2,2
nokto,18.3228417539,6.2046251616,0,2,2
whitegrizzly,18.321642546,6.02218472055,0,2,2
quinceprince,18.32105969,6.2418644638,0,2,2
putpasswordhere,18.2172430102,4.78964405304,1,4,5
avian,18.2135081597,6.35266839978,0,2,2
swerve,18.1958183178,6.34838050571,0,2,2
jdeezel,18.111353808,6.31953289734,0,2,2
tylenol jones,18.110103572,6.32861787932,0,2,2
starcutter,18.078370117,6.20432197443,0,2,2
instacover,18.0500741902,6.31453002242,0,2,2
warmachine1919,18.0428187692,6.46387437135,0,2,2
izze,18.0428187692,6.46387437135,0,2,2
fen,18.0280431471,4.35906342505,1,5,6
locamash,18.0183196563,6.3229292674,0,2,2
electricgazelle,18.0054623606,6.70491637149,0,1,1
hero,18.0031787494,6.30456695442,0,2,2
jpoptosis,17.9980023599,6.32119878345,0,2,2
big d squirrels,17.9980023599,6.32119878345,0,2,2
akiva,17.9980023599,6.32119878345,0,2,2
fmax,17.9980023599,6.32119878345,0,2,2
yam$,17.9980023599,6.32119878345,0,2,2
duckpimp,17.9980023599,6.32119878345,0,2,2
phex,17.9980023599,6.32119878345,0,2,2
dennysgrandslambreakfast,17.9980023599,6.32119878345,0,2,2
zarfon,17.9980023599,6.32119878345,0,2,2
fry,17.9980023599,6.32119878345,0,2,2
drhino,17.9980023599,6.32119878345,0,2,2
snack?,17.9980023599,6.32119878345,0,2,2
astropancakes,17.9980023599,6.32119878345,0,2,2
laugh,17.9980023599,6.32119878345,0,2,2
lights,17.9816499173,6.29750892389,0,2,2
turtle,17.9810996549,6.0615370108,0,2,2
seantos,17.9661928965,3.65196991833,2,8,10
beaver,17.958835544,6.31200221875,0,2,2
alex,17.9392084778,6.28142665394,0,2,2
wolfcry,17.9230213746,6.16381175236,0,2,2
black rob,17.9115109095,6.28017882446,0,2,2
erk,17.9107571059,6.27774263235,0,2,2
pigwick,17.9085248734,5.83873928228,0,2,2
maxi,17.8471382488,6.27199149472,0,2,2
holosly,17.8405629898,6.27988339032,0,2,2
ebay,17.8359797122,6.26745356674,0,2,2
harmless,17.8270005524,6.29388615473,0,2,2
5000candlesinthewind,17.8270005524,6.29388615473,0,2,2
jojohnson,17.8270005524,6.29388615473,0,2,2
tuna,17.8270005524,6.29388615473,0,2,2
armor,17.8270005524,6.29388615473,0,2,2
giggitoxin,17.8270005524,6.29388615473,0,2,2
oljace,17.8270005524,6.29388615473,0,2,2
flash,17.8270005524,6.29388615473,0,2,2
jfm,17.8270005524,6.29388615473,0,2,2
legoman,17.8270005524,6.29388615473,0,2,2
mrryanness,17.8012990057,4.75126295633,1,4,5
zane,17.7546889757,6.37991001333,0,2,2
fs shampoomaster,17.6764689919,6.23207522826,0,2,2
matt47,17.6673384456,6.26628461383,0,2,2
turtlpower,17.6673384456,6.26628461383,0,2,2
liam_butler,17.6673384456,6.26628461383,0,2,2
frogge,17.6584978233,5.8288353458,0,2,2
oxycontin,17.6103954248,3.51632767579,2,6,8
uncle onion,17.6088232344,6.2344399148,0,2,2
xlax,17.5512357258,4.72965931318,1,4,5
gambit,17.5381058359,6.04022060431,0,2,2
blank,17.5157993115,5.9797827329,0,2,2
mechanicalmarine,17.4461933521,6.30547921767,0,2,2
magfmur,17.4412025514,5.99671252336,0,2,2
scraggus,17.4303150827,6.18724463433,0,2,2
goomah,17.4129916516,6.18520774262,0,2,2
thegoat,17.4076481683,6.29919906056,0,2,2
levity,17.3906834127,6.18744334256,0,2,2
draxsel,17.358477432,6.16091093994,0,2,2
sad,17.3391686592,6.28284296999,0,2,2
jerzilla,17.3142575988,6.08167010618,0,2,2
juan doe,17.2593715302,6.26660083903,0,2,2
bozz,17.2550251036,6.269075413,0,2,2
4 phri,17.2235887762,6.2635158315,0,2,2
master j.j.,17.2159805961,6.25613385274,0,2,2
fig,17.210872062,4.23754356067,1,5,6
puddn,17.2084788552,6.2591236046,0,2,2
jobook,17.1773993655,6.2472248959,0,2,2
marfslayer 3000,17.1573329149,6.26923433457,0,2,2
driftintheabyss,17.1230201462,6.24558798543,0,2,2
amaya,17.120377916,6.24601280341,0,2,2
sianvar,17.0909712461,6.05378160322,0,2,2
lunchy,17.0699686222,6.08232004122,0,2,2
superduperfanofboom,17.0516150876,6.2238769682,0,2,2
lonk,17.0073866723,6.02726524418,0,2,2
sam,17.0069482635,5.88766988753,0,2,2
kayo,16.9847121527,6.21981944122,0,2,2
rocktimus crime,16.9498531079,4.92120206027,0,5,5
russellsprouts,16.9393162106,5.33978744443,0,4,4
redwolf,16.9338981215,5.78770906598,0,2,2
paper tiger,16.9273178368,6.23983584333,0,2,2
irish,16.9273178368,6.23983584333,0,2,2
sharktoast,16.9273178368,6.23983584333,0,2,2
abc,16.9273178368,6.23983584333,0,2,2
grraffe,16.9273178368,6.23983584333,0,2,2
deku,16.9273178368,6.23983584333,0,2,2
miles,16.9273178368,6.23983584333,0,2,2
theycallmechris,16.9273178368,6.23983584333,0,2,2
searcher,16.9273178368,6.23983584333,0,2,2
sleeh,16.9273178368,6.23983584333,0,2,2
sambook,16.9273178368,6.23983584333,0,2,2
ferrero64,16.9273178368,6.23983584333,0,2,2
zombieheart84,16.9273178368,6.23983584333,0,2,2
j,16.9273178368,6.23983584333,0,2,2
skubtard,16.9273178368,6.23983584333,0,2,2
whiz kid,16.9273178368,6.23983584333,0,2,2
shadow light master,16.9273178368,6.23983584333,0,2,2
grunyan,16.9273178368,6.23983584333,0,2,2
uh what,16.9273178368,6.23983584333,0,2,2
scuttlebug jamboree,16.9273178368,6.23983584333,0,2,2
red,16.9273178368,6.23983584333,0,2,2
sven stormbeard,16.9273178368,6.23983584333,0,2,2
blues,16.9273178368,6.23983584333,0,2,2
sfgman,16.9273178368,6.23983584333,0,2,2
fs mook,16.9273178368,6.23983584333,0,2,2
themickeynick,16.9273178368,6.23983584333,0,2,2
d-tek,16.9273178368,6.23983584333,0,2,2
beekle,16.9273178368,6.23983584333,0,2,2
azzy,16.9273178368,6.23983584333,0,2,2
heisenberg,16.9273178368,6.23983584333,0,2,2
thac0,16.9273178368,6.23983584333,0,2,2
benbook,16.9273178368,6.23983584333,0,2,2
riseup93,16.9273178368,6.23983584333,0,2,2
monk,16.9273178368,6.23983584333,0,2,2
smashlopez64,16.9273178368,6.23983584333,0,2,2
muthaluva777,16.9273178368,6.23983584333,0,2,2
digital cannon,16.9273178368,6.23983584333,0,2,2
hail_sagan,16.9273178368,6.23983584333,0,2,2
umi,16.9273178368,6.23983584333,0,2,2
raxcity,16.9273178368,6.23983584333,0,2,2
edwin...,16.9273178368,6.23983584333,0,2,2
yuxminato,16.9273178368,6.23983584333,0,2,2
bean,16.9273178368,6.23983584333,0,2,2
aperture,16.9273178368,6.23983584333,0,2,2
zurdo,16.9273178368,6.23983584333,0,2,2
sunshine,16.9273178368,6.23983584333,0,2,2
kezzup,16.9273178368,6.23983584333,0,2,2
rickter_scale,16.9273178368,6.23983584333,0,2,2
waffles,16.9273178368,6.23983584333,0,2,2
voidstar,16.9273178368,6.23983584333,0,2,2
atari,16.9273178368,6.23983584333,0,2,2
jazz,16.9273178368,6.23983584333,0,2,2
qk shkz,16.9273178368,6.23983584333,0,2,2
gaymer,16.9273178368,6.23983584333,0,2,2
mr.e [rohr],16.9273178368,6.23983584333,0,2,2
ubll black mage,16.9273178368,6.23983584333,0,2,2
dd,16.9273178368,6.23983584333,0,2,2
aubfox,16.9273178368,6.23983584333,0,2,2
phalanx,16.9093882126,6.20923233147,0,2,2
m2cain,16.892490689,6.20929761722,0,2,2
bunnyblast,16.8822801378,6.20385470448,0,2,2
blizz,16.865327086,6.19888552083,0,2,2
mookie,16.8530904258,6.18837459222,0,2,2
rabizkoshik,16.8426869985,4.44375782152,1,5,6
ham,16.8405825625,4.34911637884,1,6,7
darv,16.8172633686,6.2067889521,0,2,2
da bear,16.7988221597,6.06416220587,0,2,2
werewyatt,16.7855100462,4.02544600271,1,5,6
dk dredd,16.7761720308,5.93345080588,0,2,2
karl,16.6552881432,5.54547510957,0,3,3
colt,16.6196458199,6.16564338099,0,2,2
scott,16.5992204561,6.15323764653,0,2,2
scaryman,16.5975733724,3.92569263363,1,6,7
mikeyg,16.5702708523,5.89064268278,0,2,2
bc_burns,16.5383659216,6.12783790491,0,2,2
curiousplaces,16.4946314178,5.98428371546,0,2,2
robslabgod,16.4761911725,5.64004535573,0,2,2
charlie,16.4106162743,5.78946827494,0,2,2
pvc,16.400476286,5.99329902216,0,2,2
mike4real,16.3489022915,5.81333456044,0,2,2
nyani,16.3397594719,5.85967955801,0,3,3
fumofuu,16.3030542888,5.91672443964,0,2,2
dunos_,16.2878779255,5.97763085216,0,2,2
kraken,16.2658891577,5.86023295168,0,2,2
polarbair,16.2621781536,6.13412271997,0,2,2
papa,16.2534457225,5.23022840952,0,4,4
juno,16.2311025997,5.97438046955,0,2,2
recneps,16.2161126244,4.02120974895,1,7,8
katiebug (sfk),16.1633389172,5.97054957684,0,2,2
yung god,16.0854440179,6.08376253996,0,2,2
thedarkdreamer,15.8117426471,6.01673635797,0,2,2
bulldog,15.7875607058,6.01539646542,0,2,2
ohhhbreezy,15.6703131939,3.92486012354,1,6,7
tweli,15.60716869,5.97661226801,0,2,2
bennyboy98,15.4993931622,5.82173058914,0,2,2
jet fuel,15.4976207178,3.81391378415,1,7,8
kohenbro,15.4047986868,4.99951426716,0,5,5
failcant,15.357851223,5.8152051293,0,2,2
sweaters,15.3576121017,6.06819483028,0,2,2
vondo,15.2138301683,4.51185334548,0,6,6
cr0ak,15.1875993065,5.90448236514,0,2,2
hyperbole,15.1648833,5.91820734303,0,2,2
thisisgettingold,15.115537955,5.93072884891,0,2,2
ryden hope,15.0465713965,5.70803561869,0,2,2
nikku,14.9964862922,5.85857113824,0,2,2
ppdmd,14.9247578391,5.84013101842,0,2,2
falln,14.9042172228,5.66942705032,0,2,2
adulix,14.894363068,5.00342255587,0,5,5
deep dimples,14.8507190736,4.53817707757,0,5,5
neph_girl,14.8418092884,4.29241851834,0,7,7
djltheescapade,14.7836508823,4.94011850343,0,5,5
sugaaku,14.4458284627,5.37156501497,0,4,4
elrond,14.3918821556,4.20927809144,0,7,7
dr gibs,14.3419539303,4.69367763781,0,5,5
link,14.1665568654,5.7580728291,0,2,2
bung0o,14.1234865847,4.65949256251,0,6,6
cat,14.0798507803,4.75028887024,0,5,5
mjim,14.0797639132,4.46487949071,0,5,5
jpeghero,13.9960810869,3.7366085322,1,8,9
nardwell,13.9551463916,2.79281983416,2,19,21
myk,13.8397278746,5.36213805829,0,4,4
jonnjonn,13.82073892,4.66172072278,0,5,5
paul d,13.6526042096,5.22888989512,0,4,4
2%gay,13.6517880434,4.95456067386,0,6,6
jeremy,13.5790492234,5.0697513134,0,4,4
nnaughtydogg,13.5507020005,4.35113992407,0,6,6
bagel,13.4836907095,4.52579181192,0,6,6
shwang,13.3686879443,4.6571491862,0,6,6
tehz,13.3045225373,4.70712852415,0,6,6
blanco mano,12.8583249396,4.39627499111,0,6,6
golfclubninja,12.4573292653,4.61161194709,0,8,8
jimbot,12.3978721318,4.43568197921,0,7,7
