player,rating,rd,sets,wins,losses,tournaments
superboomfan,2152.23570977,71.5138582617,94,90,4,10
alvin,2016.99262545,96.2208590803,20,17,3,2
mariguas,1942.4147103,71.1807303028,51,41,10,5
tr3gthez,1938.94834288,92.9029584075,29,23,6,3
wizzrobe,1916.11727262,68.2961869659,55,44,11,7
isai,1907.00925387,83.8376217422,33,27,6,3
kerokeroppi,1874.76147524,65.3704295001,64,49,15,7
tacos,1872.87379848,72.6759650088,51,39,12,6
barksanchez,1863.69113364,69.2310007921,42,30,12,5
zantetsu,1863.68193768,109.310483919,17,13,4,2
dext3r,1861.75543198,78.9064782211,37,28,9,4
marbles,1858.31130014,102.806455135,18,14,4,2
wario,1854.0221633,144.573041605,11,10,1,1
vinsanity,1846.4399307,146.095533516,8,6,2,1
kurabba,1840.91223526,148.720571012,9,7,2,1
stranded,1835.85662855,89.8888189604,32,26,6,4
dtan,1834.53833624,98.909133369,19,14,5,2
revan,1827.27626279,69.5406450232,52,39,13,6
lowww,1825.65098024,140.719717958,9,7,2,1
wangera,1816.3543961,103.758126083,21,16,5,2
prince,1813.16591564,140.583327143,9,7,2,1
fireblaster,1799.38856129,64.656004857,82,60,22,10
heropie,1792.66824631,104.669656898,16,12,4,2
derek #squats,1784.13785018,102.431553027,16,11,5,2
handsometom,1779.69103521,109.626351828,16,11,5,2
nta,1770.29418392,182.14788035,16,11,5,2
firo,1766.66071896,89.0774143695,23,15,8,3
fox,1765.15158393,96.3162966933,24,17,7,3
bark the shark,1763.40898369,79.1371117458,40,29,11,5
cobr,1755.29620942,119.310581007,23,15,8,3
$$$ jim $$$,1748.85046322,97.7702775585,17,12,5,2
jaimehr,1747.08469808,83.6419046796,30,21,9,4
combo blaze,1746.70701259,85.0156355277,30,20,10,4
janitor,1742.91400086,82.6153095289,33,24,9,4
sotoh,1739.34832572,92.0787612919,27,18,9,4
mojomonkey,1738.88650272,145.29985239,8,6,2,1
lorenzo,1736.61834149,96.0816143467,22,15,7,3
hero pie,1732.20243818,109.319814551,17,11,6,2
shears,1729.23605842,64.3715768739,68,46,22,9
bonobono,1728.2293039,144.795115761,7,5,2,1
dark gentleman,1726.49980788,134.680181776,11,7,4,2
star king,1724.04819483,171.464814716,17,11,6,2
janco,1723.52654095,124.06218423,13,8,5,2
spark,1721.91984241,148.340391045,7,5,2,1
kort,1721.41143387,111.967733256,17,11,6,2
nothing,1718.22928798,103.077855026,21,15,6,3
kimimaru,1716.06998225,106.520552526,18,13,5,2
finio,1714.07825898,158.273879796,7,5,2,1
near,1713.27899389,129.166808129,10,7,3,1
letsgo,1711.3912638,180.379021997,6,3,3,1
nacl,1707.69703492,105.474094951,18,12,6,3
nintendude,1707.27337747,80.5689712605,36,23,13,5
sheermadness,1704.78928313,153.645258965,7,5,2,1
facechew,1699.3193371,163.929403172,7,5,2,1
banze,1697.89151596,113.15642126,16,11,5,2
robert,1697.12710136,96.6965302512,22,15,7,3
fumbles,1688.87786288,141.825385361,8,5,3,1
battlecow,1688.34929138,135.499699665,8,5,3,1
kyle tree,1687.85517735,117.690581812,14,9,5,2
wookiee,1686.54596486,89.3083639857,27,18,9,4
a$,1685.29805196,167.219016955,6,4,2,1
hipstur,1684.92794196,81.7154473565,35,24,11,5
spongy,1684.54364945,118.115735597,13,9,4,1
box765,1682.99968956,138.921387611,9,6,3,1
jason,1682.68875878,89.4361504456,28,19,9,4
shalaka,1681.8815607,115.82594784,16,10,6,2
stonefallow,1677.53952723,139.660328008,11,7,4,2
zero,1676.35627026,114.757434461,17,11,6,2
amida,1674.83591963,102.819442569,20,13,7,3
poobearninja,1670.23087474,132.163000167,13,9,4,2
jay-r,1669.30795467,172.572251236,7,5,2,1
smash jesus,1669.01399084,125.340779787,14,10,4,2
fishaman p,1660.75502221,109.941196692,15,9,6,2
connor,1660.40615537,102.515812837,19,12,7,3
jay_mute$,1659.0434213,113.342730528,14,9,5,2
ybombb,1654.44040011,127.368864291,14,9,5,2
loto,1654.19157934,169.453973272,6,4,2,1
pugs,1654.1441192,111.200587564,13,8,5,2
yobolight,1651.16475144,107.263785239,19,12,7,3
josephzander,1650.69296328,130.056806978,9,6,3,1
gildo,1650.40223026,108.469652407,18,12,6,2
lord narwhal,1647.08396104,96.1341422094,23,14,9,3
dajjal,1646.20278202,93.5648179429,24,15,9,3
the american patriot,1645.56483791,179.09196903,6,4,2,1
nattybroh,1644.0840776,118.863965034,13,9,4,1
kaz,1642.39758037,118.164724773,13,8,5,2
v,1640.86359075,160.887844269,6,4,2,1
mrmarbles,1640.00900531,126.303049729,14,9,5,2
eg,1639.78801082,102.113864389,17,11,6,2
tr3g the z,1639.07777628,156.679676546,9,6,3,1
kraines,1638.60700335,198.796968875,4,3,1,1
xyk,1638.41460518,177.037819085,6,4,2,1
tonester,1638.34103565,145.560558022,11,7,4,2
the big d,1638.31033548,177.412261629,6,4,2,1
hotline,1637.34166912,168.340791417,6,4,2,1
b33f,1637.07034287,106.046184108,17,11,6,2
piratetrips,1634.57348785,114.087964199,12,8,4,1
esid,1634.02689261,150.74838913,9,6,3,1
mr.sir,1629.64169267,75.568309068,48,28,20,8
shihman,1628.21253245,93.3720691027,28,18,10,4
onski,1627.58079439,95.0482717506,25,15,10,4
sextc,1627.57075506,152.351119842,8,5,3,1
llcstoism,1627.40813853,111.84085233,15,9,6,2
jimmy joe,1627.12755517,83.2649829029,31,18,13,5
mokkori,1626.6347393,182.632308241,6,4,2,1
bard,1625.89401472,92.204316699,25,16,9,5
sunnyb,1624.81793961,142.382897374,8,5,3,1
dogs_johnson,1623.80856646,105.332112509,18,11,7,3
socrates,1622.5832294,181.776416093,5,3,2,1
madrush21,1621.70486047,73.2994631424,43,24,19,7
d35,1620.95328295,88.3315839939,28,17,11,4
b0n,1620.14786597,170.551328145,6,4,2,1
rossi,1617.706257,175.907808936,5,3,2,1
clubbadubba,1617.66899376,114.878317846,15,9,6,2
freean,1614.79910606,113.22202365,19,12,7,3
b link,1614.27935923,150.565355727,7,4,3,1
a to the z,1613.86629758,96.5153646,21,11,10,3
darkhorse,1613.63518965,85.1437342613,30,18,12,5
bowl,1613.57079455,128.39293457,13,8,5,2
kyle,1613.16758913,181.601403272,5,3,2,1
snorlax,1612.09331573,106.461016573,20,12,8,3
preston,1611.69156066,97.370246313,23,14,9,4
greeno,1610.49732898,103.512172063,21,13,8,3
saltsizzle,1610.08096589,97.7565523624,18,10,8,3
quickcav,1609.31420204,145.115371886,9,6,3,1
1000,1609.18692098,189.221952712,5,3,2,1
jxc,1608.60034052,169.691405051,6,4,2,1
komotonoto,1608.06401923,137.971997874,9,5,4,1
ivor,1608.04620324,178.755956101,5,3,2,1
monte,1607.36910986,147.823205735,7,4,3,1
monte,1607.36910986,147.823205735,7,4,3,1
natendo,1605.96564751,170.389927779,6,4,2,1
sedda,1604.70331931,133.470812916,18,11,7,3
dogg,1603.78637659,110.272653163,14,8,6,2
heny935,1602.62870545,164.965832939,6,4,2,1
masterhandjob,1602.57161077,94.3919127054,26,15,11,4
duffman,1602.09904053,174.368180612,5,3,2,1
freddy cougar,1601.06859103,190.88727716,5,3,2,1
the dark gentleman,1600.60106475,158.550027958,7,4,3,1
supa,1599.53568175,113.145644859,15,8,7,3
umbra,1596.50943528,142.167931845,10,6,4,2
ctg,1595.89321262,105.904946786,25,14,11,5
broly,1594.47703867,189.446959174,5,3,2,1
bamster,1593.92035383,178.470482578,5,3,2,1
sax,1592.72929707,144.181788786,8,5,3,1
tafokints,1591.8996249,216.923455552,3,2,1,1
a la carte,1591.61052686,151.536633362,9,5,4,2
cyoonit,1591.38535166,147.661669726,7,4,3,1
mustard tiger,1591.11528864,143.777739974,10,6,4,2
kirbstomper,1590.7482268,142.142221254,9,5,4,2
dpb,1589.76072277,189.341002845,5,3,2,1
satan [turner],1588.9363881,157.007331524,7,4,3,1
chuck lubs,1588.83820748,188.109119643,5,3,2,1
studstill,1588.60372759,142.740548609,11,7,4,2
limesoda,1586.11221912,108.652234304,16,9,7,3
shanks,1585.99709117,133.676173841,12,7,5,2
gravyfingers,1583.62932869,149.028142044,7,4,3,1
smurf,1583.24594039,91.1566174455,29,17,12,5
tyhiggz,1582.42393197,102.092543918,17,9,8,3
elated,1582.41917145,138.549604156,10,6,4,1
fudgeball,1581.60990377,159.707392642,5,3,2,1
mr. slimey,1579.71627605,198.122995617,4,2,2,1
iheartqueso,1579.69846905,151.480754552,9,5,4,2
knitephox,1578.72752039,118.523241051,17,10,7,3
moogle,1578.69539633,187.339206223,5,3,2,1
zuko,1576.63916734,103.003439598,23,12,11,4
b.i.,1575.89269955,134.778325452,11,7,4,1
elel,1574.77251965,147.729597476,10,6,4,2
skyfire,1574.38440114,185.461136741,5,3,2,1
zyrg,1574.19886086,142.76010842,10,6,4,1
no~m,1574.01605654,187.67573768,5,3,2,1
p21/c,1573.75718595,124.005115247,15,9,6,2
shyboy,1572.10991729,194.731533917,5,3,2,1
sebula4,1572.10991729,193.998377059,5,3,2,1
sheick,1572.10991729,194.731533917,5,3,2,1
blaise,1572.10991729,194.731533917,5,3,2,1
kingkool,1572.10991729,194.731533917,5,3,2,1
vudujin,1572.10991729,194.731533917,5,3,2,1
dragoniota,1572.10991729,194.975306902,5,3,2,2
nattyb,1572.10991729,194.731533917,5,3,2,1
ern,1572.10991729,194.731533917,5,3,2,1
tvdonk,1572.10991729,194.731533917,5,3,2,1
t0mmii,1572.10991729,194.731533917,5,3,2,1
toro,1572.10991729,194.243070151,5,3,2,1
autobaun,1572.10991729,194.731533917,5,3,2,1
batterybird,1572.10991729,194.731533917,5,3,2,1
toronto joe,1572.10991729,194.731533917,5,3,2,1
zergos,1572.10991729,194.291971789,5,3,2,1
xor,1572.10991729,194.731533917,5,3,2,1
king lumsy,1572.10991729,194.487455384,5,3,2,1
eggmode,1572.10161898,103.651925902,19,11,8,3
subtle,1569.86549525,150.719916012,10,5,5,2
gt,1568.91193785,77.7278923057,32,18,14,5
travkid,1568.09938962,222.166837472,2,1,1,1
killahertz,1567.84722867,128.482657256,13,7,6,3
dubs,1567.77616588,138.301202694,12,7,5,2
g0d,1567.77369899,191.242573026,4,2,2,1
daniel,1567.54093582,111.927040578,19,11,8,3
pathall,1567.28804249,196.014668548,4,2,2,1
touque,1567.28052473,178.177103376,5,3,2,1
rgood,1567.1892753,186.638960362,5,3,2,1
coin chaser,1566.80634848,186.350242136,5,3,2,1
dizzle,1566.5111977,145.675451584,14,7,7,3
handles,1563.65417523,115.329170007,15,9,6,2
dr. lampy,1563.41505141,187.265133794,5,3,2,1
nesskhalifa,1563.02871947,154.901183174,9,5,4,2
bread,1561.73469528,119.292074795,14,8,6,2
rusty,1561.6230298,104.949455639,17,9,8,3
fancy,1560.64369567,184.033511648,5,3,2,1
giraphe,1559.79773079,182.143871767,5,3,2,1
scoback,1559.26684588,127.823488056,12,6,6,2
gaijilla,1559.17637111,206.15376283,4,2,2,1
se√±orhen10r,1559.07142197,153.824061264,7,4,3,1
starchild,1559.01149625,119.120047337,15,9,6,2
tot,1558.4585112,130.321319326,13,7,6,2
wazzberry,1557.43947197,185.878530446,5,3,2,1
rith,1556.43598489,172.572251236,7,4,3,1
pete,1556.43598489,172.572251236,7,4,3,1
waxy:joe,1555.43078907,142.350577167,10,6,4,1
notlightningrunner,1554.97095163,185.815794454,5,3,2,1
the protagonist,1554.56029026,125.154586676,13,7,6,2
annex,1554.51850819,102.582185926,21,12,9,3
dfx,1554.3966835,110.013954308,27,15,12,5
thrillhouse,1554.26130821,132.852350528,9,5,4,1
stonehaus,1554.14116805,184.940058198,5,3,2,1
bon,1551.53558557,125.871682921,12,6,6,2
pewpewu,1548.88552512,145.872467905,9,5,4,2
sonicfuzz,1548.29490736,122.495663551,14,8,6,2
commander,1547.41094978,183.057697586,5,3,2,1
pluto,1547.32598435,195.36582008,4,2,2,1
zbl_mystic,1546.49215629,171.461932301,5,3,2,1
vanillarin,1546.27234155,157.432017817,9,5,4,2
purtle,1545.95118319,163.818296822,6,3,3,1
darkneon,1543.20778708,178.529930403,5,3,2,1
pochilin,1542.73675285,207.97236989,8,3,5,2
tbq,1541.98859366,150.02113251,9,5,4,1
yunque,1540.78355717,141.068630747,11,6,5,2
nasian,1539.43397167,184.027239607,4,2,2,1
dusttin,1536.61540376,123.192085924,14,7,7,3
captain l,1536.57855107,135.240439165,12,6,6,2
boomalready1,1536.54196561,143.331042019,9,5,4,1
korobeniki,1536.46211471,123.053076856,15,7,8,3
whitejesus,1535.68534812,118.317790728,14,6,8,2
t brett,1535.53162137,152.236445325,9,5,4,2
grahamaglam,1535.4131772,123.463326866,11,5,6,2
moonshoe,1534.09192738,142.086815707,9,5,4,2
professor_wizard,1534.08715093,106.431432133,16,9,7,2
cwic-beam,1533.46509823,158.743242271,8,4,4,2
fck vwls,1532.05485027,118.623270015,16,8,8,3
luka,1531.96766465,203.777271664,4,2,2,1
jamjar,1531.74461638,94.2021883595,30,16,14,6
sandman,1529.6048996,180.091185696,5,3,2,1
th3kuzinator,1527.82781667,128.051358169,12,6,6,2
blondekid,1527.4557374,165.055713863,6,3,3,2
vanddar,1527.06481915,198.350799936,4,2,2,1
horbie,1526.51314335,162.04358548,6,3,3,1
cmull,1525.74373495,140.254942315,8,4,4,1
justin,1525.61049628,175.559733095,5,3,2,1
shishkabobs5,1524.08105204,195.988774797,4,2,2,1
drewgong,1523.83429143,156.587114939,10,4,6,3
captain fabulous,1523.2902637,113.9242688,16,8,8,3
kabal,1523.25241065,152.039399645,7,4,3,1
bunz,1522.5506471,202.443836219,4,2,2,1
mr.watchandlearn,1522.24881677,202.032796488,4,2,2,1
hypa,1518.90134262,191.521388115,4,2,2,1
pizza,1518.58014684,107.515632036,20,10,10,5
daniels,1518.26885071,103.511323492,22,11,11,5
spaghetti,1516.4151316,181.754915309,5,2,3,1
cyan can,1513.30492218,200.669269037,4,2,2,1
kaladin,1511.42393302,193.388084977,4,2,2,1
synth,1511.15719932,174.850839892,4,2,2,1
kaddy,1511.07538074,239.35427267,2,1,1,1
shake,1510.85494991,199.463234004,4,2,2,1
stevie g$üëåüëåüëåüëåüëåüëåüëåüëå,1509.79552046,203.392576304,4,2,2,1
kd3,1507.78033368,200.754709426,4,2,2,1
barron,1504.20475258,203.67674306,4,2,2,1
rizner,1501.98914063,111.213660777,19,10,9,4
reptar,1501.74737372,155.381923599,8,4,4,2
savior,1501.40438739,200.291170176,4,2,2,1
duncs,1500.8241901,116.898966224,16,8,8,3
cuppajoe,1500.76115734,199.348330842,7,3,4,2
purple fox,1500.22842496,187.162256305,4,2,2,1
wincancel,1500.0,209.255166634,4,2,2,1
blueman,1500.0,209.255166634,4,2,2,1
hamburglar,1500.0,208.982594402,4,2,2,1
ravioli,1500.0,209.20976259,4,2,2,1
geekliftus,1500.0,209.663360564,4,2,2,1
snowstorm,1500.0,209.663360564,4,2,2,1
moist,1500.0,209.436684378,4,2,2,1
adrian,1500.0,209.255166634,4,2,2,1
mr. biz,1500.0,209.663360564,4,2,2,1
dwreck,1500.0,209.663360564,4,2,2,1
satch,1500.0,208.937131126,4,2,2,1
collin the conqueror,1500.0,209.663360564,4,2,2,1
the amazing busterino,1500.0,209.663360564,4,2,2,1
qtip,1500.0,253.907619787,2,1,1,1
qubit,1500.0,209.663360564,4,2,2,1
poptartplug,1500.0,208.982594402,4,2,2,1
dankestdad,1500.0,209.663360564,4,2,2,1
rawdog,1500.0,181.79812984,6,3,3,1
bottle opener guy,1500.0,209.663360564,4,2,2,1
beguiler,1500.0,209.118924928,4,2,2,1
leavescat,1500.0,163.108491562,8,4,4,1
klms,1500.0,209.663360564,4,2,2,1
weedwack,1500.0,209.663360564,4,2,2,1
h2o,1500.0,209.255166634,4,2,2,1
imdabes,1500.0,209.663360564,4,2,2,1
logic,1500.0,209.663360564,4,2,2,1
therapture_,1500.0,209.663360564,4,2,2,1
tetsu0,1500.0,209.663360564,4,2,2,1
salt,1500.0,209.255166634,4,2,2,1
swiftbass,1500.0,209.663360564,4,2,2,1
funkykong,1500.0,208.982594402,4,2,2,1
mrpoo,1500.0,209.20976259,4,2,2,1
tauvalian,1500.0,209.436684378,4,2,2,1
clefairy as mew,1500.0,208.982594402,4,2,2,1
jaquarium,1500.0,209.436684378,4,2,2,1
hoofydough,1500.0,209.663360564,4,2,2,1
nuro,1500.0,181.79812984,6,3,3,1
dezno,1500.0,253.832778391,2,1,1,1
han,1500.0,209.663360564,4,2,2,1
steamfriedasian,1500.0,209.663360564,4,2,2,1
kman,1500.0,209.118924928,4,2,2,1
morino,1500.0,182.632308241,6,3,3,1
nich,1500.0,208.982594402,4,2,2,1
karlthemarx,1500.0,209.436684378,4,2,2,1
rythemretrn,1500.0,209.255166634,4,2,2,1
quitrage,1500.0,209.663360564,4,2,2,1
pizzajokes,1500.0,209.663360564,4,2,2,1
jc_chill,1500,350,4,2,2,1
sph,1500,350,5,2,3,1
mr. wang,1500,350,6,4,2,1
zarc,1500,350,3,1,2,1
imperium,1500,350,1,0,1,1
driftintheabyss,1500,350,2,0,2,1
phut,1500,350,6,3,3,1
bubby,1500,350,3,1,2,1
bp,1500,350,6,3,3,1
whuck,1500,350,6,3,3,1
stephanie,1500,350,1,0,1,1
lecceo,1500,350,3,1,2,1
hbrw-hammer,1500,350,3,1,2,1
puddn,1500,350,2,0,2,1
dount,1500,350,6,3,3,1
superkirby,1500,350,3,1,2,1
truffleshuffle,1500,350,5,2,3,1
massimo,1500,350,4,1,3,1
peasantloaf,1500,350,5,3,2,1
elmustachio,1500,350,3,1,2,1
jdeezel,1500,350,2,0,2,1
costaricancool,1500,350,5,2,3,1
hotahota,1500,350,5,3,2,1
master j.j.,1500,350,2,0,2,1
mahie,1500,350,0,0,0,1
locamash,1500,350,2,0,2,1
gaymer,1500,350,2,0,2,1
pandemonium,1500,350,4,2,2,1
zane,1500,350,2,0,2,1
elvis,1500,350,6,4,2,1
7blanks,1500,350,6,3,3,1
zeppelin,1500,350,8,5,3,1
dimension,1500,350,3,1,2,1
ibc,1499.96787681,155.046307074,8,4,4,2
hariballz,1499.08576972,155.17416262,8,4,4,1
k-nut,1498.86896074,155.287566446,7,4,3,1
sunflower,1498.62230975,129.61373331,13,6,7,3
brny,1497.31353552,186.442368565,4,2,2,1
lookalike,1496.89817111,160.248349717,8,4,4,2
razz,1496.52103954,129.135692172,12,6,6,2
breakthrough,1496.11487725,199.998241092,4,2,2,1
spamus,1494.5502653,190.654150254,4,2,2,1
tootmoses,1494.44057704,192.388746989,4,2,2,1
deathcpo,1494.2693839,113.699570682,14,7,7,2
weirdy man,1491.39892079,200.026185626,4,2,2,1
bflakes,1490.82744599,183.976132374,4,2,2,1
neth,1490.42168474,198.578310065,4,2,2,1
prism,1490.40805513,246.650988012,3,1,2,1
jsmirk,1490.3984299,126.681253858,13,6,7,2
droc,1489.16263168,193.946849852,4,2,2,1
moosh_da_moosh,1488.31179879,195.742836765,4,2,2,1
bringdaruckus312,1487.86391711,191.068842887,4,2,2,1
bigbeaver,1487.2513869,88.2472194117,28,13,15,4
hhhhhhhhhhhhhhh,1487.21641669,197.694068074,4,2,2,1
lldl,1486.95102744,203.711213547,4,2,2,1
spunker,1485.84029211,208.253133048,3,1,2,1
hoofy,1485.55634104,159.12323025,8,4,4,2
bre,1485.5000704,185.411672963,4,2,2,1
jungle,1484.85521545,194.248997391,4,2,2,1
meerkat,1483.01187756,101.960849962,19,9,10,3
reese,1482.62276963,193.7098164,4,2,2,1
aces,1482.61038909,127.478708205,16,6,10,4
enneielle,1481.66779105,162.838230654,6,3,3,1
sun vulcan,1481.43944803,147.764210178,8,4,4,1
keagsbsmashin,1481.05883983,200.561061709,4,2,2,1
mixxedvegetables,1477.70043163,198.940758483,4,2,2,1
j9d2,1477.6825336,179.468934729,4,2,2,1
marlwolfe,1477.25311504,170.694222831,6,3,3,1
leaf fc,1476.74744026,163.344112178,7,3,4,2
village mascot,1475.99151432,110.281331172,17,8,9,3
frogman [charette],1474.32112758,237.570234401,3,1,2,1
ngwn,1471.97492943,234.584010624,3,1,2,1
fanboy,1470.67424017,233.738406517,3,1,2,1
bacorn,1470.47681825,101.46507796,22,10,12,6
kelvinheit,1469.8516005,146.269094983,16,9,7,2
aisengobay,1469.81832866,185.330007121,4,2,2,1
q!,1468.41895979,96.1064053189,24,11,13,5
jazzy jinx,1467.50984052,189.244664528,4,2,2,1
billbacon420,1465.03380992,230.960047541,3,1,2,1
cortese187,1464.75028036,199.150431212,4,2,2,1
blue bear,1464.72165935,208.777043037,4,2,2,1
hotsauce,1463.75385767,230.628687734,3,1,2,1
fingerblast,1463.52090056,178.378023766,6,3,3,1
derstuk,1463.27293444,155.054957208,10,4,6,3
miniohh!,1462.89072694,188.363154846,4,2,2,1
smashg0d,1462.66441736,222.993222954,3,1,2,1
wowzers,1461.93427962,200.235602328,4,2,2,1
mistertizye,1461.67383883,204.763099292,3,1,2,1
butcher of bakersfield,1460.51268304,146.435433235,9,4,5,1
capos,1460.38623302,104.876404573,16,8,8,3
dankey kang,1460.2508609,216.496679831,3,1,2,1
beans,1459.25714213,109.021676848,16,7,9,2
rebel scum,1458.71332218,133.737001863,9,4,5,1
sebastian,1458.15487762,227.725756314,3,1,2,1
stark,1458.0012749,188.447766856,4,2,2,1
goosewithsocks,1457.3281377,155.162942121,6,2,4,1
kevine,1456.51711405,226.123784479,3,1,2,1
probers,1456.07344234,193.335815794,4,2,2,1
nuggzy,1455.96356686,200.194329709,4,2,2,1
the (.)(.),1454.14323975,164.340077008,6,3,3,1
scratch,1453.66483413,130.174899816,19,8,11,3
kristoff,1453.10601792,122.014739925,14,6,8,3
nalgas,1452.77893905,163.830019431,6,3,3,1
prime,1452.21581662,120.407989782,19,7,12,4
bhol,1449.92513287,147.331340529,7,3,4,1
jinjo,1447.54287148,206.797291997,3,1,2,1
jlo,1446.52789991,166.799794127,6,3,3,1
slartibartfast42,1443.76588304,174.009692207,7,3,4,2
yass2queen,1443.71658896,220.681219258,3,1,2,1
masquerade,1443.70641538,221.286939103,3,1,2,1
lalo,1443.56401511,171.689201456,7,3,4,1
bodacious,1443.48097723,172.697139402,7,3,4,2
frostbyte,1442.5048209,162.070868041,7,3,4,2
qapples,1441.88430297,220.550884317,3,1,2,1
crazyk115,1441.6130996,182.506933041,5,2,3,1
cagt,1441.1172043,148.501081,9,4,5,2
z-rex,1441.07322392,222.201033886,3,1,2,1
thissidedown,1441.07322392,222.414701537,3,1,2,1
rocket,1440.3566686,138.604935116,7,3,4,1
v-bomber,1440.29099204,160.178951214,7,3,4,2
tank,1439.54401546,173.72563777,5,2,3,1
zhu,1439.25187479,206.113279653,3,1,2,1
mando,1437.71076062,138.556898263,10,4,6,2
ego,1436.18492272,218.578503916,3,1,2,1
izoo,1436.05159325,219.143634916,3,1,2,1
arctic,1435.49649116,218.617291277,3,1,2,1
pika,1435.30651143,221.050278443,5,1,4,2
midgetto,1434.60852101,162.97128467,7,3,4,2
chicken,1434.59163694,120.189403624,14,6,8,2
macintosh,1433.30510745,177.831871456,5,2,3,1
kriskringle,1432.19697964,188.716420691,4,2,2,1
boogie!,1430.72269817,153.964670995,8,3,5,1
little bill,1429.52702546,206.487398893,3,1,2,1
gamer4life,1429.40085761,188.297310293,4,2,2,1
yolochi,1428.62849169,216.01030518,3,1,2,1
pintoa,1428.22304884,144.130839046,8,3,5,1
white,1427.89008271,194.291971789,5,2,3,1
thenuge,1426.88434753,146.432252904,8,3,5,1
daddy's milk,1425.96640822,155.092309,9,4,5,2
jam,1424.10390955,178.120573208,5,2,3,1
vidya_james,1423.64410837,215.772766484,3,1,2,1
zenaga,1421.10805245,216.761536882,3,1,2,1
nigel_thornberry,1420.26004726,213.741419171,3,1,2,1
cormander,1418.94582103,127.279659003,11,4,7,2
maliki,1418.81636273,169.692416018,13,7,6,3
cbones,1418.61184812,215.571650919,3,1,2,1
waldo,1418.58502033,164.409599121,5,2,3,1
soulbroker,1418.17198117,206.825539816,3,1,2,1
sombrero,1418.11649692,198.719433108,3,1,2,1
maniac379,1417.82985341,103.638562686,18,7,11,3
apparition the ambassador,1417.6654104,103.974809002,21,8,13,4
lucky_hamburger,1417.58120018,211.663027857,3,1,2,1
brotherly,1417.12425796,206.888341714,3,1,2,1
shyguyking,1415.46203598,159.552449022,8,3,5,1
ondas,1415.17702064,145.724904944,8,3,5,1
-philip coast philip-,1413.16798621,212.435571979,3,1,2,1
paco,1412.90254396,123.838967256,12,5,7,2
maaron,1412.16026165,214.814196087,3,1,2,1
zibba,1412.14026598,215.120367949,3,1,2,1
ardent rage,1412.14026598,215.561528818,3,1,2,1
yrn,1411.37271622,211.68998441,3,1,2,1
swankeaboo,1408.97170446,213.409631096,3,1,2,1
paco [larkin],1407.57233867,213.461613899,3,1,2,1
stew,1407.14320753,135.406421871,9,4,5,1
robnu,1406.79828313,161.700204232,6,2,4,1
elitescoringguy,1406.33314169,150.770492313,8,3,5,1
jmabate,1405.50177134,216.814001773,3,1,2,1
littlespoon,1405.50177134,216.155757186,3,1,2,1
gera,1405.20288962,205.878712306,3,1,2,1
hiv+,1404.53355079,210.241885232,3,1,2,1
maps,1404.11854869,123.173255263,12,4,8,2
ir,1402.31092179,211.255286088,3,1,2,1
moze,1401.51531277,194.79094129,3,1,2,1
mulkster,1401.03336195,220.457627025,3,1,2,1
mr_sharpie93,1401.03336195,220.026283234,3,1,2,1
big d [hamiel],1400.87815102,211.17116061,3,1,2,1
evals,1400.65260968,214.651313516,3,1,2,1
precookedbread,1400.65260968,214.828271869,3,1,2,1
hsf,1400.65260968,214.385602115,3,1,2,1
cooljoe,1400.65260968,214.385602115,3,1,2,1
xiivi,1400.17381886,143.505115873,12,5,7,4
sadu,1400.16218631,228.109542274,3,1,2,1
shasta,1400.16218631,228.733389073,3,1,2,1
heartsdealer,1400.16218631,228.733389073,3,1,2,1
mourin,1400.16218631,228.359285506,3,1,2,1
eggmcmuffin888,1400.16218631,228.733389073,3,1,2,1
zwephy,1400.16218631,228.733389073,3,1,2,1
blahguy,1400.16218631,228.317680605,3,1,2,1
leet,1400.16218631,228.067891814,3,1,2,1
spt,1400.16218631,228.109542274,3,1,2,1
evab,1400.16218631,228.109542274,3,1,2,1
esuma,1400.16218631,228.733389073,3,1,2,1
k-man,1400.16218631,228.733389073,3,1,2,1
burnt out ninja,1400.16218631,228.733389073,3,1,2,1
chaos pro,1400.16218631,228.733389073,3,1,2,1
drlight,1400.16218631,228.733389073,3,1,2,1
hayrow,1400.16218631,228.109542274,3,1,2,1
kavon,1400.16218631,227.734413905,3,1,2,1
nyx,1400.16218631,228.317680605,3,1,2,1
flatline,1400.16218631,228.317680605,3,1,2,1
hungrybox,1400.16218631,229.355539015,3,1,2,2
pastor,1400.16218631,228.733389073,3,1,2,1
anathema,1400.16218631,228.733389073,3,1,2,1
schlag,1400.16218631,228.317680605,3,1,2,1
andy,1400.16218631,228.317680605,3,1,2,1
flare,1400.16218631,228.109542274,3,1,2,1
nathansandwich,1400.16218631,228.733389073,3,1,2,1
firefly,1400.16218631,228.733389073,3,1,2,1
dhir,1400.16218631,228.733389073,3,1,2,1
giraffe,1400.16218631,228.733389073,3,1,2,1
hotpocket,1400.16218631,228.109542274,3,1,2,1
napkins,1400.16218631,228.109542274,3,1,2,1
whoopiecow,1400.16218631,228.359285506,3,1,2,1
java boy,1400.16218631,227.734413905,3,1,2,1
birdlordmasterbeak,1400.16218631,228.109542274,3,1,2,1
castaway,1400.16218631,228.109542274,3,1,2,1
fawnco,1400.16218631,228.733389073,3,1,2,1
zombie!,1400.16218631,228.733389073,3,1,2,1
snazzy,1400.16218631,228.109542274,3,1,2,1
cardoso,1400.16218631,228.359285506,3,1,2,1
yakal,1400.16218631,228.733389073,3,1,2,1
kossismoss,1400.16218631,228.733389073,3,1,2,1
r.o.m.,1400.16218631,228.733389073,3,1,2,1
krutchby,1400.16218631,228.109542274,3,1,2,1
maestro,1400.16218631,228.067891814,3,1,2,1
dr. grin,1400.16218631,228.733389073,3,1,2,1
15(ichigo),1400.16218631,228.317680605,3,1,2,1
myroknpancakes,1400.16218631,228.733389073,3,1,2,1
capsui,1400.16218631,228.109542274,3,1,2,1
changed man,1400.16218631,228.109542274,3,1,2,1
pokeiman_master,1400.16218631,228.109542274,3,1,2,1
jirachinick,1400.16218631,228.733389073,3,1,2,1
kzidek,1400.16218631,228.317680605,3,1,2,1
scruffy mcwonder crumpet,1399.47773873,216.735462982,3,1,2,1
mmneggs,1399.18105362,136.092629904,8,2,6,1
godspeed,1398.77926551,130.919572877,11,4,7,2
tmakk,1397.57837582,124.878110333,13,5,8,3
gato,1396.66763133,214.977190732,3,1,2,1
miken,1396.47551291,269.422638239,1,0,1,1
blackf00t,1396.0553002,169.688162773,6,2,4,1
wal,1395.4225482,218.906996108,3,1,2,1
train_town,1395.27226386,202.077197308,3,1,2,1
chiefreaper,1394.92825753,211.850845916,3,1,2,1
boh,1394.7765604,213.094559329,3,1,2,1
damp,1394.36002994,188.22093032,5,2,3,1
 ô·¥è·¥Ö·¥Ä·¥Ñ…™·¥è·¥ús,1393.32175881,142.613135125,8,2,6,1
sunshinetk,1391.06007338,171.105715692,6,2,4,1
hipo,1390.78950118,209.777151258,3,1,2,1
xanz,1390.78950118,209.777151258,3,1,2,1
mortech,1389.11663181,148.687227311,8,3,5,1
dankpank,1389.00560134,127.69237451,11,4,7,2
mattatari,1387.53169898,216.904993174,3,1,2,1
pzero39,1387.53169898,216.510452551,3,1,2,1
banana fiend,1384.51054013,203.177236969,3,1,2,1
walkrofsky,1383.56286799,152.343523227,6,2,4,1
throwz?!,1381.07122461,216.736249718,3,1,2,1
squible,1377.51185746,162.89820139,7,3,4,1
blisstex,1377.10381768,191.838391281,6,2,4,2
astumpycow,1376.63570722,206.068680265,4,1,3,1
icactusdog,1376.50155363,127.599967217,13,4,9,3
chai,1374.55035024,269.182071985,1,0,1,1
malkasaur,1373.8889909,266.114637456,1,0,1,1
khakis,1373.11621562,183.358602477,6,2,4,3
iceking,1372.49265091,183.786796907,6,2,4,2
krypto,1372.46024808,184.151289599,6,2,4,2
dirtcruncher,1369.20266887,127.073011404,12,4,8,2
drewskii55,1365.86968286,208.918095286,3,1,2,1
gumbolaya!,1365.40105575,216.550944041,3,1,2,1
ocelot,1364.59212593,131.817014351,12,4,8,2
trevman,1364.39508973,216.775658065,3,1,2,1
bogmyer,1364.11256586,179.266028719,5,1,4,1
highlyeducational,1356.95489445,218.885015714,3,1,2,1
tokaji,1356.08703056,226.707937112,3,1,2,1
patty-wagon,1355.41836912,267.670078082,1,0,1,1
dasit mane,1354.69762484,157.582576273,7,2,5,2
grrg,1352.15398011,136.135355838,14,4,10,3
mojo,1351.86864414,186.413698215,5,2,3,1
hotspank,1347.80564028,215.747635628,3,1,2,1
kingcool,1344.75357643,141.044848949,9,3,6,1
chinstrap,1343.66207462,175.726424962,6,2,4,2
the professor,1342.22692138,147.897246006,10,3,7,2
myninja,1341.13533333,170.361612154,6,2,4,1
astumpyzombie,1340.32288332,185.849590026,5,1,4,1
zad,1338.96630715,131.779613435,10,3,7,2
yungpurp,1338.43228722,254.787587941,1,0,1,1
spicky,1337.78799739,290.524950161,1,0,1,1
the cfb,1337.78799739,290.55764775,1,0,1,1
lukem,1337.78799739,290.55764775,1,0,1,1
garv,1337.78799739,291.047670779,1,0,1,1
caelan,1337.78799739,290.753756065,1,0,1,1
akito555,1337.78799739,291.047670779,1,0,1,1
masterofzoroark,1337.78799739,291.047670779,1,0,1,1
dishier wand,1337.78799739,290.55764775,1,0,1,1
homemadewaffles,1337.78799739,291.047670779,1,0,1,1
flat nat,1337.78799739,290.524950161,1,0,1,1
ragingcherry,1337.78799739,291.047670779,1,0,1,1
spell,1337.78799739,290.524950161,1,0,1,1
sabo,1337.78799739,290.55764775,1,0,1,1
fil,1337.78799739,291.047670779,1,0,1,1
refriedjeans,1337.78799739,290.524950161,1,0,1,1
i use tap jump,1337.78799739,290.524950161,1,0,1,1
god,1337.78799739,291.047670779,1,0,1,1
branchan,1337.78799739,291.047670779,1,0,1,1
et,1337.78799739,290.884421491,1,0,1,1
yung,1337.78799739,291.047670779,1,0,1,1
rice,1337.78799739,291.047670779,1,0,1,1
nfreak,1337.78799739,290.55764775,1,0,1,1
bronze_sun,1337.78799739,290.655718447,1,0,1,1
hans_mawell,1337.78799739,290.655718447,1,0,1,1
uprowr,1337.78799739,290.55764775,1,0,1,1
bunmira,1337.78799739,291.047670779,1,0,1,1
neverpullout,1337.78799739,290.524950161,1,0,1,1
akajumo,1337.78799739,290.263236849,1,0,1,1
adubz,1337.78799739,290.55764775,1,0,1,1
4sk,1337.78799739,291.047670779,1,0,1,1
rf!,1337.78799739,290.753756065,1,0,1,1
dude,1337.78799739,290.753756065,1,0,1,1
big tone,1337.78799739,291.047670779,1,0,1,1
electricgazelle,1337.78799739,290.655718447,1,0,1,1
weatherman,1337.51847174,180.241656457,5,1,4,1
spaff,1334.18426314,234.707132588,2,0,2,1
maximum can,1332.54668248,227.15593405,2,0,2,1
milleneum,1332.02546646,181.750354841,5,1,4,1
jaws,1330.72071068,214.23997738,3,1,2,1
mello,1328.69057526,256.617150811,2,0,2,1
danno,1328.17014511,225.814965352,3,1,2,1
yolft,1328.05060258,143.83127632,8,2,6,1
redribb0n,1327.62409232,268.306055931,1,0,1,1
schmerka berl,1326.97398115,150.956641053,11,3,8,3
esmod,1326.74860044,253.642643542,2,0,2,1
jollie,1326.59776966,150.231327601,7,2,5,1
elu,1326.15190477,145.296223838,8,2,6,1
jedisalazar,1325.95174791,250.439644535,2,0,2,1
brambramjam,1325.88253541,199.405756577,4,1,3,1
tdp,1325.52397065,227.966982253,3,1,2,1
bohemian milk,1325.52397065,227.966982253,3,1,2,1
rhubarb,1325.34826449,125.533424877,12,4,8,2
general1712,1323.09110054,167.559273646,6,1,5,1
luwolf,1321.89731169,251.606388286,2,0,2,1
jose,1321.85713863,267.469071763,1,0,1,1
woof,1320.46663096,142.241736948,9,2,7,1
lou sanus,1320.35422977,143.442229121,7,1,6,1
the drew,1319.21049577,126.771414931,11,3,8,2
husker,1318.25487511,153.364945875,6,1,5,1
guccipivotmaster4000,1316.06791925,243.336490671,2,0,2,1
turtle,1314.52618115,241.192869108,2,0,2,1
barrels,1313.37815611,130.762744353,11,3,8,2
oxycontin,1313.08610287,154.456174019,8,2,6,1
moustasher,1308.28766464,139.966359555,10,3,7,2
shug,1305.82497726,179.938217178,5,1,4,2
magnus combosen,1305.67858851,181.616097391,5,1,4,1
kevorkian,1303.68761151,163.555902383,8,2,6,3
mariokartmoney,1303.67100018,205.936452344,5,1,4,2
taiko,1303.37444822,148.358168306,11,3,8,3
nagurnimaster,1302.51162622,241.164370115,2,0,2,1
kobra,1301.10892962,205.185719434,5,1,4,2
jad,1300.24518645,237.408161524,2,0,2,1
stdangerous,1294.82594084,232.753226588,2,0,2,1
tallyshell,1293.05452486,203.779047977,4,1,3,1
yaron,1291.43176644,140.479197004,7,1,6,1
dmolz,1291.17033392,147.564362843,7,1,6,1
seantos,1290.11977687,140.439531433,10,2,8,2
pidgezero_one,1288.758982,152.143797036,9,2,7,2
werewyatt,1288.62436373,163.642196756,6,1,5,1
jedipanda,1288.1495692,154.286579684,6,1,5,1
fig,1287.81765685,170.570421489,6,1,5,1
jackmehoff,1287.59348868,226.758834211,2,0,2,1
putpasswordhere,1287.43001814,199.928405992,5,1,4,2
brendanhall,1284.80077303,274.337750112,1,0,1,1
pilot,1284.80077303,274.441616991,1,0,1,1
eliot,1283.74949781,167.597360459,9,2,7,3
broonz,1282.80824466,151.033792051,8,2,6,2
mrryanness,1281.99361591,195.831173179,5,1,4,2
depressed eagle,1281.96209659,195.37131524,5,1,4,2
xlax,1281.8360817,195.717501857,5,1,4,2
jgin,1281.31502701,227.074981568,2,0,2,1
fen,1279.32434959,171.105715692,6,1,5,1
twunt,1279.13062508,197.346547353,5,1,4,2
silentknight,1278.76763122,203.566063572,5,1,4,2
nami,1278.72792408,231.311570089,2,0,2,1
pugdaddyfre$hlyfeogg*flva,1277.72750189,235.351963939,2,0,2,1
magfmur,1276.924676,238.071663004,2,0,2,1
quinceprince,1276.924676,238.470368653,2,0,2,1
starcutter,1276.924676,238.31096644,2,0,2,1
multiball,1273.46888253,141.165690691,11,3,8,2
bus,1270.89511326,231.859837673,2,0,2,1
wolfcry,1270.3226934,236.424373097,2,0,2,1
scootieloo,1270.21855457,233.608523792,2,0,2,1
nokto,1269.38594106,236.172735183,2,0,2,1
rabizkoshik,1265.14006072,167.308870405,6,1,5,1
gambit,1261.10354673,237.638419489,2,0,2,1
pigwick,1257.04925579,223.638078391,2,0,2,1
whitegrizzly,1255.71222022,235.123404451,2,0,2,1
blank,1255.71222022,235.889837256,2,0,2,1
tbone,1255.71222022,235.889837256,2,0,2,1
dk dredd,1254.66384488,238.5430096,2,0,2,1
katiebug (sfk),1254.6161826,236.115450407,2,0,2,1
charlie,1253.9871933,235.796985235,2,0,2,1
karl,1253.24465459,216.833177586,3,0,3,1
lights,1252.79674799,254.094626834,2,0,2,1
deku,1252.79674799,253.720474905,2,0,2,1
grraffe,1252.79674799,254.28149635,2,0,2,1
hero,1252.79674799,253.945032213,2,0,2,1
shadow light master,1252.79674799,254.28149635,2,0,2,1
mookie,1252.79674799,253.383265797,2,0,2,1
mechanicalmarine,1252.79674799,253.683029361,2,0,2,1
bozz,1252.79674799,253.720474905,2,0,2,1
paper tiger,1252.79674799,254.28149635,2,0,2,1
4 phri,1252.79674799,253.720474905,2,0,2,1
fmax,1252.79674799,254.28149635,2,0,2,1
riseup93,1252.79674799,253.720474905,2,0,2,1
abc,1252.79674799,253.383265797,2,0,2,1
fs mook,1252.79674799,253.683029361,2,0,2,1
astropancakes,1252.79674799,254.28149635,2,0,2,1
laugh,1252.79674799,253.683029361,2,0,2,1
heisenberg,1252.79674799,254.28149635,2,0,2,1
dennysgrandslambreakfast,1252.79674799,253.683029361,2,0,2,1
cr0ak,1252.79674799,254.28149635,2,0,2,1
phalanx,1252.79674799,253.720474905,2,0,2,1
izze,1252.79674799,253.907619787,2,0,2,1
umi,1252.79674799,253.945032213,2,0,2,1
giggitoxin,1252.79674799,253.720474905,2,0,2,1
scraggus,1252.79674799,253.683029361,2,0,2,1
superduperfanofboom,1252.79674799,253.720474905,2,0,2,1
erk,1252.79674799,253.383265797,2,0,2,1
irish,1252.79674799,254.28149635,2,0,2,1
oljace,1252.79674799,253.907619787,2,0,2,1
fs shampoomaster,1252.79674799,253.683029361,2,0,2,1
levity,1252.79674799,253.720474905,2,0,2,1
polarbair,1252.79674799,253.945032213,2,0,2,1
drhino,1252.79674799,254.28149635,2,0,2,1
hail_sagan,1252.79674799,253.720474905,2,0,2,1
m2cain,1252.79674799,253.383265797,2,0,2,1
blizz,1252.79674799,253.945032213,2,0,2,1
myk,1252.79674799,254.094626834,4,0,4,2
ppdmd,1252.79674799,254.094626834,2,0,2,1
youtwo,1252.79674799,253.832778391,2,0,2,1
turtlpower,1252.79674799,253.945032213,2,0,2,1
sleeh,1252.79674799,254.28149635,2,0,2,1
master jay,1252.79674799,254.094626834,2,0,2,1
black rob,1252.79674799,253.720474905,2,0,2,1
maxi,1252.79674799,254.094626834,2,0,2,1
ferrero64,1252.79674799,254.28149635,2,0,2,1
sad,1252.79674799,253.720474905,2,0,2,1
instacover,1252.79674799,253.907619787,2,0,2,1
voidstar,1252.79674799,253.383265797,2,0,2,1
da bear,1252.79674799,253.495718674,2,0,2,1
nikku,1252.79674799,253.720474905,2,0,2,1
searcher,1252.79674799,253.832778391,2,0,2,1
zombieheart84,1252.79674799,254.28149635,2,0,2,1
uncle onion,1252.79674799,253.907619787,2,0,2,1
fry,1252.79674799,254.28149635,2,0,2,1
flash,1252.79674799,253.907619787,2,0,2,1
kayo,1252.79674799,253.683029361,2,0,2,1
juan doe,1252.79674799,253.720474905,2,0,2,1
urpasmash,1252.79674799,253.945032213,2,0,2,1
zarfon,1252.79674799,254.28149635,2,0,2,1
sam,1252.79674799,253.683029361,2,0,2,1
lunchy,1252.79674799,254.28149635,2,0,2,1
waffles,1252.79674799,254.28149635,2,0,2,1
scuttlebug jamboree,1252.79674799,253.720474905,2,0,2,1
holosly,1252.79674799,254.094626834,2,0,2,1
rickter_scale,1252.79674799,254.094626834,2,0,2,1
aubfox,1252.79674799,254.28149635,2,0,2,1
matt47,1252.79674799,254.28149635,2,0,2,1
jobook,1252.79674799,253.720474905,2,0,2,1
red,1252.79674799,254.28149635,2,0,2,1
darv,1252.79674799,254.094626834,2,0,2,1
charlie harper,1252.79674799,254.094626834,2,0,2,1
swerve,1252.79674799,253.683029361,2,0,2,1
ebay,1252.79674799,254.094626834,2,0,2,1
sambook,1252.79674799,253.720474905,2,0,2,1
sharktoast,1252.79674799,254.28149635,2,0,2,1
jfm,1252.79674799,253.683029361,2,0,2,1
sven stormbeard,1252.79674799,253.945032213,2,0,2,1
5000candlesinthewind,1252.79674799,254.28149635,2,0,2,1
tylenol jones,1252.79674799,253.720474905,2,0,2,1
amaya,1252.79674799,253.720474905,2,0,2,1
avian,1252.79674799,253.907619787,2,0,2,1
d-tek,1252.79674799,254.28149635,2,0,2,1
kl3an,1252.79674799,254.28149635,2,0,2,1
phex,1252.79674799,254.28149635,2,0,2,1
marfslayer 3000,1252.79674799,253.907619787,2,0,2,1
miles,1252.79674799,253.907619787,2,0,2,1
duck chris,1252.79674799,253.945032213,2,0,2,1
tydye,1252.79674799,253.907619787,2,0,2,1
themickeynick,1252.79674799,254.28149635,2,0,2,1
zurdo,1252.79674799,253.383265797,2,0,2,1
kezzup,1252.79674799,253.720474905,2,0,2,1
mr.e [rohr],1252.79674799,253.720474905,2,0,2,1
digital cannon,1252.79674799,253.720474905,2,0,2,1
bean,1252.79674799,254.28149635,2,0,2,1
ubll black mage,1252.79674799,253.945032213,2,0,2,1
beaver,1252.79674799,254.094626834,2,0,2,1
jpoptosis,1252.79674799,254.28149635,2,0,2,1
atari,1252.79674799,254.28149635,2,0,2,1
smashlopez64,1252.79674799,253.945032213,2,0,2,1
qk shkz,1252.79674799,253.945032213,2,0,2,1
skubtard,1252.79674799,254.28149635,2,0,2,1
liam_butler,1252.79674799,254.28149635,2,0,2,1
yam$,1252.79674799,254.28149635,2,0,2,1
tuna,1252.79674799,253.945032213,2,0,2,1
sfgman,1252.79674799,254.28149635,2,0,2,1
yuxminato,1252.79674799,254.28149635,2,0,2,1
link,1252.79674799,253.683029361,2,0,2,1
benbook,1252.79674799,253.720474905,2,0,2,1
alex,1252.79674799,253.683029361,2,0,2,1
draxsel,1252.79674799,254.094626834,2,0,2,1
goomah,1252.79674799,253.832778391,2,0,2,1
j,1252.79674799,254.28149635,2,0,2,1
blues,1252.79674799,254.28149635,2,0,2,1
harmless,1252.79674799,254.28149635,2,0,2,1
aperture,1252.79674799,254.28149635,2,0,2,1
bunnyblast,1252.79674799,253.720474905,2,0,2,1
edwin...,1252.79674799,254.28149635,2,0,2,1
azzy,1252.79674799,254.28149635,2,0,2,1
theycallmechris,1252.79674799,253.945032213,2,0,2,1
beekle,1252.79674799,254.28149635,2,0,2,1
monk,1252.79674799,254.28149635,2,0,2,1
bc_burns,1252.79674799,254.094626834,2,0,2,1
colt,1252.79674799,253.945032213,2,0,2,1
jojohnson,1252.79674799,253.907619787,2,0,2,1
scott,1252.79674799,253.720474905,2,0,2,1
uh what,1252.79674799,254.28149635,2,0,2,1
thac0,1252.79674799,253.720474905,2,0,2,1
snack?,1252.79674799,254.094626834,2,0,2,1
duckpimp,1252.79674799,254.094626834,2,0,2,1
whiz kid,1252.79674799,254.28149635,2,0,2,1
dd,1252.79674799,254.28149635,2,0,2,1
armor,1252.79674799,254.28149635,2,0,2,1
jazz,1252.79674799,254.28149635,2,0,2,1
muthaluva777,1252.79674799,253.683029361,2,0,2,1
yung god,1252.79674799,253.383265797,2,0,2,1
thegoat,1252.79674799,253.720474905,2,0,2,1
warmachine1919,1252.79674799,253.720474905,2,0,2,1
sunshine,1252.79674799,253.945032213,2,0,2,1
raxcity,1252.79674799,254.28149635,2,0,2,1
big d squirrels,1252.79674799,254.28149635,2,0,2,1
legoman,1252.79674799,254.094626834,2,0,2,1
akiva,1252.79674799,254.28149635,2,0,2,1
grunyan,1252.79674799,254.28149635,2,0,2,1
hyperbole,1252.79674799,253.720474905,2,0,2,1
missingn0,1252.35585395,235.090492834,2,0,2,1
frogge,1246.44240502,229.935213861,2,0,2,1
scaryman,1238.62194243,159.396349647,7,1,6,1
bear,1234.46300657,192.73028228,5,1,4,2
ham,1233.56818195,174.877633739,7,1,6,3
lonk,1229.00582463,240.779752568,2,0,2,1
curiousplaces,1229.00582463,240.779752568,2,0,2,1
lloyd-black,1228.05963857,133.362288508,10,2,8,2
mike4real,1222.34270831,236.460349063,2,0,2,1
papa,1221.45440411,187.060373186,4,0,4,1
robslabgod,1220.10236201,225.574107,2,0,2,1
pvc,1218.58028363,242.719678044,2,0,2,1
juno,1218.58028363,243.110760992,2,0,2,1
dunos_,1218.58028363,242.719678044,2,0,2,1
jerzilla,1218.48500189,241.838311565,2,0,2,1
fumofuu,1214.47059913,241.206819308,2,0,2,1
rocktimus crime,1210.68384144,172.233999381,5,0,5,1
deep dimples,1210.48571645,171.958976931,5,0,5,1
recneps,1209.86610807,152.71375797,8,1,7,2
jeremy,1209.85229848,204.602928741,4,0,4,1
ohhhbreezy,1208.42361941,159.110724722,7,1,6,1
mikeyg,1207.10695142,222.200397124,2,0,2,1
nnaughtydogg,1207.01473651,160.920095447,6,0,6,1
kohenbro,1205.82351152,181.750354841,5,0,5,1
jet fuel,1205.41166476,147.892786629,8,1,7,1
paul d,1205.4102451,223.036934033,4,0,4,1
sianvar,1201.49536799,244.586596103,2,0,2,1
russellsprouts,1200.26170567,177.224573667,4,0,4,1
vondo,1199.86583743,160.268402668,6,0,6,1
neph_girl,1198.39422729,142.638701373,7,0,7,1
nyani,1194.88428227,233.394371028,3,0,3,2
2%gay,1192.74212163,166.44968355,6,0,6,1
adulix,1190.1171937,181.037755838,5,0,5,1
ryden hope,1180.39885302,242.691726599,2,0,2,1
kraken,1180.39885302,242.691726599,2,0,2,1
dr gibs,1180.02212929,179.390455459,5,0,5,1
mjim,1178.99359756,174.821462308,5,0,5,1
bagel,1172.47825637,164.404965482,6,0,6,1
jpeghero,1169.95150921,162.572872958,9,1,8,2
failcant,1169.65177662,237.626581518,2,0,2,1
bung0o,1168.89807535,159.993443727,6,0,6,1
elrond,1168.10348933,143.779709628,7,0,7,1
bennyboy98,1164.82195562,245.845895574,2,0,2,1
bulldog,1160.87371869,253.351862459,2,0,2,1
thisisgettingold,1160.87371869,253.351862459,2,0,2,1
sweaters,1160.87371869,253.464329268,2,0,2,1
redwolf,1160.87371869,253.314362426,2,0,2,1
tweli,1160.87371869,253.351862459,2,0,2,1
thedarkdreamer,1160.87371869,253.351862459,2,0,2,1
cat,1158.74393027,179.562248964,5,0,5,1
sugaaku,1152.90063324,216.902904633,4,0,4,2
djltheescapade,1151.90711445,190.757722302,5,0,5,2
falln,1141.82963552,239.106920707,2,0,2,1
jonnjonn,1131.12267733,173.277232089,5,0,5,1
jimbot,1129.21436418,155.085397056,7,0,7,1
blanco mano,1120.78651453,168.44398204,6,0,6,1
tehz,1112.88419157,183.438069724,6,0,6,2
shwang,1105.98818033,187.501038404,6,0,6,2
nardwell,1101.33078882,120.584850603,21,2,19,5
golfclubninja,1063.634122,182.679526168,8,0,8,3
bonerstorm,980.718163189,350,6,3,3,2
