player,rating,rd,sets,wins,losses,tournaments
superboomfan,2149.68809912,71.3532659763,110,106,4,12
alvin,2014.840427,96.1081399792,20,17,3,2
mariguas,1937.69940432,70.920282567,51,41,10,5
wizzrobe,1912.35361905,68.1829543843,69,54,15,9
isai,1906.89329917,83.8739668932,33,27,6,3
kerokeroppi,1869.42291841,65.0449197016,80,61,19,9
tr3gthez,1869.16328776,80.1187583301,58,45,13,6
tacos,1868.47700802,72.5271923003,51,39,12,6
barksanchez,1864.48658736,68.7388341946,42,30,12,5
dext3r,1861.10570228,78.8975227168,37,28,9,4
zantetsu,1854.99795056,108.591209146,17,13,4,2
wario,1854.0221633,144.573041605,11,10,1,1
vinsanity,1846.19341828,146.063035911,8,6,2,1
kurabba,1840.17281464,148.620114555,9,7,2,1
stranded,1835.23097009,89.8305378391,32,26,6,4
dtan,1833.66424022,98.8292470189,19,14,5,2
revan,1821.7797655,68.791528484,70,53,17,8
lowww,1813.14333142,139.106368101,9,7,2,1
prince,1813.10573268,140.575964575,9,7,2,1
wangera,1806.13160282,102.696884962,21,16,5,2
fireblaster,1798.86332897,64.6363776568,94,68,26,12
heropie,1792.6899803,104.641633006,16,12,4,2
marbles,1782.3941421,82.4306321517,32,23,9,4
derek #squats,1780.09896152,101.361799447,36,25,11,4
handsometom,1771.38717175,108.638455689,30,19,11,4
fox,1764.93593515,96.3012513128,24,17,7,3
bark the shark,1763.33175924,79.1417732755,54,39,15,7
firo,1762.07049906,88.5292532761,23,15,8,3
cobr,1755.33392357,119.328859422,23,15,8,3
$$$ jim $$$,1747.59986257,97.7270919315,17,12,5,2
jaimehr,1747.36238605,83.6415185199,30,21,9,4
combo blaze,1746.78646918,85.0296343843,30,20,10,4
janitor,1742.60830403,82.5959360967,33,24,9,4
sotoh,1739.05500803,92.0463668405,27,18,9,4
mojomonkey,1737.76478405,145.154444776,8,6,2,1
hero pie,1731.20994763,109.203835586,17,11,6,2
lorenzo,1728.92775441,95.3687262086,22,15,7,3
bonobono,1726.70743493,144.574576229,7,5,2,1
dark gentleman,1726.06168242,134.607804748,11,7,4,2
shears,1725.71531121,63.8441264214,78,50,28,11
star king,1724.04819483,171.464814716,17,11,6,2
janco,1723.40310426,124.049314657,25,14,11,4
nta,1722.69983492,172.949602693,16,11,5,2
spark,1721.844228,148.331533648,7,5,2,1
kort,1720.69478629,111.881774572,17,11,6,2
nothing,1718.22928798,103.077855026,21,15,6,3
kimimaru,1716.06998225,106.520552526,18,13,5,2
near,1712.67877469,129.086714036,10,7,3,1
finio,1712.31023663,157.985111099,7,5,2,1
letsgo,1710.89104032,180.291142054,6,3,3,1
nacl,1707.69126521,105.474226682,18,12,6,3
sheermadness,1704.78928313,153.645258965,7,5,2,1
nintendude,1703.58450939,79.5583647854,48,29,19,7
facechew,1699.3193371,163.929403172,7,5,2,1
banze,1697.89151596,113.15642126,16,11,5,2
robert,1696.61069545,96.7069798343,22,15,7,3
fumbles,1689.14414511,141.864387412,8,5,3,1
kyle tree,1687.01599912,117.607826269,14,9,5,2
wookiee,1686.36783883,89.2917937676,27,18,9,4
a$,1685.29805196,167.219016955,6,4,2,1
battlecow,1684.80895566,135.064973965,8,5,3,1
spongy,1684.35377176,118.092586667,13,9,4,1
jason,1682.41186519,89.4124972813,28,19,9,4
shalaka,1681.55076807,115.781119736,16,10,6,2
hipstur,1680.45574995,81.3220927722,35,24,11,5
box765,1679.34900343,138.428385281,9,6,3,1
stonefallow,1677.89642688,139.735002016,11,7,4,2
zero,1676.35627026,114.757434461,17,11,6,2
amida,1674.81167695,102.817030888,20,13,7,3
poobearninja,1670.23087474,132.163000167,13,9,4,2
jay-r,1669.30795467,172.572251236,7,5,2,1
smash jesus,1669.00735843,125.340979722,14,10,4,2
connor,1660.27083426,102.50951378,19,12,7,3
fishaman p,1659.83609274,109.829562041,15,9,6,2
ybombb,1654.44040011,127.368864291,28,19,9,4
loto,1654.19157934,169.453973272,6,4,2,1
pugs,1654.07891615,111.198243402,13,8,5,2
jay_mute$,1653.9028344,112.253525633,14,9,5,2
yobolight,1651.22812853,107.264644505,19,12,7,3
josephzander,1650.3417574,129.99963892,9,6,3,1
gildo,1649.69851447,108.349352761,18,12,6,2
lord narwhal,1647.0559715,96.1317526596,23,14,9,3
dajjal,1645.90005141,93.5534942799,24,15,9,3
the american patriot,1645.56483791,179.09196903,6,4,2,1
nattybroh,1644.0840776,118.863965034,13,9,4,1
v,1640.86359075,160.887844269,6,4,2,1
eg,1639.71206227,102.116324301,17,11,6,2
kraines,1638.60700335,198.796968875,4,3,1,1
xyk,1638.41460518,177.037819085,6,4,2,1
tonester,1638.36104227,145.565046526,11,7,4,2
the big d,1638.31033548,177.412261629,18,12,6,3
hotline,1637.32593147,168.338970284,6,4,2,1
kaz,1636.66758961,116.959604403,13,8,5,2
b33f,1636.60564274,106.033614449,17,11,6,2
piratetrips,1634.57541719,114.087869936,12,8,4,1
esid,1633.42250722,150.642670464,9,6,3,1
mr.sir,1629.59418436,75.5640097196,60,34,26,10
onski,1627.62848196,95.0706297115,25,15,10,4
sextc,1627.57075506,152.351119842,24,15,9,3
llcstoism,1627.09499193,111.792828498,15,9,6,2
mokkori,1626.6347393,182.632308241,6,4,2,1
shihman,1626.54481148,92.1002086514,28,18,10,4
jimmy joe,1626.3366374,83.2008622391,31,18,13,5
bard,1625.68663118,92.1965142116,25,16,9,5
sunnyb,1624.27956609,142.305908316,8,5,3,1
dogs_johnson,1623.45332445,105.308246729,18,11,7,3
socrates,1622.5832294,181.776416093,15,9,6,3
madrush21,1621.23023998,73.2746560712,43,24,19,7
b0n,1620.14786597,170.551328145,18,12,6,3
rossi,1617.706257,175.907808936,5,3,2,1
clubbadubba,1617.66899376,114.878317846,15,9,6,2
d35,1616.48716589,87.8003580771,28,17,11,4
freean,1614.79910606,113.22202365,19,12,7,3
b link,1614.27935923,150.565355727,21,12,9,3
bowl,1613.64150942,128.413789253,13,8,5,2
darkhorse,1613.59534156,85.1433015409,30,18,12,5
kyle,1613.16758913,181.601403272,15,9,6,3
snorlax,1612.09331573,106.461016573,32,18,14,5
preston,1611.66907255,97.3684133129,35,20,15,6
saltsizzle,1610.1766032,97.7738536139,18,10,8,3
quickcav,1609.30298426,145.114210195,9,6,3,1
1000,1609.18692098,189.221952712,15,9,6,3
jxc,1608.60034052,169.691405051,6,4,2,1
a to the z,1608.03665408,95.7749089451,21,11,10,3
ivor,1608.0086602,172.978122015,15,9,6,3
monte,1607.34582104,147.817535783,7,4,3,1
monte,1607.34582104,147.817535783,7,4,3,1
komotonoto,1606.98718769,137.814833621,9,5,4,1
natendo,1605.96564751,170.389927779,6,4,2,1
greeno,1605.92605671,101.448998997,21,13,8,3
sedda,1604.70331931,133.470812916,18,11,7,3
dogg,1603.48443017,110.240844415,14,8,6,2
heny935,1602.62870545,164.965832939,6,4,2,1
masterhandjob,1602.34246622,94.3574346708,26,15,11,4
duffman,1602.09904053,174.368180612,5,3,2,1
freddy cougar,1601.06859103,190.88727716,5,3,2,1
the dark gentleman,1600.60106475,158.550027958,7,4,3,1
supa,1599.45661256,113.131708481,15,8,7,3
umbra,1596.50943528,142.167931845,10,6,4,2
ctg,1594.7394614,105.7587237,25,14,11,5
broly,1594.47703867,189.446959174,15,9,6,3
bamster,1593.95162771,178.290832034,5,3,2,1
sax,1592.72929707,144.181788786,8,5,3,1
tafokints,1591.8996249,216.923455552,3,2,1,1
a la carte,1591.82421397,151.583963389,9,5,4,2
cyoonit,1591.38535166,147.661669726,7,4,3,1
mustard tiger,1591.05115801,143.7672627,10,6,4,2
kirbstomper,1590.72162031,142.005065816,9,5,4,2
dpb,1589.76072277,189.341002845,5,3,2,1
satan [turner],1588.9363881,157.007331524,7,4,3,1
chuck lubs,1588.83820748,188.109119643,5,3,2,1
studstill,1588.60372759,142.740548609,11,7,4,2
shanks,1586.11450375,133.707587118,12,7,5,2
limesoda,1586.10712094,108.651595014,16,9,7,3
gravyfingers,1583.62932869,149.028142044,7,4,3,1
smurf,1582.87719171,91.1069207169,29,17,12,5
elated,1582.51992656,138.561738537,10,6,4,1
tyhiggz,1581.88556779,102.034771227,17,9,8,3
fudgeball,1581.43679151,159.69610115,5,3,2,1
iheartqueso,1579.65697717,151.470837839,9,5,4,2
mr. slimey,1579.58792934,198.084704323,4,2,2,1
knitephox,1578.72752039,118.523241051,17,10,7,3
moogle,1578.69539633,187.339206223,5,3,2,1
zuko,1576.62989096,102.981810945,23,12,11,4
b.i.,1575.89269955,134.778325452,11,7,4,1
elel,1574.77251965,147.729597476,10,6,4,2
skyfire,1574.38440114,185.461136741,5,3,2,1
zyrg,1574.19886086,142.76010842,10,6,4,1
no~m,1574.01605654,187.67573768,15,9,6,3
p21/c,1573.75718595,124.005115247,15,9,6,2
blaise,1572.10991729,194.731533917,5,3,2,1
king lumsy,1572.10991729,194.487455384,5,3,2,1
dragoniota,1572.10991729,194.975306902,5,3,2,2
sheick,1572.10991729,194.731533917,5,3,2,1
autobaun,1572.10991729,194.731533917,5,3,2,1
tvdonk,1572.10991729,194.731533917,5,3,2,1
xor,1572.10991729,194.731533917,5,3,2,1
nattyb,1572.10991729,194.731533917,5,3,2,1
shyboy,1572.10991729,194.731533917,5,3,2,1
sebula4,1572.10991729,193.998377059,5,3,2,1
t0mmii,1572.10991729,194.731533917,5,3,2,1
kingkool,1572.10991729,194.731533917,5,3,2,1
zergos,1572.10991729,194.291971789,15,9,6,3
batterybird,1572.10991729,194.731533917,5,3,2,1
ern,1572.10991729,194.731533917,5,3,2,1
toro,1572.10991729,194.243070151,5,3,2,1
toronto joe,1572.10991729,194.731533917,5,3,2,1
vudujin,1572.10991729,194.731533917,5,3,2,1
eggmode,1571.85493138,103.629064308,19,11,8,3
subtle,1569.34053995,150.585006222,10,5,5,2
gt,1568.64391487,77.7070830439,32,18,14,5
dubs,1567.77616588,138.301202694,12,7,5,2
g0d,1567.77369899,191.242573026,4,2,2,1
travkid,1567.62585661,222.054951051,2,1,1,1
daniel,1567.54093582,111.927040578,19,11,8,3
pathall,1567.28804249,196.014668548,4,2,2,1
touque,1567.26948004,178.17548071,5,3,2,1
rgood,1567.1892753,186.638960362,5,3,2,1
coin chaser,1566.80634848,186.350242136,5,3,2,1
dizzle,1566.5111977,145.675451584,14,7,7,3
handles,1563.59539527,115.333415071,15,9,6,2
dr. lampy,1563.41505141,187.265133794,5,3,2,1
nesskhalifa,1563.02871947,154.901183174,19,11,8,4
killahertz,1562.57993192,127.343789434,13,7,6,3
rusty,1561.63781769,104.947571223,17,9,8,3
fancy,1560.64369567,184.033511648,5,3,2,1
bread,1560.63417857,119.158873189,14,8,6,2
giraphe,1559.79773079,182.143871767,5,3,2,1
gaijilla,1559.32347324,206.208082329,4,2,2,1
se√±orhen10r,1559.07142197,153.824061264,7,4,3,1
starchild,1559.01149625,119.120047337,15,9,6,2
scoback,1558.989329,127.761108408,12,6,6,2
tot,1558.4585112,130.321319326,13,7,6,2
wazzberry,1557.43947197,185.878530446,5,3,2,1
waxy:joe,1556.70848495,138.882843394,10,6,4,1
pete,1556.43598489,172.572251236,7,4,3,1
rith,1556.43598489,172.572251236,7,4,3,1
notlightningrunner,1554.97095163,185.815794454,5,3,2,1
the protagonist,1554.51599585,125.147298278,13,7,6,2
annex,1554.43485117,102.573845281,21,12,9,3
dfx,1554.41983221,109.958022008,27,15,12,5
stonehaus,1554.14116805,184.940058198,5,3,2,1
thrillhouse,1554.09654997,132.844327394,9,5,4,1
bon,1550.9488379,125.751713705,12,6,6,2
pewpewu,1548.49833418,145.775213515,9,5,4,2
sonicfuzz,1548.06895708,122.443911939,14,8,6,2
commander,1547.41094978,183.057697586,5,3,2,1
pluto,1547.24087673,195.353113483,4,2,2,1
zbl_mystic,1546.34917274,171.445111113,5,3,2,1
vanillarin,1546.27234155,157.432017817,17,9,8,4
purtle,1545.93816807,163.816619695,6,3,3,1
yunque,1544.48950742,134.748914482,11,6,5,2
pochilin,1542.73675285,207.97236989,8,3,5,2
darkneon,1542.16369615,178.288144709,5,3,2,1
tbq,1541.98859366,150.02113251,9,5,4,1
nasian,1539.55575999,184.041039731,4,2,2,1
dusttin,1536.32902351,123.123158263,14,7,7,3
captain l,1536.24250012,135.161132778,12,6,6,2
korobeniki,1536.11030849,122.980380315,15,7,8,3
boomalready1,1536.0757905,143.220961133,9,5,4,1
t brett,1535.42648184,152.228130157,9,5,4,2
grahamaglam,1534.1427675,123.297851399,11,5,6,2
moonshoe,1534.09192738,142.086815707,9,5,4,2
professor_wizard,1533.79993415,106.43462339,16,9,7,2
cwic-beam,1533.38685949,158.732213776,16,8,8,4
whitejesus,1532.8897159,116.920731089,14,6,8,2
fck vwls,1532.05485027,118.623270015,28,14,14,5
luka,1531.96766465,203.777271664,12,6,6,3
jamjar,1531.76244049,94.2034478364,30,16,14,6
sandman,1529.6048996,180.091185696,5,3,2,1
th3kuzinator,1527.81811604,128.052142328,12,6,6,2
blondekid,1527.25115267,165.022104228,6,3,3,2
vanddar,1527.06481915,198.350799936,4,2,2,1
horbie,1526.45757969,162.029916595,6,3,3,1
cmull,1525.64315003,140.228558116,8,4,4,1
justin,1525.61049628,175.559733095,5,3,2,1
shishkabobs5,1524.08105204,195.988774797,4,2,2,1
drewgong,1523.74623534,156.570691845,10,4,6,3
captain fabulous,1523.2887156,113.922776269,26,12,14,5
kabal,1523.25241065,152.039399645,7,4,3,1
bunz,1522.5506471,202.443836219,4,2,2,1
mr.watchandlearn,1522.24881677,202.032796488,4,2,2,1
hypa,1518.78967376,191.501750335,4,2,2,1
daniels,1518.67897452,103.577203711,32,17,15,7
pizza,1518.19768228,107.448508339,20,10,10,5
spaghetti,1514.3495117,181.226143417,5,2,3,1
cyan can,1513.30492218,200.669269037,4,2,2,1
kaladin,1511.42393302,193.388084977,4,2,2,1
kaddy,1511.07538074,239.35427267,2,1,1,1
synth,1511.02635095,174.840956504,4,2,2,1
shake,1510.85494991,199.463234004,12,6,6,3
stevie g$üëåüëåüëåüëåüëåüëåüëåüëå,1509.91324491,203.44472891,4,2,2,1
kd3,1507.78033368,200.754709426,4,2,2,1
barron,1503.73822577,203.464071992,4,2,2,1
rizner,1501.96053357,111.21179179,19,10,9,4
reptar,1501.74737372,155.381923599,8,4,4,2
savior,1501.40438739,200.291170176,4,2,2,1
cuppajoe,1500.76115734,199.348330842,7,3,4,2
duncs,1500.50400811,116.843430616,16,8,8,3
purple fox,1500.22842496,187.162256305,4,2,2,1
dwreck,1500.0,209.663360564,4,2,2,1
blueman,1500.0,209.255166634,12,6,6,3
dankestdad,1500.0,209.663360564,4,2,2,1
poptartplug,1500.0,208.982594402,4,2,2,1
imdabes,1500.0,209.663360564,4,2,2,1
ravioli,1500.0,209.20976259,4,2,2,1
mr. biz,1500.0,209.663360564,4,2,2,1
therapture_,1500.0,209.663360564,4,2,2,1
beguiler,1500.0,209.118924928,4,2,2,1
collin the conqueror,1500.0,209.663360564,4,2,2,1
h2o,1500.0,209.255166634,12,6,6,3
snowstorm,1500.0,209.663360564,4,2,2,1
salt,1500.0,209.255166634,12,6,6,3
qtip,1500.0,253.907619787,2,1,1,1
moist,1500.0,209.436684378,4,2,2,1
leavescat,1500.0,163.108491562,8,4,4,1
tetsu0,1500.0,209.663360564,4,2,2,1
the amazing busterino,1500.0,209.663360564,4,2,2,1
satch,1500.0,208.937131126,4,2,2,1
klms,1500.0,209.663360564,4,2,2,1
rawdog,1500.0,181.79812984,6,3,3,1
wincancel,1500.0,209.255166634,12,6,6,3
geekliftus,1500.0,209.663360564,4,2,2,1
adrian,1500.0,209.255166634,12,6,6,3
logic,1500.0,209.663360564,4,2,2,1
qubit,1500.0,209.663360564,4,2,2,1
swiftbass,1500.0,209.663360564,4,2,2,1
hamburglar,1500.0,208.982594402,4,2,2,1
bottle opener guy,1500.0,209.663360564,4,2,2,1
weedwack,1500.0,209.663360564,4,2,2,1
pizzajokes,1500.0,209.663360564,4,2,2,1
rythemretrn,1500.0,209.255166634,12,6,6,3
jaquarium,1500.0,209.436684378,4,2,2,1
clefairy as mew,1500.0,208.982594402,4,2,2,1
tauvalian,1500.0,209.436684378,4,2,2,1
morino,1500.0,182.632308241,6,3,3,1
nich,1500.0,208.982594402,4,2,2,1
karlthemarx,1500.0,209.436684378,4,2,2,1
nuro,1500.0,181.79812984,6,3,3,1
hoofydough,1500.0,209.663360564,4,2,2,1
dezno,1500.0,253.832778391,2,1,1,1
funkykong,1500.0,208.982594402,4,2,2,1
quitrage,1500.0,209.663360564,4,2,2,1
han,1500.0,209.663360564,4,2,2,1
mrpoo,1500.0,209.20976259,4,2,2,1
kman,1500.0,209.118924928,4,2,2,1
steamfriedasian,1500.0,209.663360564,4,2,2,1
truffleshuffle,1500,350,5,2,3,1
costaricancool,1500,350,5,2,3,1
bp,1500,350,6,3,3,1
phut,1500,350,6,3,3,1
massimo,1500,350,4,1,3,1
stephanie,1500,350,1,0,1,1
bubby,1500,350,3,1,2,1
jdeezel,1500,350,2,0,2,1
lecceo,1500,350,3,1,2,1
sph,1500,350,5,2,3,1
zarc,1500,350,3,1,2,1
peasantloaf,1500,350,5,3,2,1
driftintheabyss,1500,350,2,0,2,1
whuck,1500,350,6,3,3,1
dount,1500,350,6,3,3,1
locamash,1500,350,2,0,2,1
imperium,1500,350,1,0,1,1
puddn,1500,350,2,0,2,1
dimension,1500,350,3,1,2,1
elvis,1500,350,6,4,2,1
mahie,1500,350,0,0,0,1
gaymer,1500,350,2,0,2,1
hbrw-hammer,1500,350,3,1,2,1
zeppelin,1500,350,8,5,3,1
master j.j.,1500,350,2,0,2,1
jc_chill,1500,350,4,2,2,1
hotahota,1500,350,5,3,2,1
7blanks,1500,350,6,3,3,1
superkirby,1500,350,3,1,2,1
elmustachio,1500,350,3,1,2,1
pandemonium,1500,350,4,2,2,1
zane,1500,350,2,0,2,1
mr. wang,1500,350,6,4,2,1
ibc,1499.96787681,155.046307074,8,4,4,2
hariballz,1499.08576972,155.17416262,8,4,4,1
k-nut,1498.86896074,155.287566446,7,4,3,1
sunflower,1498.62230975,129.61373331,19,8,11,5
brny,1497.24662392,186.43463262,4,2,2,1
lookalike,1496.89817111,160.248349717,8,4,4,2
razz,1496.48306306,129.125422651,12,6,6,2
breakthrough,1496.11487725,199.998241092,4,2,2,1
spamus,1494.5502653,190.654150254,4,2,2,1
tootmoses,1494.44057704,192.388746989,4,2,2,1
deathcpo,1494.24801026,113.696392324,14,7,7,2
weirdy man,1491.19257331,199.998699884,4,2,2,1
bflakes,1490.82744599,183.976132374,4,2,2,1
jsmirk,1490.57918605,126.723592536,13,6,7,2
neth,1490.42168474,198.578310065,12,6,6,3
prism,1490.28847226,246.567591234,3,1,2,1
droc,1489.16263168,193.946849852,4,2,2,1
moosh_da_moosh,1488.31179879,195.742836765,4,2,2,1
bringdaruckus312,1487.86391711,191.068842887,4,2,2,1
hhhhhhhhhhhhhhh,1487.21641669,197.694068074,4,2,2,1
lldl,1486.95102744,203.711213547,4,2,2,1
spunker,1485.72078841,208.206185017,3,1,2,1
hoofy,1485.55634104,159.12323025,8,4,4,2
bre,1485.5000704,185.411672963,4,2,2,1
jungle,1484.85521545,194.248997391,4,2,2,1
bigbeaver,1483.8984856,87.6899340655,28,13,15,4
meerkat,1482.94715377,101.958739533,19,9,10,3
reese,1482.62276963,193.7098164,4,2,2,1
aces,1482.61212079,127.478939992,16,6,10,4
enneielle,1481.66779105,162.838230654,18,9,9,3
keagsbsmashin,1481.05883983,200.561061709,12,6,6,3
sun vulcan,1480.27160609,147.627946001,8,4,4,1
mixxedvegetables,1477.70043163,198.940758483,4,2,2,1
j9d2,1477.6825336,179.468934729,4,2,2,1
marlwolfe,1477.25311504,170.694222831,18,9,9,3
leaf fc,1476.74744026,163.344112178,7,3,4,2
village mascot,1475.89555411,110.269042687,17,8,9,3
ngwn,1471.34896512,234.192995806,3,1,2,1
bacorn,1470.47662163,101.465874568,22,10,12,6
fanboy,1470.15233621,233.417074169,3,1,2,1
aisengobay,1469.75446919,185.322408909,4,2,2,1
kelvinheit,1469.21081341,146.093327041,16,9,7,2
jazzy jinx,1467.50984052,189.244664528,4,2,2,1
q!,1466.35826573,95.2658473629,24,11,13,5
billbacon420,1465.057046,230.973921286,3,1,2,1
cortese187,1464.75028036,199.150431212,12,6,6,3
blue bear,1464.72165935,208.777043037,4,2,2,1
hotsauce,1463.79509766,230.652298424,3,1,2,1
fingerblast,1463.52090056,178.378023766,6,3,3,1
derstuk,1463.27293444,155.054957208,10,4,6,3
miniohh!,1462.89072694,188.363154846,4,2,2,1
wowzers,1461.93427962,200.235602328,4,2,2,1
dankey kang,1460.52752793,216.630734973,3,1,2,1
butcher of bakersfield,1460.51268304,146.435433235,9,4,5,1
mistertizye,1460.46033204,204.332237494,3,1,2,1
capos,1460.3389275,104.877421764,16,8,8,3
beans,1458.86549065,108.959495819,16,7,9,2
rebel scum,1458.48159606,133.72797696,9,4,5,1
sebastian,1458.09512991,227.694089066,3,1,2,1
stark,1458.0012749,188.447766856,4,2,2,1
frogman [charette],1457.44249243,227.35268284,3,1,2,1
goosewithsocks,1457.24091067,155.12777981,6,2,4,1
probers,1456.00741221,193.318266519,4,2,2,1
nuggzy,1455.96356686,200.194329709,4,2,2,1
kevine,1455.8718908,225.767680405,3,1,2,1
the (.)(.),1454.09982457,164.338416454,6,3,3,1
scratch,1453.01404763,129.975845698,19,8,11,3
kristoff,1452.93249853,121.949340976,14,6,8,3
nalgas,1452.77893905,163.830019431,6,3,3,1
prime,1451.90325159,120.322816844,19,7,12,4
bhol,1448.65323032,147.077343664,7,3,4,1
smashg0d,1448.52473071,214.486306613,3,1,2,1
jinjo,1447.54287148,206.797291997,3,1,2,1
jlo,1446.52789991,166.799794127,6,3,3,1
slartibartfast42,1443.76588304,174.009692207,7,3,4,2
yass2queen,1443.71658896,220.681219258,3,1,2,1
masquerade,1443.70641538,221.286939103,3,1,2,1
lalo,1443.56401511,171.689201456,7,3,4,1
bodacious,1443.48097723,172.697139402,7,3,4,2
frostbyte,1442.5048209,162.070868041,7,3,4,2
qapples,1441.78657306,220.509259914,3,1,2,1
crazyk115,1441.6130996,182.506933041,5,2,3,1
cagt,1441.1172043,148.501081,9,4,5,2
z-rex,1441.07322392,222.201033886,3,1,2,1
thissidedown,1441.07322392,222.414701537,3,1,2,1
v-bomber,1440.29099204,160.178951214,7,3,4,2
rocket,1439.95737126,138.579283122,7,3,4,1
tank,1439.54401546,173.72563777,5,2,3,1
zhu,1439.25187479,206.113279653,3,1,2,1
mando,1437.60775005,138.537870502,10,4,6,2
ego,1436.18492272,218.578503916,9,3,6,3
izoo,1436.05159325,219.143634916,9,3,6,3
arctic,1435.49649116,218.617291277,9,3,6,3
pika,1435.30651143,221.050278443,5,1,4,2
midgetto,1434.60852101,162.97128467,7,3,4,2
chicken,1434.30012428,120.127766043,14,6,8,2
macintosh,1433.28848555,177.829721898,5,2,3,1
kriskringle,1432.13062953,188.709212916,4,2,2,1
boogie!,1430.87783557,154.038554585,8,3,5,1
little bill,1429.52702546,206.487398893,3,1,2,1
gamer4life,1429.40085761,188.297310293,4,2,2,1
yolochi,1428.62849169,216.01030518,3,1,2,1
pintoa,1428.18246869,144.127555332,8,3,5,1
white,1427.89008271,194.291971789,15,6,9,3
thenuge,1426.6577208,146.346133407,8,3,5,1
daddy's milk,1425.96640822,155.092309,9,4,5,2
jam,1424.10390955,178.120573208,15,6,9,3
vidya_james,1423.64410837,215.772766484,9,3,6,3
zenaga,1421.10805245,216.761536882,3,1,2,1
nigel_thornberry,1420.31341284,213.756284627,3,1,2,1
cormander,1418.84814416,127.268326036,11,4,7,2
maliki,1418.81636273,169.692416018,13,7,6,3
cbones,1418.61184812,215.571650919,3,1,2,1
waldo,1418.58320204,164.409485215,5,2,3,1
soulbroker,1418.17198117,206.825539816,3,1,2,1
sombrero,1418.10705796,198.714918583,3,1,2,1
maniac379,1417.66957072,103.624838722,18,7,11,3
lucky_hamburger,1417.58120018,211.663027857,3,1,2,1
apparition the ambassador,1417.19669876,103.889961767,21,8,13,4
brotherly,1417.12425796,206.888341714,3,1,2,1
shyguyking,1415.61285593,159.634805335,8,3,5,1
ondas,1414.07692389,145.398285767,8,3,5,1
-philip coast philip-,1413.15627664,212.432820875,3,1,2,1
paco,1412.91918758,123.841490341,12,5,7,2
maaron,1412.16026165,214.814196087,3,1,2,1
zibba,1412.14026598,215.120367949,3,1,2,1
ardent rage,1412.14026598,215.561528818,3,1,2,1
yrn,1411.37271622,211.68998441,3,1,2,1
swankeaboo,1408.97170446,213.409631096,3,1,2,1
paco [larkin],1407.57233867,213.461613899,3,1,2,1
stew,1407.1007993,135.407006957,9,4,5,1
robnu,1406.80855726,161.701681537,6,2,4,1
elitescoringguy,1406.33314169,150.770492313,8,3,5,1
littlespoon,1405.50177134,216.155757186,3,1,2,1
jmabate,1405.50177134,216.814001773,9,3,6,3
gera,1405.20288962,205.878712306,3,1,2,1
hiv+,1404.53355079,210.241885232,3,1,2,1
maps,1403.92929778,123.147980939,12,4,8,2
ir,1402.31092179,211.255286088,9,3,6,3
moze,1401.31155614,194.766266349,3,1,2,1
mulkster,1401.03336195,220.457627025,3,1,2,1
mr_sharpie93,1401.03336195,220.026283234,3,1,2,1
big d [hamiel],1400.87815102,211.17116061,3,1,2,1
evals,1400.65260968,214.651313516,9,3,6,3
hsf,1400.65260968,214.385602115,3,1,2,1
cooljoe,1400.65260968,214.385602115,3,1,2,1
precookedbread,1400.65260968,214.828271869,3,1,2,1
xiivi,1400.17381886,143.505115873,12,5,7,4
burnt out ninja,1400.16218631,228.733389073,3,1,2,1
pastor,1400.16218631,228.733389073,3,1,2,1
spt,1400.16218631,228.109542274,3,1,2,1
java boy,1400.16218631,227.734413905,3,1,2,1
heartsdealer,1400.16218631,228.733389073,3,1,2,1
napkins,1400.16218631,228.109542274,3,1,2,1
nyx,1400.16218631,228.317680605,3,1,2,1
sadu,1400.16218631,228.109542274,3,1,2,1
jirachinick,1400.16218631,228.733389073,3,1,2,1
firefly,1400.16218631,228.733389073,3,1,2,1
flare,1400.16218631,228.109542274,3,1,2,1
nathansandwich,1400.16218631,228.733389073,3,1,2,1
zwephy,1400.16218631,228.733389073,3,1,2,1
dhir,1400.16218631,228.733389073,3,1,2,1
hotpocket,1400.16218631,228.109542274,3,1,2,1
blahguy,1400.16218631,228.317680605,3,1,2,1
mourin,1400.16218631,228.359285506,9,3,6,3
giraffe,1400.16218631,228.733389073,3,1,2,1
shasta,1400.16218631,228.733389073,3,1,2,1
schlag,1400.16218631,228.317680605,3,1,2,1
andy,1400.16218631,228.317680605,3,1,2,1
leet,1400.16218631,228.067891814,3,1,2,1
evab,1400.16218631,228.109542274,3,1,2,1
birdlordmasterbeak,1400.16218631,228.109542274,3,1,2,1
chaos pro,1400.16218631,228.733389073,3,1,2,1
esuma,1400.16218631,228.733389073,3,1,2,1
whoopiecow,1400.16218631,228.359285506,9,3,6,3
drlight,1400.16218631,228.733389073,3,1,2,1
fawnco,1400.16218631,228.733389073,3,1,2,1
hayrow,1400.16218631,228.109542274,3,1,2,1
eggmcmuffin888,1400.16218631,228.733389073,3,1,2,1
zombie!,1400.16218631,228.733389073,3,1,2,1
kzidek,1400.16218631,228.317680605,3,1,2,1
k-man,1400.16218631,228.733389073,3,1,2,1
pokeiman_master,1400.16218631,228.109542274,3,1,2,1
myroknpancakes,1400.16218631,228.733389073,3,1,2,1
15(ichigo),1400.16218631,228.317680605,3,1,2,1
capsui,1400.16218631,228.109542274,3,1,2,1
yakal,1400.16218631,228.733389073,3,1,2,1
cardoso,1400.16218631,228.359285506,9,3,6,3
maestro,1400.16218631,228.067891814,3,1,2,1
dr. grin,1400.16218631,228.733389073,3,1,2,1
r.o.m.,1400.16218631,228.733389073,3,1,2,1
castaway,1400.16218631,228.109542274,3,1,2,1
changed man,1400.16218631,228.109542274,3,1,2,1
snazzy,1400.16218631,228.109542274,3,1,2,1
hungrybox,1400.16218631,229.355539015,3,1,2,2
flatline,1400.16218631,228.317680605,3,1,2,1
krutchby,1400.16218631,228.109542274,3,1,2,1
anathema,1400.16218631,228.733389073,3,1,2,1
kossismoss,1400.16218631,228.733389073,3,1,2,1
kavon,1400.16218631,227.734413905,3,1,2,1
scruffy mcwonder crumpet,1399.26514264,216.700494047,3,1,2,1
mmneggs,1399.07422238,136.065635046,8,2,6,1
godspeed,1398.77926551,130.919572877,11,4,7,2
tmakk,1397.58061752,124.878409343,13,5,8,3
gato,1396.66763133,214.977190732,3,1,2,1
miken,1396.47551291,269.422638239,1,0,1,1
blackf00t,1396.0553002,169.688162773,6,2,4,1
wal,1395.4225482,218.906996108,3,1,2,1
train_town,1395.27226386,202.077197308,3,1,2,1
chiefreaper,1394.92825753,211.850845916,3,1,2,1
boh,1394.7765604,213.094559329,3,1,2,1
damp,1394.36002994,188.22093032,5,2,3,1
 ô·¥è·¥Ö·¥Ä·¥Ñ…™·¥è·¥ús,1392.35696168,142.305602714,8,2,6,1
sunshinetk,1391.06007338,171.105715692,6,2,4,1
hipo,1390.78950118,209.777151258,3,1,2,1
xanz,1390.78950118,209.777151258,3,1,2,1
mortech,1389.11663181,148.687227311,8,3,5,1
dankpank,1388.83398066,127.675338919,11,4,7,2
pzero39,1387.53169898,216.510452551,3,1,2,1
mattatari,1387.53169898,216.904993174,3,1,2,1
banana fiend,1384.44620422,203.17408519,3,1,2,1
walkrofsky,1383.32479053,152.323950563,6,2,4,1
throwz?!,1381.07122461,216.736249718,3,1,2,1
squible,1377.51185746,162.89820139,7,3,4,1
blisstex,1377.10381768,191.838391281,6,2,4,2
astumpycow,1376.82061196,206.247706872,4,1,3,1
icactusdog,1376.40054874,127.567226228,13,4,9,3
chai,1374.55035024,269.182071985,1,0,1,1
malkasaur,1373.8889909,266.114637456,1,0,1,1
khakis,1373.11621562,183.358602477,14,6,8,5
iceking,1372.49265091,183.786796907,6,2,4,2
krypto,1372.46024808,184.151289599,6,2,4,2
dirtcruncher,1369.18262027,127.069388189,12,4,8,2
drewskii55,1365.86968286,208.918095286,3,1,2,1
gumbolaya!,1365.40105575,216.550944041,3,1,2,1
ocelot,1364.70885204,131.853035809,12,4,8,2
trevman,1364.39508973,216.775658065,3,1,2,1
bogmyer,1364.0932158,179.261726552,5,1,4,1
highlyeducational,1356.95489445,218.885015714,3,1,2,1
tokaji,1356.08703056,226.707937112,9,3,6,3
patty-wagon,1355.41836912,267.670078082,1,0,1,1
dasit mane,1354.60142954,157.485490048,7,2,5,2
grrg,1352.13389246,136.123479486,14,4,10,3
mojo,1351.86864414,186.413698215,5,2,3,1
hotspank,1347.80564028,215.747635628,9,3,6,3
kingcool,1344.75357643,141.044848949,9,3,6,1
chinstrap,1343.66207462,175.726424962,6,2,4,2
the professor,1342.22692138,147.897246006,10,3,7,2
myninja,1341.13533333,170.361612154,6,2,4,1
astumpyzombie,1340.32288332,185.849590026,5,1,4,1
zad,1338.62124677,131.605046426,10,3,7,2
yungpurp,1338.22602118,254.763739497,1,0,1,1
akito555,1337.78799739,291.047670779,1,0,1,1
fil,1337.78799739,291.047670779,1,0,1,1
neverpullout,1337.78799739,290.524950161,1,0,1,1
caelan,1337.78799739,290.753756065,3,0,3,3
akajumo,1337.78799739,290.263236849,1,0,1,1
dude,1337.78799739,290.753756065,3,0,3,3
flat nat,1337.78799739,290.524950161,1,0,1,1
electricgazelle,1337.78799739,290.655718447,1,0,1,1
lukem,1337.78799739,290.55764775,1,0,1,1
sabo,1337.78799739,290.55764775,1,0,1,1
spell,1337.78799739,290.524950161,1,0,1,1
ragingcherry,1337.78799739,291.047670779,1,0,1,1
masterofzoroark,1337.78799739,291.047670779,1,0,1,1
nfreak,1337.78799739,290.55764775,1,0,1,1
rice,1337.78799739,291.047670779,1,0,1,1
garv,1337.78799739,291.047670779,1,0,1,1
rf!,1337.78799739,290.753756065,3,0,3,3
uprowr,1337.78799739,290.55764775,1,0,1,1
4sk,1337.78799739,291.047670779,1,0,1,1
hans_mawell,1337.78799739,290.655718447,1,0,1,1
homemadewaffles,1337.78799739,291.047670779,1,0,1,1
bronze_sun,1337.78799739,290.655718447,1,0,1,1
bunmira,1337.78799739,291.047670779,1,0,1,1
adubz,1337.78799739,290.55764775,1,0,1,1
branchan,1337.78799739,291.047670779,1,0,1,1
yung,1337.78799739,291.047670779,1,0,1,1
et,1337.78799739,290.884421491,1,0,1,1
the cfb,1337.78799739,290.55764775,1,0,1,1
god,1337.78799739,291.047670779,1,0,1,1
i use tap jump,1337.78799739,290.524950161,1,0,1,1
spicky,1337.78799739,290.524950161,1,0,1,1
refriedjeans,1337.78799739,290.524950161,1,0,1,1
dishier wand,1337.78799739,290.55764775,1,0,1,1
big tone,1337.78799739,291.047670779,1,0,1,1
weatherman,1337.28406089,179.98525565,5,1,4,1
spaff,1334.18426314,234.707132588,2,0,2,1
maximum can,1332.54668248,227.15593405,2,0,2,1
milleneum,1332.02546646,181.750354841,5,1,4,1
jaws,1330.72071068,214.23997738,3,1,2,1
mello,1328.34256432,255.930122478,2,0,2,1
danno,1328.17014511,225.814965352,3,1,2,1
redribb0n,1327.62409232,268.306055931,1,0,1,1
schmerka berl,1326.99287607,150.961408482,11,3,8,3
esmod,1326.74860044,253.642643542,2,0,2,1
jollie,1326.58293982,150.231852419,7,2,5,1
elu,1326.10586597,145.284436475,8,2,6,1
jedisalazar,1325.90346584,250.362289843,2,0,2,1
brambramjam,1325.88253541,199.405756577,4,1,3,1
yolft,1325.5531,141.472828398,8,2,6,1
tdp,1325.52397065,227.966982253,3,1,2,1
bohemian milk,1325.52397065,227.966982253,3,1,2,1
rhubarb,1325.34826449,125.533424877,12,4,8,2
luwolf,1321.89731169,251.606388286,2,0,2,1
jose,1321.85713863,267.469071763,1,0,1,1
general1712,1321.69807631,164.92518374,6,1,5,1
woof,1320.46663096,142.241736948,9,2,7,1
lou sanus,1320.31892377,143.438992476,7,1,6,1
the drew,1319.20916474,126.771344057,11,3,8,2
husker,1318.23848358,153.356876363,6,1,5,1
guccipivotmaster4000,1316.06791925,243.336490671,6,0,6,3
turtle,1314.47949325,241.151742743,2,0,2,1
oxycontin,1313.08610287,154.456174019,8,2,6,1
barrels,1312.74935432,130.588652104,11,3,8,2
moustasher,1308.28766464,139.966359555,10,3,7,2
shug,1305.82497726,179.938217178,5,1,4,2
magnus combosen,1305.67858851,181.616097391,5,1,4,1
kevorkian,1303.67809153,163.5533798,8,2,6,3
mariokartmoney,1303.67100018,205.936452344,5,1,4,2
taiko,1303.37444822,148.358168306,11,3,8,3
nagurnimaster,1302.51162622,241.164370115,2,0,2,1
kobra,1301.10892962,205.185719434,5,1,4,2
jad,1297.92304821,236.228338285,2,0,2,1
turtlpower,1296.12052178,238.007831293,6,0,6,3
stdangerous,1294.82594084,232.753226588,2,0,2,1
tallyshell,1293.05452486,203.779047977,4,1,3,1
yaron,1291.42400526,140.478180381,7,1,6,1
dmolz,1291.17931496,147.565643465,7,1,6,1
seantos,1290.11977687,140.439531433,10,2,8,2
pidgezero_one,1288.56424199,152.052838594,9,2,7,2
werewyatt,1288.55365076,163.628644548,6,1,5,1
jackmehoff,1288.19280717,227.363707592,2,0,2,1
jedipanda,1288.15074206,154.286679779,6,1,5,1
fig,1287.705046,170.383555264,6,1,5,1
putpasswordhere,1287.43001814,199.928405992,5,1,4,2
brendanhall,1284.80077303,274.337750112,1,0,1,1
pilot,1284.80077303,274.441616991,1,0,1,1
eliot,1282.91621041,167.306512849,9,2,7,3
broonz,1282.81047441,151.034480417,8,2,6,2
mrryanness,1281.99361591,195.831173179,5,1,4,2
depressed eagle,1281.96209659,195.37131524,5,1,4,2
xlax,1281.8360817,195.717501857,5,1,4,2
jgin,1281.23564817,227.062420914,2,0,2,1
nami,1279.84996388,230.895252392,2,0,2,1
fen,1279.32434959,171.105715692,6,1,5,1
twunt,1279.13062508,197.346547353,5,1,4,2
silentknight,1278.76763122,203.566063572,5,1,4,2
pugdaddyfre$hlyfeogg*flva,1277.70495962,235.34695793,2,0,2,1
magfmur,1276.924676,238.071663004,2,0,2,1
quinceprince,1276.924676,238.470368653,2,0,2,1
starcutter,1276.924676,238.31096644,6,0,6,3
multiball,1273.46888253,141.165690691,11,3,8,2
bus,1270.89511326,231.859837673,2,0,2,1
wolfcry,1270.3226934,236.424373097,2,0,2,1
scootieloo,1270.03702183,233.577233109,2,0,2,1
nokto,1269.38594106,236.172735183,2,0,2,1
rabizkoshik,1265.14006072,167.308870405,6,1,5,1
gambit,1261.10354673,237.638419489,2,0,2,1
pigwick,1257.04925579,223.638078391,2,0,2,1
whitegrizzly,1255.71222022,235.123404451,2,0,2,1
blank,1255.71222022,235.889837256,2,0,2,1
tbone,1255.71222022,235.889837256,2,0,2,1
dk dredd,1254.66384488,238.5430096,2,0,2,1
katiebug (sfk),1254.6548418,236.142508759,2,0,2,1
charlie,1253.9871933,235.796985235,2,0,2,1
karl,1253.34254442,216.429087448,3,0,3,1
ppdmd,1252.79674799,254.094626834,2,0,2,1
drhino,1252.79674799,254.28149635,2,0,2,1
blizz,1252.79674799,253.945032213,6,0,6,3
myk,1252.79674799,254.094626834,4,0,4,2
armor,1252.79674799,254.28149635,2,0,2,1
zombieheart84,1252.79674799,254.28149635,2,0,2,1
avian,1252.79674799,253.907619787,2,0,2,1
black rob,1252.79674799,253.720474905,2,0,2,1
erk,1252.79674799,253.383265797,2,0,2,1
thac0,1252.79674799,253.720474905,2,0,2,1
darv,1252.79674799,254.094626834,2,0,2,1
azzy,1252.79674799,254.28149635,2,0,2,1
rickter_scale,1252.79674799,254.094626834,2,0,2,1
beaver,1252.79674799,254.094626834,2,0,2,1
jojohnson,1252.79674799,253.907619787,2,0,2,1
scuttlebug jamboree,1252.79674799,253.720474905,2,0,2,1
jobook,1252.79674799,253.720474905,2,0,2,1
ferrero64,1252.79674799,254.28149635,2,0,2,1
waffles,1252.79674799,254.28149635,2,0,2,1
irish,1252.79674799,254.28149635,2,0,2,1
scraggus,1252.79674799,253.683029361,2,0,2,1
d-tek,1252.79674799,254.28149635,2,0,2,1
yam$,1252.79674799,254.28149635,2,0,2,1
m2cain,1252.79674799,253.383265797,2,0,2,1
ebay,1252.79674799,254.094626834,2,0,2,1
polarbair,1252.79674799,253.945032213,6,0,6,3
tylenol jones,1252.79674799,253.720474905,2,0,2,1
youtwo,1252.79674799,253.832778391,2,0,2,1
sad,1252.79674799,253.720474905,2,0,2,1
cr0ak,1252.79674799,254.28149635,2,0,2,1
bean,1252.79674799,254.28149635,2,0,2,1
laugh,1252.79674799,253.683029361,2,0,2,1
abc,1252.79674799,253.383265797,2,0,2,1
themickeynick,1252.79674799,254.28149635,2,0,2,1
charlie harper,1252.79674799,254.094626834,2,0,2,1
zurdo,1252.79674799,253.383265797,2,0,2,1
sven stormbeard,1252.79674799,253.945032213,6,0,6,3
phalanx,1252.79674799,253.720474905,2,0,2,1
phex,1252.79674799,254.28149635,2,0,2,1
master jay,1252.79674799,254.094626834,2,0,2,1
kayo,1252.79674799,253.683029361,2,0,2,1
blues,1252.79674799,254.28149635,2,0,2,1
instacover,1252.79674799,253.907619787,2,0,2,1
voidstar,1252.79674799,253.383265797,2,0,2,1
da bear,1252.79674799,253.495718674,2,0,2,1
kl3an,1252.79674799,254.28149635,2,0,2,1
sharktoast,1252.79674799,254.28149635,2,0,2,1
sambook,1252.79674799,253.720474905,2,0,2,1
lights,1252.79674799,254.094626834,2,0,2,1
swerve,1252.79674799,253.683029361,2,0,2,1
liam_butler,1252.79674799,254.28149635,2,0,2,1
zarfon,1252.79674799,254.28149635,2,0,2,1
grraffe,1252.79674799,254.28149635,2,0,2,1
fmax,1252.79674799,254.28149635,2,0,2,1
nikku,1252.79674799,253.720474905,2,0,2,1
yung god,1252.79674799,253.383265797,2,0,2,1
hero,1252.79674799,253.945032213,6,0,6,3
urpasmash,1252.79674799,253.945032213,6,0,6,3
sfgman,1252.79674799,254.28149635,2,0,2,1
5000candlesinthewind,1252.79674799,254.28149635,2,0,2,1
jfm,1252.79674799,253.683029361,2,0,2,1
mookie,1252.79674799,253.383265797,2,0,2,1
lunchy,1252.79674799,254.28149635,2,0,2,1
sam,1252.79674799,253.683029361,2,0,2,1
alex,1252.79674799,253.683029361,2,0,2,1
beekle,1252.79674799,254.28149635,2,0,2,1
fry,1252.79674799,254.28149635,2,0,2,1
akiva,1252.79674799,254.28149635,2,0,2,1
big d squirrels,1252.79674799,254.28149635,2,0,2,1
fs mook,1252.79674799,253.683029361,2,0,2,1
raxcity,1252.79674799,254.28149635,2,0,2,1
legoman,1252.79674799,254.094626834,2,0,2,1
shadow light master,1252.79674799,254.28149635,2,0,2,1
duck chris,1252.79674799,253.945032213,6,0,6,3
red,1252.79674799,254.28149635,2,0,2,1
bozz,1252.79674799,253.720474905,2,0,2,1
benbook,1252.79674799,253.720474905,2,0,2,1
levity,1252.79674799,253.720474905,2,0,2,1
paper tiger,1252.79674799,254.28149635,2,0,2,1
harmless,1252.79674799,254.28149635,2,0,2,1
mr.e [rohr],1252.79674799,253.720474905,2,0,2,1
ubll black mage,1252.79674799,253.945032213,6,0,6,3
marfslayer 3000,1252.79674799,253.907619787,2,0,2,1
astropancakes,1252.79674799,254.28149635,2,0,2,1
whiz kid,1252.79674799,254.28149635,2,0,2,1
duckpimp,1252.79674799,254.094626834,2,0,2,1
snack?,1252.79674799,254.094626834,2,0,2,1
uh what,1252.79674799,254.28149635,2,0,2,1
sunshine,1252.79674799,253.945032213,6,0,6,3
theycallmechris,1252.79674799,253.945032213,6,0,6,3
mechanicalmarine,1252.79674799,253.683029361,2,0,2,1
edwin...,1252.79674799,254.28149635,2,0,2,1
amaya,1252.79674799,253.720474905,2,0,2,1
colt,1252.79674799,253.945032213,6,0,6,3
hail_sagan,1252.79674799,253.720474905,2,0,2,1
bunnyblast,1252.79674799,253.720474905,2,0,2,1
scott,1252.79674799,253.720474905,2,0,2,1
superduperfanofboom,1252.79674799,253.720474905,2,0,2,1
bc_burns,1252.79674799,254.094626834,2,0,2,1
4 phri,1252.79674799,253.720474905,2,0,2,1
izze,1252.79674799,253.907619787,2,0,2,1
sleeh,1252.79674799,254.28149635,2,0,2,1
muthaluva777,1252.79674799,253.683029361,2,0,2,1
qk shkz,1252.79674799,253.945032213,6,0,6,3
riseup93,1252.79674799,253.720474905,2,0,2,1
fs shampoomaster,1252.79674799,253.683029361,2,0,2,1
searcher,1252.79674799,253.832778391,2,0,2,1
jpoptosis,1252.79674799,254.28149635,2,0,2,1
dennysgrandslambreakfast,1252.79674799,253.683029361,2,0,2,1
grunyan,1252.79674799,254.28149635,2,0,2,1
holosly,1252.79674799,254.094626834,2,0,2,1
kezzup,1252.79674799,253.720474905,2,0,2,1
maxi,1252.79674799,254.094626834,2,0,2,1
j,1252.79674799,254.28149635,2,0,2,1
aubfox,1252.79674799,254.28149635,2,0,2,1
yuxminato,1252.79674799,254.28149635,2,0,2,1
hyperbole,1252.79674799,253.720474905,2,0,2,1
tydye,1252.79674799,253.907619787,2,0,2,1
aperture,1252.79674799,254.28149635,2,0,2,1
thegoat,1252.79674799,253.720474905,2,0,2,1
matt47,1252.79674799,254.28149635,2,0,2,1
monk,1252.79674799,254.28149635,2,0,2,1
juan doe,1252.79674799,253.720474905,2,0,2,1
jazz,1252.79674799,254.28149635,2,0,2,1
uncle onion,1252.79674799,253.907619787,2,0,2,1
skubtard,1252.79674799,254.28149635,2,0,2,1
giggitoxin,1252.79674799,253.720474905,2,0,2,1
link,1252.79674799,253.683029361,2,0,2,1
tuna,1252.79674799,253.945032213,6,0,6,3
deku,1252.79674799,253.720474905,2,0,2,1
digital cannon,1252.79674799,253.720474905,2,0,2,1
goomah,1252.79674799,253.832778391,2,0,2,1
draxsel,1252.79674799,254.094626834,2,0,2,1
miles,1252.79674799,253.907619787,2,0,2,1
atari,1252.79674799,254.28149635,2,0,2,1
smashlopez64,1252.79674799,253.945032213,6,0,6,3
heisenberg,1252.79674799,254.28149635,2,0,2,1
dd,1252.79674799,254.28149635,2,0,2,1
oljace,1252.79674799,253.907619787,2,0,2,1
flash,1252.79674799,253.907619787,2,0,2,1
umi,1252.79674799,253.945032213,6,0,6,3
warmachine1919,1252.79674799,253.720474905,2,0,2,1
missingn0,1252.35585395,235.090492834,2,0,2,1
frogge,1246.27500262,229.930847033,2,0,2,1
scaryman,1238.62194243,159.396349647,7,1,6,1
bear,1234.46300657,192.73028228,5,1,4,2
ham,1233.58727028,174.886594483,7,1,6,3
curiousplaces,1229.00582463,240.779752568,2,0,2,1
lonk,1229.00582463,240.779752568,2,0,2,1
lloyd-black,1228.05963857,133.362288508,10,2,8,2
mike4real,1222.34270831,236.460349063,2,0,2,1
papa,1221.45002945,187.05725622,4,0,4,1
robslabgod,1219.8533845,225.258502411,2,0,2,1
juno,1218.58028363,243.110760992,2,0,2,1
dunos_,1218.58028363,242.719678044,2,0,2,1
pvc,1218.58028363,242.719678044,2,0,2,1
jerzilla,1218.48500189,241.838311565,2,0,2,1
fumofuu,1214.47059913,241.206819308,2,0,2,1
deep dimples,1210.50611479,171.961772477,5,0,5,1
rocktimus crime,1210.48615824,172.226468998,5,0,5,1
recneps,1209.86830049,152.714342314,8,1,7,2
jeremy,1209.85229848,204.602928741,4,0,4,1
ohhhbreezy,1208.42361941,159.110724722,7,1,6,1
mikeyg,1207.10695142,222.200397124,2,0,2,1
nnaughtydogg,1207.0119167,160.919988188,6,0,6,1
kohenbro,1205.82351152,181.750354841,5,0,5,1
paul d,1205.41893744,223.031055095,4,0,4,1
jet fuel,1205.41166476,147.892786629,8,1,7,1
vondo,1201.94571225,157.020099604,6,0,6,1
sianvar,1201.49536799,244.586596103,2,0,2,1
russellsprouts,1200.26831047,177.221243119,4,0,4,1
neph_girl,1198.25343134,142.627751609,7,0,7,1
nyani,1194.88428227,233.394371028,5,0,5,4
2%gay,1192.74212163,166.44968355,6,0,6,1
adulix,1190.1171937,181.037755838,5,0,5,1
ryden hope,1180.39885302,242.691726599,2,0,2,1
kraken,1180.39885302,242.691726599,2,0,2,1
dr gibs,1180.02212929,179.390455459,5,0,5,1
mjim,1178.1423326,174.595362907,5,0,5,1
bagel,1172.4627158,164.403888417,6,0,6,1
jpeghero,1169.95150921,162.572872958,9,1,8,2
failcant,1169.65177662,237.626581518,2,0,2,1
bung0o,1168.90992173,159.84225945,6,0,6,1
elrond,1168.10218124,143.779563202,7,0,7,1
bennyboy98,1164.82195562,245.845895574,2,0,2,1
thedarkdreamer,1160.87371869,253.351862459,2,0,2,1
sweaters,1160.87371869,253.464329268,2,0,2,1
thisisgettingold,1160.87371869,253.351862459,2,0,2,1
tweli,1160.87371869,253.351862459,2,0,2,1
bulldog,1160.87371869,253.351862459,2,0,2,1
redwolf,1160.87371869,253.314362426,2,0,2,1
cat,1158.74393027,179.562248964,5,0,5,1
sugaaku,1152.90063324,216.902904633,4,0,4,2
djltheescapade,1151.90711445,190.757722302,5,0,5,2
falln,1141.82963552,239.106920707,2,0,2,1
jonnjonn,1131.41036205,173.022391287,5,0,5,1
jimbot,1129.21436418,155.085397056,7,0,7,1
blanco mano,1120.78651453,168.44398204,6,0,6,1
tehz,1112.86906143,183.427269028,6,0,6,2
shwang,1105.98818033,187.501038404,6,0,6,2
nardwell,1101.2427545,120.558198546,21,2,19,5
golfclubninja,1063.55492139,182.608078976,8,0,8,3
bonerstorm,980.718163189,350,6,3,3,2
