player,rating,rd,sets,wins,losses,num_tourneys
armada,2162.27803401,59.9683884588,159,145,14,14
leffen,2098.57790481,61.5961016975,104,88,16,10
hungrybox,2091.75665615,55.9042041075,201,172,29,19
mew2king,2047.82189314,53.3617371087,158,126,32,16
mang0,2035.73250742,58.1209669101,163,133,30,17
pi,1995.50645821,161.296234256,15,11,4,2
overtriforce,1971.23601977,80.8973464859,65,55,10,7
swedish delight,1958.13345597,62.9443385386,88,65,23,9
kirbykaze,1955.6603391,139.65007017,29,22,7,3
ice,1937.32120839,57.033395215,133,102,31,14
sfat,1935.94194392,55.8333849708,142,103,39,17
johnnyfight,1935.47561702,91.1536934326,25,21,4,2
taj,1921.99463036,135.301528424,10,8,2,1
lovage805,1921.09879803,119.84032,14,10,4,2
wizzrobe,1919.42722169,55.9729730483,133,101,32,13
s0ft,1918.42207711,162.281570477,8,6,2,1
westballz,1917.35099653,55.5225562492,142,105,37,17
professor pro,1916.18559849,57.7662178756,115,89,26,11
trif,1914.82705095,66.3454168645,73,59,14,6
kage,1911.51821298,86.5383801635,38,30,8,4
therealthing,1911.23440988,143.44157102,9,7,2,1
yort,1909.67094595,120.907589268,20,14,6,4
charlon,1904.86676897,125.938989748,13,11,2,1
fuzzyness,1900.72292482,75.6358978098,65,53,12,6
adamayonmike,1897.58467994,92.9075743475,41,33,8,4
iori,1894.46830165,114.631715286,18,14,4,2
jeapie,1894.15599279,182.967738194,22,18,4,2
twin,1890.29713123,103.726565448,19,15,4,2
k-12,1886.90123223,103.266695552,23,19,4,2
shroomed,1880.99149565,60.9907010584,94,69,25,12
albert,1878.67393198,144.638640285,9,7,2,1
pewpewu,1874.3227474,58.627172591,87,62,25,11
plup,1871.52682876,63.5212499603,70,50,20,9
hack,1869.14198739,207.390531103,4,4,0,1
flikkflakk,1867.98154984,109.50378335,20,17,3,2
android,1867.26182215,70.0227138451,75,60,15,7
zgetto,1867.2519233,74.2951797473,59,47,12,6
mahie,1866.12946309,80.38634945,52,42,10,5
hax,1864.21837766,138.946125585,11,8,3,1
amsa,1864.11342379,97.8903483443,20,16,4,2
prince f. abu,1861.60799944,131.956432645,30,23,7,3
reaper,1861.27513029,104.117595006,33,27,6,3
zoler,1860.14177048,103.445411017,35,29,6,3
alejandro,1857.97856223,135.286051789,10,8,2,1
n0ne,1856.30346639,64.3052572184,101,74,27,11
dusty md,1854.43069113,245.381913936,2,2,0,1
infinitenumbers,1852.02528452,140.218869774,9,7,2,1
laudandus,1848.29516841,91.5536040505,38,30,8,4
absentpage,1847.33285599,90.6624786741,26,20,6,3
captainjack,1847.27242266,139.478567516,11,9,2,1
axe,1844.79759855,61.030859582,92,65,27,12
duck,1840.91041957,61.098098957,94,68,26,12
syrox,1840.46177032,82.8163036268,34,25,9,4
dizzkidboogie,1836.57726433,61.4055040821,82,59,23,10
kels,1836.4594193,78.9695734338,30,23,7,3
druggedfox,1834.42064716,63.7131087749,79,56,23,10
rk,1834.41037915,164.517518302,6,4,2,1
trulliam,1834.3075477,77.9452314803,51,39,12,5
daydee,1834.10139401,100.393128598,24,20,4,2
rocky,1833.86713325,109.747455068,34,26,8,4
spud,1833.47192185,117.273258538,18,12,6,3
calle w,1832.84752335,99.9041927869,22,18,4,2
eagle,1832.07580459,103.262712727,23,19,4,2
beat,1831.8681778,137.552170789,12,10,2,1
mrlz,1830.36403401,130.251516259,21,16,5,3
rudolph,1830.21518164,126.231689675,21,14,7,3
azzu,1828.91811434,109.598668298,19,15,4,2
chudat,1828.65902811,81.2736681037,60,47,13,6
luigi ka-master,1828.40697614,153.844623371,8,6,2,1
s2j,1828.2765985,58.4537092325,108,74,34,15
amsah,1827.93883967,83.2118425462,50,40,10,5
lucky,1827.53652535,64.2913401589,72,51,21,11
salevits,1826.130033,107.457020225,20,16,4,2
levingy,1825.37898828,99.9707719998,31,22,9,3
kyle,1824.65420384,133.296218995,10,8,2,1
baxon,1822.33763425,101.807651174,33,27,6,3
zealous5000,1821.11908118,108.853037985,14,10,4,2
sealmore,1819.92640235,154.362621268,8,7,1,1
ferocitii,1819.84915471,167.756268149,6,4,2,1
the moon,1817.03422551,62.6000965952,105,73,32,14
davidcue,1816.97560112,122.420359999,14,12,2,1
chillindude,1816.70061399,67.8197899825,60,43,17,8
colbol,1816.60048318,70.2956956787,58,41,17,7
infinite numbers,1815.90333702,127.720800163,12,8,4,2
kalamazhu,1815.36923651,114.018162801,26,18,8,3
googlyeyed,1812.31901981,159.380411497,8,6,2,1
tenrye,1812.3182531,140.996801221,11,9,2,1
macd,1811.62650921,60.0899091279,96,65,31,12
bose,1810.21103969,95.6360527627,24,19,5,3
zain,1808.59366772,88.6125300054,24,18,6,3
sverre,1808.173568,98.2386442653,22,17,5,2
esam,1808.13072332,74.9637680802,47,33,14,7
nmw,1807.78014171,89.2889987731,25,18,7,3
humpe,1807.25544397,107.006768155,21,17,4,2
polo,1805.56898885,171.975085663,6,4,2,1
mafia,1802.69842295,79.5086390667,37,26,11,6
cyrain,1802.03871409,94.9353307371,24,18,6,3
ib,1802.02805608,142.369049188,16,14,2,2
fa0,1802.00452862,115.052648462,27,20,7,3
bladewise,1801.37929069,74.8957591901,39,26,13,5
yabasta,1801.17525228,94.5332473049,40,30,10,4
crunch,1799.94444301,89.7605818863,27,20,7,3
jadde,1799.21952324,109.005548393,22,17,5,3
tai,1797.67670615,78.1060512425,35,25,10,4
imperfect,1797.06952441,106.631285631,27,21,6,3
martin,1796.65120092,156.39471978,7,6,1,1
peki,1795.23035964,103.001125595,22,17,5,2
fauster,1795.17556432,113.089028756,32,26,6,3
s1,1795.08664034,155.418822369,7,5,2,1
taylorhj,1794.69520121,118.70913181,15,11,4,2
kriz,1793.64718468,108.205891305,20,16,4,2
$mike,1792.96458166,133.755248987,23,16,7,3
@adamayonmike,1792.5273126,139.373652551,12,10,2,1
hugs,1791.61538187,67.5175769458,70,48,22,10
pricent,1791.51486836,89.5660702104,43,33,10,4
mayhem,1789.28875112,108.689728176,20,16,4,2
vidjogamer,1789.01249614,104.005840851,17,13,4,3
sassmaster,1786.52530843,236.724369285,8,5,3,2
jamrun,1786.40176036,96.514435081,30,23,7,3
zorc,1785.81142546,79.1054876444,44,33,11,5
däumling,1785.61850407,182.472260497,22,18,4,2
ryan ford,1784.46827813,83.8214639109,40,29,11,5
slox,1784.39731682,84.0635498831,39,27,12,5
quaz,1784.05969203,132.427496987,12,10,2,1
squible,1783.76051721,98.6956678667,20,15,5,2
timi,1783.46824546,133.159262532,25,21,4,2
gundersen,1782.77928755,141.17906506,11,9,2,1
psychomidget,1782.64896777,93.556198744,22,15,7,3
4%,1782.60722906,91.4838981464,28,20,8,4
patcake,1781.51478372,148.678613378,7,5,2,1
usleon,1781.46593192,100.926630459,20,15,5,2
rax,1779.78851889,109.512526415,18,14,4,2
captain faceroll,1779.62691483,74.5237810345,44,32,12,5
kpan,1778.98808396,98.2071345137,30,21,9,4
sago,1778.80190864,110.188261383,19,15,4,2
yung arc,1778.75516119,157.748558352,6,4,2,1
ginger,1777.75350676,99.3683556718,22,16,6,3
lsdx,1777.73232112,141.13807505,12,9,3,1
cal,1777.35012154,149.080021609,7,5,2,1
pikapastor,1777.11536553,134.619980022,8,6,2,1
schlimmshady,1776.85264615,139.314833654,24,20,4,2
magicubed,1776.78401091,149.810837099,7,5,2,1
vdogg,1776.01189404,106.20062557,24,19,5,2
tesla,1775.3808761,153.313668764,8,6,2,1
bësti,1775.35057146,144.441560359,11,9,2,1
jah ridin',1775.35057146,144.441560359,23,19,4,2
reeve,1775.32891138,73.8400260204,46,33,13,6
iceman,1775.19611015,94.1336736484,25,18,7,3
baeblade,1775.17411578,105.130345315,25,17,8,4
darkatma,1773.96859995,83.3591937348,33,23,10,4
nightmare,1773.60480053,88.2633847249,45,34,11,5
prince abu,1771.45659291,67.5707955531,64,44,20,8
pseudoturtle,1771.42063717,141.210139529,11,9,2,1
anther,1771.01560826,135.969802662,9,6,3,1
smashg0d,1770.65204795,115.4779651,14,10,4,2
star,1770.55491743,150.097955943,8,6,2,1
wobbles,1770.22313006,62.4147757441,74,48,26,10
llod,1769.95603483,100.972008668,17,12,5,2
vanity angel,1769.94929664,103.725592372,32,26,6,3
cuff,1769.69222263,131.050234427,12,9,3,1
griffith,1769.10179289,148.29724847,7,5,2,1
rik,1768.69341795,76.1577902061,42,30,12,5
rime,1767.82254801,122.00580269,13,9,4,1
ibdw,1767.56438887,93.8610986776,22,15,7,3
frycook,1767.3883475,118.325132988,18,14,4,2
shunsuke,1766.98633603,149.43143636,8,6,2,1
sothe,1766.61263039,118.075957227,15,12,3,1
kage the warrior,1766.28592278,145.049277088,8,6,2,1
taka,1765.8732203,118.205890365,21,15,6,3
eggy,1765.7219042,107.619376354,20,15,5,2
ministry,1764.81127108,139.314833654,12,10,2,1
mikehaze,1764.68575756,74.5030285517,55,38,17,7
desseler,1763.97537066,118.969016114,15,11,4,2
dj nintendo,1763.33804044,69.3706479037,64,45,19,8
spark,1763.08653443,101.280414354,21,15,6,3
phil,1762.81796721,111.97393344,16,11,5,2
sauc3,1762.44136604,117.018398936,15,11,4,2
fatgoku,1761.58183213,170.323906681,7,5,2,1
cdk,1760.82368114,112.756547238,16,12,4,2
hazygoose,1759.93457616,121.903404303,15,11,4,2
eddy mexico,1759.32451858,115.880596003,15,10,5,2
brtarolg,1759.2701871,76.7954586548,58,43,15,7
mr.postman,1758.26132214,122.618740008,13,9,4,1
jdog,1757.35460164,147.489057687,9,7,2,1
liam_butler,1757.10049218,118.032572651,13,9,4,2
shiftingshadows,1757.0994908,108.411101409,29,22,7,3
travis,1756.63183855,110.934054248,17,13,4,2
shinobi,1755.94671476,77.6568292362,41,29,12,5
yomi,1755.91685913,202.354385977,16,12,4,2
nintendude,1755.76410678,64.7557398927,74,48,26,10
luigikid,1755.35826054,150.251404086,10,8,2,1
sol,1755.35826054,150.251404086,10,8,2,1
wenbobular,1755.1215055,91.8567536543,28,20,8,4
strawhat,1754.86169557,162.869279103,10,6,4,2
dan salvato,1754.81192968,146.032096647,9,7,2,1
twitch,1754.31252592,149.935765405,7,5,2,1
p-chips,1754.07170845,135.477079085,11,8,3,1
gahtzu,1753.8830453,75.4902093215,52,35,17,7
tranimal,1753.77413113,99.4562184802,23,16,7,3
zoma,1753.4376589,143.455248367,8,6,2,1
wic,1753.2694786,181.79812984,6,5,1,1
nakamaman,1753.07284669,164.94476745,6,4,2,1
morsecode762,1753.07191559,158.29269896,17,13,4,2
vanitas,1752.85341535,112.695534735,26,20,6,3
azusa,1752.49610441,105.701548735,18,13,5,2
jkj,1751.4936243,100.542787956,20,14,6,3
bmc,1751.44381295,96.4081844683,26,19,7,3
cob,1751.1673481,101.729952333,16,11,5,2
junebug,1750.93918766,116.726234621,18,14,4,2
drephen,1750.82360523,77.4641527482,41,29,12,5
dacky,1750.47973869,145.959504013,8,6,2,1
voorhese,1750.26819345,137.109993185,11,9,2,1
ryan_k,1750.04244208,127.234613034,12,8,4,2
obamallama,1749.83077851,116.888978423,15,11,4,1
home,1749.59562288,129.805224663,12,8,4,1
amida,1749.23408846,78.9007894316,34,23,11,5
equal,1749.07308591,101.516362823,24,17,7,3
banana,1748.86179105,127.421171847,14,10,4,2
nintendork,1748.85552095,212.725284023,12,8,4,2
deathgazer,1748.78355515,92.1372383168,40,28,12,4
kjh,1748.71202114,66.1100985304,77,54,23,9
redd,1748.68752226,101.32294907,20,14,6,3
g$,1748.25330153,102.708856858,23,17,6,2
lanceinthepants,1748.10563683,79.5388956931,39,28,11,5
darktooth,1747.64465438,178.596098613,6,4,2,1
markow,1747.63306374,137.273087485,11,9,2,1
kdj,1747.51611251,144.549341618,9,6,3,1
jflex,1746.77022566,94.401890076,32,22,10,4
thugz,1746.60784254,160.043456442,7,5,2,1
flood,1746.43339857,168.50489264,7,5,2,2
lint,1746.10143161,85.7254151861,31,22,9,4
envy,1745.27420909,111.544162304,21,15,6,3
bobby frizz,1744.9737804,112.750794853,17,11,6,2
moogle,1744.17996998,156.678507661,7,5,2,1
monib,1743.48229538,124.461848658,26,19,7,3
chip,1743.12127359,125.76462496,13,9,4,2
nakamaru,1743.0671526,147.093654299,7,5,2,1
ronzell,1742.87123506,152.46137718,9,7,2,1
slipnslide,1742.78138438,156.132992856,7,5,2,1
shminkledorf,1742.69522715,165.192935542,7,5,2,1
triple r,1742.12909038,94.6628308541,27,20,7,3
avalancer,1741.91217483,162.909891986,8,5,3,1
ycz6,1741.44691096,126.273558423,13,9,4,2
ryobeat,1740.1693664,135.422776393,9,6,3,1
spor,1739.7352618,115.927256189,19,14,5,2
makari,1739.37685862,168.9564349,6,4,2,1
hat,1739.3094176,93.8410054017,24,17,7,3
crush,1739.27383114,83.0027799828,42,27,15,7
orly,1739.26742552,109.524041311,18,13,5,2
mistrrlove,1738.91610143,164.98865129,19,15,4,2
silent wolf,1738.15628189,73.1686829076,43,24,19,6
advanced,1737.33132619,122.598040733,15,11,4,2
swiftbass,1736.93967427,91.4471336875,35,23,12,5
davrob01,1736.91557353,141.080996954,11,8,3,1
milkman,1736.01290107,103.1835801,23,17,6,3
plank,1736.01071679,116.983346922,13,9,4,2
iv,1735.97379528,269.74615452,1,1,0,1
dudutsai,1734.23244825,96.2732814696,25,18,7,3
scythe,1734.1018815,105.296598203,18,14,4,2
mike haze,1733.88318054,123.445333111,13,8,5,2
koopatroopa895,1733.5478005,117.051077766,15,10,5,2
wakenvape,1733.21182422,127.17195222,16,12,4,3
space ghost,1733.09492556,141.260207787,9,7,2,1
lawn chair,1732.41254382,153.436324201,8,6,2,1
thegooddoctor,1732.35021534,137.21603631,11,9,2,1
luigo,1731.7962938,156.558363055,19,14,5,2
naminami,1731.7962938,156.558363055,9,7,2,1
manio,1731.7962938,156.558363055,9,7,2,1
trichael man,1731.7962938,156.679676546,9,7,2,1
rold gold,1730.50836103,159.563666842,8,6,2,1
ashtrei,1730.00223007,146.198027403,10,8,2,1
uwan,1729.84280276,154.278957437,7,5,2,1
i4n,1729.79370443,96.9727255907,25,18,7,3
r23,1729.55365922,120.705477669,25,19,6,3
askeflink,1729.35588561,91.5588669954,31,23,8,3
moy,1729.27513053,171.526741313,8,6,2,2
kwyet,1729.18710924,150.168659618,8,6,2,1
stacy's stepdad,1728.90653039,146.554617703,9,7,2,1
ihavespaceballs,1728.86341073,154.640152186,7,5,2,1
zanguzen,1728.82676979,104.202597972,19,13,6,3
liberate,1728.80577674,85.7564387138,28,19,9,4
umbra,1728.31651766,144.649709497,8,6,2,1
dizzy,1727.52216897,158.796572539,9,6,3,1
jman3,1727.50770265,133.74997834,12,9,3,1
juggleguy,1727.27517969,85.4351813714,38,26,12,5
ajp_anton,1726.23905218,109.799674192,19,13,6,2
sodrek,1726.20307766,182.393641454,6,5,1,1
murdock,1726.07587209,159.509733268,7,5,2,1
john ward,1725.66425741,157.71228382,8,6,2,1
beach,1725.61666829,93.7516950726,24,16,8,4
phade,1725.51165392,113.85915306,27,19,8,3
eekim,1725.34901714,110.645780068,18,12,6,2
kraines,1724.79755429,175.14934014,14,9,5,2
prz,1724.41069258,106.59253905,19,14,5,2
akke,1724.26199127,173.597761581,7,4,3,1
alpha dash,1724.08605373,125.44334115,25,19,6,3
peanutphobia,1723.98262636,100.207068354,20,14,6,3
toastyb,1723.43469842,107.204557332,15,10,5,2
aisengobay,1723.27629651,173.845040771,9,5,4,2
uncle mojo,1722.96185654,150.74397048,9,5,4,2
mew,1722.60271105,90.9903541049,30,21,9,4
paper,1722.43537583,122.197412169,13,9,4,2
violence,1721.80496941,114.198563714,19,13,6,3
idcrisis,1721.63950031,173.898743102,5,3,2,1
suess,1721.60429252,121.930371104,13,9,4,2
irregularjinny,1721.53771552,122.124427724,15,11,4,2
aether,1721.30299285,151.805676389,12,8,4,2
damian tyson,1720.96399459,123.549027984,24,18,6,3
ftgg,1720.67720285,144.145302561,8,6,2,1
bigfoig,1720.30076062,124.99060175,11,8,3,1
nils,1720.14031212,88.9602700593,39,27,12,4
captain smuckers,1719.86678452,83.6718725481,38,25,13,5
metroid,1719.82408703,146.241183814,8,5,3,1
tafokints,1719.65949149,80.9707352174,40,25,15,6
pure,1719.55288258,136.840032322,18,11,7,3
aglet,1719.46227084,121.304344019,14,10,4,2
alp,1719.31746857,115.814443228,13,9,4,2
joeycrzl,1719.25861795,164.402368702,9,5,4,2
dope,1718.90526614,108.892087096,28,15,13,3
vro,1718.22449888,83.5154959482,37,24,13,6
sharp,1718.19359355,154.243073802,8,6,2,1
hello,1717.79331022,114.843170942,17,13,4,2
king funk,1717.784176,112.447400966,28,21,7,3
skipper,1717.72762326,151.735814702,9,7,2,1
hindawg,1717.56243725,178.118000353,6,4,2,1
pit,1717.34353093,148.813904945,8,6,2,1
zeo,1717.26106779,98.9883816288,20,13,7,3
coen,1716.75775881,177.438120457,17,11,6,2
emt_sol,1716.58851173,122.81760243,21,14,7,3
shanks,1716.45326003,125.270711508,15,10,5,2
white guilt,1716.32975186,194.731533917,5,4,1,1
tm,1715.91231568,102.768027789,27,19,8,4
cascade,1715.73995418,181.433623584,6,4,2,1
nes,1714.6642379,153.287796752,7,5,2,1
ksc,1714.32356552,133.039390514,11,8,3,1
zhu,1714.01840748,82.5135997012,54,38,16,6
minty,1713.87433883,102.386854564,21,15,6,3
goomy,1713.67414482,123.586847069,12,8,4,2
bebop!,1713.58139577,159.273658234,7,5,2,1
homemadewaffles,1713.39003138,78.8308459193,40,26,14,6
schythed,1713.1544982,87.5182988466,32,22,10,4
krizski,1712.76646414,130.051239511,11,7,4,2
hamyojo,1712.71077087,91.9224260403,27,19,8,4
atomsk,1712.59898519,104.850336196,20,13,7,3
coffeeblack,1712.50560116,106.966701953,33,25,8,4
dr. greenthumb,1712.4879862,113.550970207,16,11,5,2
km,1712.37188306,137.81715887,9,7,2,1
dezno,1712.33781483,86.0030337399,32,22,10,4
cmg,1712.13813512,159.765480575,7,5,2,2
hylian,1712.11180857,130.915035751,11,8,3,1
ju4n,1712.03949402,156.598675796,6,4,2,1
frenzy,1711.89148838,85.0687774745,46,33,13,5
vish,1711.83795195,89.7720681274,28,19,9,4
dairdev1l,1711.7115201,76.7821897244,47,32,15,7
ciz,1711.5770451,94.3902466627,26,18,8,4
paz,1711.01169397,165.469103727,6,4,2,1
chum,1710.78569723,123.784284185,12,8,4,2
jawanga,1710.48980807,102.185875757,23,16,7,3
lonebutterfish,1710.13819955,116.260395423,24,16,8,3
yoyo,1710.01878113,114.33528491,15,9,6,3
gar,1709.80551467,103.153816673,20,14,6,3
der_hund,1709.78838466,167.526760831,7,5,2,1
electric flux,1709.74865251,162.961244782,7,5,2,1
beerman,1709.73754932,163.022295288,6,4,2,1
flamin roy,1709.38612549,127.31284087,14,10,4,2
lock,1709.082262,124.079531792,15,11,4,2
onion,1709.00986038,131.297543126,14,10,4,2
rayzorium,1708.95222416,159.985663599,8,6,2,1
webwipe,1708.70031849,128.062642315,15,10,5,2
friendly neighborgood puff,1708.182071,131.806435461,10,6,4,1
nino,1707.86618997,146.218118123,8,6,2,1
sypherphoenix,1707.69767902,121.926048778,12,8,4,2
ambiguously polish,1707.39468573,152.724225639,7,5,2,1
frootloop,1707.38589286,112.608054573,24,16,8,4
aellgi,1706.96840835,142.662985872,11,8,3,1
eliott,1706.63706227,100.59012794,22,15,7,3
captain crunch,1706.33746121,91.1815579411,36,24,12,5
kyuu,1705.93544609,267.918403065,1,1,0,1
fork,1705.72266323,175.320017908,17,13,4,2
abate,1704.57396661,90.7533456902,27,19,8,3
rustin,1704.52422489,87.7732999895,28,19,9,4
vinodh,1704.48401029,103.910712936,22,14,8,3
random-ness,1704.48252357,113.836288744,29,22,7,3
gravy,1704.40634648,129.649416643,23,15,8,3
length plank,1704.3004326,168.564738441,8,5,3,1
fendricklamar,1704.06360304,78.8500527184,37,24,13,6
vino,1703.77392276,99.2887912776,26,18,8,4
dalung,1703.72661477,179.662228002,17,11,6,2
killahertz,1703.61490155,164.961753203,8,6,2,2
chroma,1703.61490155,164.03773962,8,6,2,1
quail,1703.61490155,164.03773962,8,6,2,1
nimzo,1703.61490155,164.03773962,8,6,2,1
icer,1703.61490155,164.03773962,8,6,2,1
flop,1703.61490155,163.108491562,8,6,2,1
okamibw,1703.61490155,164.03773962,8,6,2,1
zbert,1703.61490155,164.03773962,8,6,2,1
a rookie,1703.61490155,164.03773962,17,12,5,2
tags,1703.61490155,164.03773962,8,6,2,1
dendypretendy,1703.61490155,164.03773962,8,6,2,1
soccermom69,1703.61490155,164.03773962,8,6,2,1
arcane,1703.61490155,164.03773962,8,6,2,1
kei,1703.61490155,164.03773962,8,6,2,1
neeco,1703.61490155,164.03773962,8,6,2,1
green ranger,1703.34518674,149.12582798,8,6,2,1
bolt,1702.70147349,119.483008246,15,11,4,2
darrell,1702.57766802,128.997694177,12,7,5,3
tang,1701.18622376,138.11025105,11,7,4,2
mattdotzeb,1701.08118892,86.1307084635,33,22,11,5
reno,1700.97951043,85.3993810775,39,25,14,6
darkcloud,1700.77310347,162.145212622,7,5,2,1
ny joey,1700.71694925,91.8056393418,30,20,10,4
r2dliu,1700.28823529,88.8939851929,29,19,10,4
johnkorv,1700.26902516,151.500510846,9,7,2,1
sharkz,1699.74193893,101.297894169,21,14,7,4
bëst,1699.71921054,141.916466977,10,7,3,1
hurlevent,1698.84300794,159.39301896,7,5,2,1
specialk,1698.73938812,175.477093582,6,4,2,1
fauxhebro,1698.65826812,156.437901458,8,5,3,1
nerin,1698.65107121,100.661017662,20,14,6,3
jacky,1698.61311604,103.695511704,21,14,7,2
irotikuz,1698.25072292,145.556620785,9,6,3,1
dero,1698.16241988,165.552449156,16,11,5,2
ap renekton,1698.1578037,204.954767671,4,3,1,1
piranha,1697.1688209,167.051416151,7,5,2,1
phrase,1696.92571178,157.100424944,7,5,2,1
rockleeland,1696.67897961,144.573041605,11,8,3,1
voff3,1696.64976052,152.271861196,9,6,3,1
son2,1696.55032742,115.583753463,15,10,5,2
bones,1696.52119045,94.628547253,21,14,7,3
kevinm,1696.46614467,181.504292523,6,4,2,1
root3,1696.4587131,122.194091026,13,9,4,2
ozai,1696.08961893,116.590297256,15,10,5,2
jam,1695.6905852,116.090579259,36,25,11,5
kevorkian,1695.67718044,88.1169577924,29,20,9,4
doubleshine,1695.38181143,145.938495247,10,7,3,1
arty,1695.35349786,149.889025898,8,5,3,1
rog,1695.17439843,169.365245042,13,9,4,2
starlord,1694.58802478,143.937918623,17,11,6,3
smashbob squarepants,1694.53108751,180.153094837,12,8,4,2
apeduden,1694.42932971,159.238770089,7,5,2,1
javi,1694.38668401,109.896941339,19,12,7,3
tapion,1694.26993413,160.106717212,7,5,2,1
skyreon,1694.21454484,166.729928471,7,5,2,1
kim yung un,1694.01719538,101.586422934,21,14,7,3
justjoe,1693.87776662,140.073942361,11,8,3,1
phake,1693.82633477,172.244030913,15,11,4,2
husband,1693.57612324,150.148635041,9,6,3,1
doll,1693.503482,120.468049321,14,10,4,2
hellsingulh,1693.47588919,116.504094516,14,10,4,2
hot,1693.23190568,160.637964294,6,4,2,1
jonjon,1692.94802323,128.345382282,13,9,4,2
sweet,1692.67213786,117.301199912,15,10,5,2
heartstrings,1692.12411309,83.3503762787,45,29,16,6
rogee,1691.95842998,148.49837448,7,5,2,1
mb-smash,1691.27015356,159.287081928,6,4,2,1
drewgong,1690.95010138,97.474737492,26,18,8,3
viktoralsos,1690.93389761,159.054656088,7,5,2,1
alex19,1690.80614406,110.851816181,26,18,8,4
cantus,1690.3738323,128.724964069,14,9,5,2
j666,1690.27374381,123.765215287,13,9,4,2
waterlessfishie,1690.20381052,122.207357895,15,9,6,2
hungry pigeon,1690.19035868,120.504248199,20,13,7,3
the brig,1690.0394516,145.044819277,10,6,4,2
mr_sweet,1689.95155706,205.513089103,11,7,4,2
off3nse,1689.69264381,152.165716989,8,5,3,1
jager,1689.51585237,157.753821392,7,5,2,1
bananas,1689.50540473,95.0576206798,24,16,8,3
denec,1689.06253411,113.727453293,16,11,5,2
nigel,1688.73048364,152.880558162,7,4,3,1
setchi,1688.38589744,153.276070464,17,11,6,2
chi,1687.97095962,127.378284742,14,9,5,2
rula,1687.9596842,125.074114857,19,13,6,3
boss,1687.90669722,117.916761557,16,11,5,3
spaceanimalz.com,1687.57994534,177.717192813,6,4,2,1
wts,1687.2019315,129.642449595,10,7,3,1
jrad,1687.19037247,108.316113485,25,17,8,3
arc,1687.10010142,119.590911615,17,12,5,2
willz,1686.81583201,107.21043086,29,19,10,3
shaeden,1686.72377153,161.727383498,6,4,2,1
geof t. samus,1686.47663332,162.075238656,7,5,2,1
spiff,1686.47365302,162.755648341,6,4,2,1
kohai,1686.02279578,136.980141838,11,7,4,2
blueg,1685.69050341,134.359440643,12,8,4,1
iateyourpie,1685.49354574,162.442009053,6,4,2,1
c#,1685.32428907,123.046009446,13,9,4,2
deepz,1685.21365121,133.236727761,10,6,4,1
widl,1685.12383533,101.722736691,19,12,7,3
pikapika!,1685.11344841,125.96433054,13,9,4,2
volvo,1684.97554621,169.922331945,7,5,2,1
unit,1684.65895855,181.631635118,5,3,2,1
ebay,1684.49385126,125.982548686,14,9,5,2
colonel dog,1684.13892456,173.956170918,6,4,2,1
shabo,1684.05725763,103.882376989,21,14,7,3
moky,1683.84904311,153.657757232,19,15,4,2
a link named slykbacc,1683.5355727,154.893720106,6,4,2,1
poonslayer7,1683.02466226,127.302820071,10,7,3,1
zilyn,1682.95776822,149.924763271,9,6,3,1
primer,1682.76901182,159.12081979,7,5,2,1
maskless,1682.53100086,115.582649058,26,17,9,3
dog wearing sunglasses,1682.35906401,149.163596161,8,5,3,1
dunk,1682.34355247,86.2434214141,40,27,13,7
toptierdad,1682.17080843,131.214927034,14,10,4,2
uuaa,1682.15418059,105.782717931,24,16,8,4
dai,1681.7002177,164.969597035,7,5,2,1
42nd,1681.62541721,115.831980241,21,14,7,3
yedi,1681.2077414,118.926308745,14,9,5,2
travist,1680.96307274,118.558184856,17,12,5,2
kei$,1680.34833749,201.602259123,5,3,2,1
tran,1680.10130375,124.797960483,11,7,4,2
noah,1680.03379623,141.465104342,12,8,4,2
torsional strain,1680.01350044,145.343752152,8,5,3,1
doh,1679.7040661,129.53296253,11,7,4,2
r0cket_wizard,1679.38621351,151.84910571,8,5,3,1
doodler,1679.29567828,114.309409745,16,11,5,2
grab2win,1679.15998601,144.128467065,10,7,3,1
nikabod,1678.29332488,121.994765309,13,9,4,2
kira,1678.04472828,82.0899899108,36,22,14,4
mwl,1678.01664204,153.957209612,9,6,3,1
shrug,1677.74304272,133.36557109,10,6,4,1
indie,1677.6740978,166.358352835,7,5,2,1
shot,1677.63747289,167.257006172,7,5,2,1
nekonyancer,1677.58161143,143.954650354,10,7,3,1
47,1677.51396054,111.940674518,16,11,5,2
mask,1677.29737299,124.219430609,14,9,5,2
vortex,1677.28230528,87.4000713892,39,26,13,5
phex,1676.93041127,103.439796885,34,25,9,4
psi,1676.90920255,142.238398085,9,6,3,1
parzival,1676.55553939,110.019849488,19,12,7,3
yardsale,1676.27855983,100.029499591,34,24,10,5
gato,1676.0862565,91.1281713751,27,17,10,4
quaff,1676.03176971,121.173546828,13,9,4,2
hentai legend,1675.84597453,130.914788304,11,8,3,1
fueg0,1675.28832476,141.535771071,10,6,4,2
zarinax,1675.26376206,167.065112824,6,4,2,1
windrose,1675.17701379,167.2153828,18,14,4,2
drunksloth,1675.17694902,131.434944936,19,13,6,3
callmeaustino,1674.99175466,141.410344902,9,6,3,1
citrus,1674.96491969,128.387655782,12,8,4,2
nevake,1674.7025819,135.015884944,12,8,4,1
nexic,1674.46784328,112.955521399,17,11,6,2
thissidedown,1674.36313346,107.906446643,19,13,6,2
liquid,1674.0405883,122.790836356,13,9,4,2
saus,1673.98129885,122.002707905,13,9,4,2
pk,1673.83050197,148.021079982,8,6,2,1
eight oh eight,1673.57491102,185.130211094,11,7,4,2
ripple,1673.37240369,142.811475622,10,7,3,1
shu shine,1673.22368459,169.240367086,6,4,2,1
pizzainacup,1672.81756313,166.776452481,7,5,2,1
pudgypanda,1672.69960389,103.923764681,17,11,6,2
wreckenfro,1672.37590768,268.589165175,1,1,0,1
moist,1672.34664108,119.431944393,14,9,5,2
greenmario,1672.32812396,165.092829107,6,4,2,1
flashburn 117,1672.27478346,86.7501430146,36,24,12,5
dawn,1672.23232749,125.980707297,14,10,4,2
quang,1672.22980831,121.885153597,14,10,4,2
hank,1672.22780701,105.609886653,20,13,7,2
tilt,1672.0589268,134.421582071,12,8,4,2
ctrlaltdefeat,1671.70352054,152.287238017,8,5,3,1
thoraxe,1671.49882747,126.073522305,14,10,4,2
ohai,1671.09666869,155.878224718,8,5,3,1
hh toast,1671.07265855,151.381308642,8,5,3,1
ryuker,1670.46298771,112.634857154,17,11,6,3
clue,1670.3055402,156.897003651,7,5,2,1
darkgenex,1670.25581775,173.770535027,19,11,8,4
godiegogo,1670.25153407,153.006436335,7,5,2,1
nhat,1670.23884036,150.251404086,10,7,3,1
unreal,1670.23884036,150.124896102,10,7,3,1
fishaman p,1670.23884036,149.617794495,10,7,3,1
silentspectre,1670.23884036,150.251404086,10,7,3,1
rofl,1670.23884036,150.251404086,10,7,3,1
wubbs,1670.12555124,172.488059336,6,4,2,1
jbvh,1670.02206692,173.455135618,7,5,2,2
goonsquad,1669.94058554,166.355118778,6,4,2,1
cheato,1669.91251249,143.468721104,10,7,3,1
ka-master,1669.74959824,108.229050872,18,12,6,2
professor peen,1669.66732598,149.718373475,10,6,4,2
sg,1669.44968408,163.525852163,7,5,2,1
kalzu,1669.44552026,135.128510003,10,7,3,1
gg7,1669.30795467,172.572251236,7,5,2,1
reason,1669.30795467,172.572251236,7,5,2,1
erik,1669.30795467,172.572251236,7,5,2,1
kimimaru,1669.30795467,172.572251236,7,5,2,1
ridz,1669.30795467,172.572251236,12,8,4,2
kimmy,1669.30795467,172.572251236,7,5,2,1
jace,1669.30795467,172.572251236,7,5,2,1
ratking,1669.30795467,172.572251236,7,5,2,1
yamaneko,1669.30795467,172.572251236,7,5,2,1
yakal,1669.30795467,172.572251236,7,5,2,1
warwick foe,1669.30795467,172.572251236,7,5,2,1
amazerommu,1669.30795467,172.020876339,7,5,2,1
lord,1669.30795467,172.572251236,7,5,2,1
mike melee,1669.30795467,172.296784348,7,5,2,1
darby,1669.30795467,171.689201456,7,5,2,1
groovy green hat,1669.30795467,172.572251236,7,5,2,1
shamunt,1669.30795467,172.572251236,15,10,5,2
chris best,1669.30795467,172.572251236,7,5,2,1
god with a wavebird,1669.30795467,172.572251236,7,5,2,1
d..p,1669.30795467,172.572251236,7,5,2,1
hulka,1669.30795467,172.572251236,7,5,2,1
yoshi,1669.30795467,172.572251236,7,5,2,1
shiny,1669.30795467,172.572251236,7,5,2,1
drug money,1669.30795467,172.572251236,7,5,2,1
oc mike the franchise,1669.30795467,172.572251236,11,7,4,2
mrbeenready,1669.30795467,172.572251236,7,5,2,1
fist mexico,1669.30795467,172.572251236,7,5,2,1
nerodero,1669.30795467,172.572251236,7,5,2,1
wooptywop,1669.30795467,172.572251236,7,5,2,1
ky,1669.30795467,172.572251236,7,5,2,1
zoap,1669.30795467,172.572251236,7,5,2,1
porkchops,1669.30795467,172.572251236,7,5,2,1
uma thurman,1669.30795467,171.689201456,7,5,2,1
medz,1669.30795467,172.572251236,7,5,2,1
bo0gyman,1669.30795467,172.572251236,7,5,2,1
sacasumoto,1669.30795467,172.572251236,7,5,2,1
blahyay,1669.28558781,130.227337051,10,6,4,1
the jester,1669.14221854,162.518709081,7,5,2,1
slypig,1669.11481229,130.407469882,11,7,4,2
tirno,1668.95913935,114.281216123,16,10,6,3
puff,1668.88465399,96.0325836148,26,17,9,4
lxix,1668.84147959,125.732567648,12,7,5,2
fluid,1668.82964082,120.173354352,17,11,6,3
skilljkfalco,1668.11619711,176.314777713,6,4,2,1
dazwa,1668.01681257,143.209161498,9,6,3,1
boyd,1667.9401691,165.810556131,8,4,4,2
bob$,1667.47639405,209.663360564,4,3,1,1
replicate,1667.47639405,209.663360564,4,3,1,1
drgn,1667.47639405,209.663360564,4,3,1,1
lunchables,1667.47639405,209.663360564,4,3,1,1
jacob,1667.47639405,209.663360564,4,3,1,1
alain,1667.37590545,147.078604845,10,7,3,1
fannypack,1667.34319507,101.059750195,22,14,8,2
kibbles,1667.13728486,108.198670199,19,13,6,2
smakis,1666.36404062,122.563286005,16,10,6,2
sk,1665.81945035,150.987391074,9,6,3,1
luck,1665.61152145,167.051416151,7,5,2,1
darkneo754,1665.42698024,130.125629929,12,8,4,2
omer,1665.15998142,174.837733864,6,4,2,1
jv,1664.98251797,152.713478309,7,4,3,1
sox,1664.50751715,147.757689925,8,5,3,1
jnaut,1664.47669682,171.653442968,6,4,2,1
gart,1664.38588018,123.40812451,13,9,4,2
thx,1664.30255889,116.48474696,15,10,5,2
pig,1664.30094448,106.874321282,18,12,6,2
impx,1663.9718593,133.597384167,12,8,4,2
imyt,1663.88148765,108.006917662,20,13,7,3
stango,1663.58198251,129.120112715,12,8,4,3
jdv,1663.52927255,152.915651009,9,6,3,1
thebattlerifle,1663.20787271,147.963243076,8,5,3,1
reesch,1663.18375967,89.3356392562,28,18,10,4
xardov,1663.18017046,125.570953881,23,15,8,3
dshi,1663.08258627,182.99545065,5,3,2,1
mojo,1662.81602328,120.689266063,12,7,5,2
samurai ike,1662.8146344,157.73267756,6,4,2,1
mundungu,1662.56500608,129.384526416,12,8,4,2
summonedfist,1662.29346629,161.807010945,8,5,3,1
vincessant,1662.24772589,108.826318377,16,10,6,3
agent kay,1662.21200261,290.786427926,1,1,0,1
suh dude,1662.21200261,290.786427926,1,1,0,1
boynder,1662.21200261,290.786427926,1,1,0,1
legion6691,1662.21200261,290.786427926,1,1,0,1
scorpius,1662.21200261,290.786427926,1,1,0,1
zug,1662.21200261,290.786427926,1,1,0,1
arjuna,1662.21200261,290.786427926,1,1,0,1
le golden magikarp,1662.21200261,290.786427926,1,1,0,1
jerusus,1662.21200261,290.786427926,1,1,0,1
brgirardeau,1662.21200261,290.786427926,1,1,0,1
spoonermcgee,1662.21200261,290.786427926,1,1,0,1
hipsterlumberjack,1662.21200261,290.786427926,1,1,0,1
dollaboiii,1662.21200261,290.786427926,1,1,0,1
edicus,1662.21200261,290.786427926,1,1,0,1
spark510,1662.21200261,290.786427926,1,1,0,1
nitrolibre,1662.21200261,290.786427926,1,1,0,1
bong,1662.21200261,290.786427926,1,1,0,1
boolaid,1662.21200261,290.786427926,1,1,0,1
zyko,1662.21200261,290.786427926,1,1,0,1
xyos,1662.21200261,290.786427926,1,1,0,1
hotaruz,1662.21200261,290.786427926,1,1,0,1
slacker298,1662.21200261,290.786427926,1,1,0,1
sivgard,1662.21200261,290.786427926,1,1,0,1
fraud,1662.21200261,290.786427926,1,1,0,1
4chat,1662.21200261,290.786427926,1,1,0,1
sugoi,1662.21200261,290.786427926,1,1,0,1
nab,1662.21200261,290.786427926,1,1,0,1
revok,1662.21200261,290.786427926,1,1,0,1
magnum,1662.21200261,290.786427926,1,1,0,1
ugi,1662.21200261,290.786427926,1,1,0,1
masskirbycide,1662.21200261,290.786427926,1,1,0,1
raboku,1662.21200261,290.786427926,1,1,0,1
vyrulent,1662.21200261,290.786427926,1,1,0,1
babygotbackup,1662.21200261,290.786427926,1,1,0,1
klimno,1662.21200261,290.786427926,1,1,0,1
championgg,1662.21200261,290.786427926,1,1,0,1
khersy,1662.21200261,290.786427926,1,1,0,1
hk,1662.21200261,290.786427926,1,1,0,1
samovar,1662.21200261,290.786427926,1,1,0,1
green eggs and cam,1662.21200261,290.786427926,1,1,0,1
grace,1662.21200261,290.786427926,1,1,0,1
rgb,1662.21200261,290.786427926,1,1,0,1
farbog,1662.21200261,290.786427926,1,1,0,1
wallofpuppies,1662.21200261,290.786427926,1,1,0,1
meezmo,1662.21200261,290.786427926,1,1,0,1
mo0cat,1662.21200261,290.786427926,1,1,0,1
dalln,1662.21200261,290.786427926,1,1,0,1
sandman,1662.21200261,290.786427926,1,1,0,1
scrubster,1662.21200261,290.786427926,1,1,0,1
falkony,1662.21200261,290.786427926,1,1,0,1
nikopena,1662.21200261,290.786427926,1,1,0,1
dad?,1662.21200261,290.786427926,1,1,0,1
vox,1662.21200261,290.786427926,1,1,0,1
glare,1662.21200261,290.786427926,1,1,0,1
sakai,1662.21200261,290.786427926,1,1,0,1
fuzzard,1662.21200261,290.786427926,1,1,0,1
hutch,1662.21200261,290.786427926,1,1,0,1
nail,1662.21200261,290.786427926,1,1,0,1
ring,1662.21200261,290.786427926,1,1,0,1
thebigredt,1662.21200261,290.786427926,1,1,0,1
kevingchang,1662.21200261,290.786427926,1,1,0,1
herrmann,1662.21200261,290.786427926,1,1,0,1
brunobars,1662.21200261,290.786427926,1,1,0,1
sunnyknight,1662.21200261,290.786427926,4,2,2,2
alcapwned,1662.21200261,290.786427926,1,1,0,1
elmore,1662.21200261,290.786427926,1,1,0,1
noops,1662.21200261,290.786427926,1,1,0,1
frozeneye,1662.21200261,290.786427926,1,1,0,1
-9-,1662.21200261,290.786427926,1,1,0,1
prevaloir,1662.21200261,290.786427926,1,1,0,1
addy daddy,1662.21200261,290.786427926,1,1,0,1
boor,1662.21200261,290.786427926,1,1,0,1
ellorin,1662.21200261,290.786427926,1,1,0,1
miley,1662.21200261,290.786427926,1,1,0,1
sko,1662.21200261,290.786427926,1,1,0,1
_cel,1662.21200261,290.786427926,1,1,0,1
feeniks,1662.21200261,290.786427926,1,1,0,1
drazax,1662.21200261,290.786427926,1,1,0,1
ketsu,1662.21200261,290.786427926,1,1,0,1
theukuleleguy,1662.21200261,290.786427926,1,1,0,1
vikiz,1662.21200261,290.786427926,1,1,0,1
snester,1662.21200261,290.786427926,1,1,0,1
mch,1662.21200261,290.786427926,1,1,0,1
t26 #2528,1662.21200261,290.786427926,1,1,0,1
xinicide,1662.21200261,290.786427926,1,1,0,1
tsmith9915,1662.21200261,290.786427926,1,1,0,1
pickle,1662.21200261,290.786427926,1,1,0,1
puffnasty,1662.21200261,290.786427926,1,1,0,1
jdubz,1662.21200261,290.786427926,1,1,0,1
chedderb0b,1662.21200261,290.786427926,1,1,0,1
danch,1662.20253436,165.797414416,7,5,2,1
luigigoshard,1662.12917333,75.1876988443,45,29,16,6
maxy,1661.88611369,120.44722334,26,17,9,3
grandshrimp,1661.71960234,169.057722423,6,4,2,1
ed,1661.70995854,156.084852051,7,5,2,1
razor ramon,1661.62818745,196.928655297,16,10,6,2
mittens,1661.51120414,151.811063107,11,6,5,2
bizz,1661.45358732,160.321773557,7,4,3,1
fives,1661.25366807,147.496979876,9,6,3,1
bluebuster,1660.9345965,126.303554741,11,7,4,1
shonic,1660.65617224,151.78492512,9,6,3,1
bor,1660.62310726,129.227800216,14,9,5,2
blendtec,1660.60073612,131.888128448,13,9,4,2
ferriswheel,1660.45226688,108.44535819,21,14,7,3
gtown_tom,1660.28166982,134.639409212,12,8,4,2
£30-,1660.19548131,154.5092608,8,5,3,1
derfmidwest,1660.12416947,144.769387557,8,5,3,1
endeby,1660.09976505,105.668345264,21,13,8,3
zasa,1659.96379752,107.505049915,19,12,7,3
sastopher,1659.85594011,170.53288385,6,4,2,1
tempo,1659.47143925,132.797653058,23,16,7,3
vj,1658.93436715,141.265289862,9,6,3,1
mojomonkey,1658.79333094,163.355795504,7,4,3,1
andonuts,1658.79065168,165.935897969,7,5,2,1
kaeon,1658.76182261,167.795961856,6,4,2,1
s-royal,1658.50843578,158.029181653,7,5,2,1
helmet,1658.36503629,140.457735386,19,12,7,3
surf's up. hail satan.,1658.09833832,103.699544548,19,12,7,2
stelzig,1657.93723064,111.104708793,19,13,6,2
xif,1657.91213159,184.020264003,12,7,5,2
quin,1657.03481969,126.228736282,10,6,4,1
wolven,1657.02894628,104.344503368,21,14,7,3
tiramisu,1656.95331868,171.157835097,6,4,2,1
vdub,1656.87101845,106.840619901,19,12,7,3
tenshi,1656.70005869,166.616033619,7,5,2,1
photonic,1656.29224963,95.5255664266,26,17,9,3
andy,1656.13494705,157.557374802,8,6,2,1
bananasack,1656.0992718,150.154319722,8,5,3,1
bomb,1656.02168862,123.427538983,14,9,5,2
zook,1655.76814201,106.098551211,25,16,9,4
umasi,1655.71279611,142.199071081,9,6,3,1
jozi,1655.58501969,145.838562076,8,5,3,1
pervy,1655.22555513,184.220924214,5,3,2,1
bonkcushy,1655.15368049,106.167730524,18,12,6,2
mfsa,1654.50905552,164.826981657,6,4,2,1
ungiven,1654.48865463,181.065447798,6,4,2,1
dizney,1654.48865463,181.222781091,6,4,2,1
eet,1654.35088414,157.356430097,16,11,5,2
kyle bananasak's left nip,1653.76381021,178.18167508,6,4,2,1
weeaboo,1653.68107227,107.389156002,22,14,8,3
yasu,1653.5324459,171.650156491,6,4,2,1
zlazher,1653.21830527,136.182770088,11,7,4,2
emz,1653.01038728,165.376653495,7,5,2,1
dab,1652.73285778,133.631455255,17,10,7,3
blu-j,1652.65298667,179.597910505,6,4,2,1
babycakes,1652.62247053,235.842343984,9,5,4,2
bizzarro flame,1652.47994605,132.066344692,13,9,4,3
glitchy,1652.31521456,222.090452969,13,7,6,2
snacks!,1652.15569412,127.827990964,14,9,5,2
neologism,1652.08771183,149.18695866,18,12,6,2
syko,1651.9119932,143.186876913,10,6,4,2
watchingtime,1651.90450259,131.940823635,11,7,4,2
mchi,1651.82008318,113.783663499,18,12,6,3
theswooper,1651.8193863,104.129370237,23,15,8,4
cookiemonsta,1651.80126258,102.680527135,19,11,8,3
thoreo,1651.5533997,132.722871368,13,9,4,2
poop,1651.52148104,132.022591902,13,9,4,2
mr. lemon,1651.5063033,146.885984684,9,6,3,1
quality steve,1650.93532595,163.597890622,6,4,2,1
jim jam flim flam,1650.71132151,134.739078984,11,7,4,2
jf,1650.70573267,86.926890506,28,17,11,5
eon,1650.64183304,136.843362851,22,12,10,4
j00t,1650.46958202,173.090763452,6,4,2,2
tanooki,1650.2676113,180.25466403,7,5,2,2
subtle,1650.14119085,115.101933595,18,12,6,3
coastward,1649.8112812,134.572636979,11,7,4,2
wishh,1649.77565483,170.259781556,6,4,2,1
thevelvetmarmot,1649.30879086,167.573688254,7,5,2,1
decaf,1649.09251509,145.636391301,9,6,3,1
gimme,1649.09196061,112.137294651,17,11,6,3
switch,1648.93278449,97.6938217828,24,14,10,4
pureskillz,1648.90917634,194.66866645,15,9,6,2
biggpappa,1648.77896483,204.182015012,11,7,4,2
| smokey bluntz,1648.59360013,164.415060102,7,5,2,1
dublat,1648.51933923,171.749033417,14,9,5,2
rick,1648.4665524,159.941796147,7,5,2,1
flambo,1648.26843575,167.416193603,6,4,2,1
niklas2912,1648.25218829,154.305503363,7,5,2,1
galen the wise,1648.10178253,123.751539729,14,9,5,2
hanyuuki,1648.09547525,178.699627209,6,4,2,1
emodinosaur,1648.04224807,107.851121989,20,13,7,3
njzfinest,1647.76167667,176.393141688,6,4,2,1
seeray,1647.58951579,153.436071834,8,5,3,1
kyu puff,1647.49181136,141.658793327,10,6,4,1
rjw,1647.46450549,196.62150417,10,6,4,2
lazarous,1647.43410534,152.220995426,8,5,3,1
rockmix,1647.34976434,142.521084789,12,8,4,2
baby bird,1647.29238108,140.241763928,12,8,4,2
klaps,1647.23618028,150.608690449,8,5,3,1
modem,1647.18477842,121.371579692,15,10,5,2
ricky,1646.72613761,112.647872789,20,13,7,2
anaveragekid,1646.2636563,138.827284873,12,8,4,1
ses,1646.18037753,125.270425205,14,9,5,2
emanon,1646.11912852,108.828842893,28,20,8,4
watt the flux,1646.04585492,202.759359146,5,3,2,1
ionthekid,1646.04096941,132.727255657,11,7,4,2
skeith,1646.01193484,108.607938505,18,12,6,2
harald,1646.00372239,120.47349916,16,11,5,2
pas,1645.97171061,125.910552125,14,9,5,2
ellis,1645.74655479,119.429882683,15,10,5,2
natendo,1645.60889049,165.716156901,7,5,2,1
little england,1645.59198159,164.802802733,7,5,2,1
jonas,1645.56483791,179.515830419,6,4,2,1
odds,1645.41009305,137.841861392,11,7,4,1
nox,1645.24112174,88.1360697441,30,19,11,4
mattmog,1645.19406976,105.585526318,19,12,7,2
@tryceblazer,1645.17531946,148.346430398,8,5,3,1
barrakir,1645.06047628,173.185015838,6,4,2,1
yordy,1644.9531058,168.753823904,7,4,3,1
oro?!,1644.87151958,178.754652113,5,3,2,1
s2b,1644.86931827,120.747995963,15,9,6,2
marriott moy,1644.85818889,111.207914818,17,11,6,3
zorbak,1644.80567146,171.05756097,6,4,2,1
sjkf,1644.80237713,138.666383025,10,6,4,1
king quiggles,1644.703884,174.222548144,6,4,2,1
videowaffles,1644.47858985,120.835295829,13,8,5,2
vestboy myst,1644.36564951,143.075489705,8,5,3,1
hyperflame,1644.35591585,112.028392772,17,11,6,3
sandy,1644.31836767,174.637118855,6,4,2,1
nainsoo,1644.24081359,163.160444966,7,5,2,1
maximus,1644.22873957,102.860407537,21,13,8,3
shadowzw,1644.12077944,188.475070434,5,3,2,1
thomdore,1643.47071521,125.355397852,13,8,5,2
meo,1643.30003418,148.430501362,14,8,6,2
igneous rock,1643.25665911,202.055335513,5,3,2,1
kaimen,1643.23971423,168.254582314,6,4,2,1
metal reaper,1643.19300175,156.323573699,6,4,2,1
infernojesus,1642.71265599,111.832555296,19,12,7,3
velocity,1642.67725046,138.810432082,12,8,4,2
elegy,1642.64381872,142.596536159,10,7,3,1
aura,1642.48811917,171.875441954,13,6,7,2
desucakes,1642.36305326,177.629468496,16,10,6,2
floorboards,1642.19238092,154.989487534,8,5,3,1
zeppx,1641.97043079,154.78073416,18,11,7,3
krut,1641.86017402,164.114602088,7,5,2,1
shon,1641.80036824,169.79956298,7,4,3,1
speez,1641.72355019,177.566776085,6,4,2,1
mrbenready,1641.58140015,135.925603341,15,9,6,3
drag,1641.56286012,115.991634125,17,11,6,2
ford$,1641.2492023,169.67376986,6,4,2,1
mr. f,1641.22749066,170.571660998,6,4,2,1
tek9,1640.88458629,167.89415016,14,9,5,2
jairee,1640.86291005,138.475465011,9,6,3,1
gndy,1640.7506555,161.527424687,8,5,3,1
bigvegetabluntz,1640.72119646,102.770015822,20,13,7,3
tess,1640.54716553,177.135442971,6,4,2,1
karils,1640.09989181,169.893731917,6,4,2,1
fazers,1640.04479016,170.791497276,6,4,2,1
ihwp,1639.90695813,139.835518124,11,7,4,2
petteh,1639.76407908,116.939516813,23,15,8,3
peanut,1639.75064829,123.331168479,13,8,5,1
gso,1639.51612978,116.925890074,16,10,6,2
balloon,1639.23521381,122.2077743,15,10,5,2
karma,1639.19867032,106.979879302,21,13,8,2
toastbread,1639.07777628,156.679676546,9,6,3,1
plinci,1639.07777628,156.558363055,9,6,3,1
zombie!,1639.07777628,156.679676546,9,6,3,1
ganz,1639.07777628,156.558363055,9,6,3,1
benteezy,1639.07777628,156.679676546,14,9,5,2
kanti,1639.07777628,156.679676546,9,6,3,1
clade,1639.07777628,156.558363055,9,6,3,1
romeo,1639.07777628,156.679676546,9,6,3,1
tc,1639.07777628,156.679676546,9,6,3,1
lovage,1639.07777628,156.679676546,9,6,3,1
sherigami,1639.07777628,156.679676546,9,6,3,1
ezvip,1639.07777628,157.646823763,9,6,3,2
xelius,1639.07777628,156.558363055,9,6,3,1
manyula,1639.07777628,156.558363055,18,12,6,2
the phenom,1639.07777628,156.679676546,9,6,3,1
nanacomehome,1639.07777628,156.679676546,9,6,3,1
the leaf,1638.7779809,123.580837445,13,8,5,2
sneker,1638.35829343,170.36027802,5,3,2,1
badmdvafox829,1638.34052197,182.468014955,5,3,2,1
quindelin,1637.98162746,149.293022956,8,5,3,1
noc,1637.95346466,165.85564528,7,5,2,1
rhan,1637.82283299,129.481218176,16,10,6,3
trinity92,1637.61190489,175.018356426,7,4,3,1
mew2queen,1637.32707873,128.487061702,13,8,5,2
haotwo,1637.23973422,118.030666534,25,16,9,3
kingbbb,1637.23179221,171.946476694,6,4,2,1
twisty,1637.11608447,139.657635307,9,6,3,1
tenwa,1637.10095931,140.765998111,11,7,4,2
qerb,1637.01921406,174.092903537,6,4,2,1
jim morrison,1637.0065914,174.961167747,7,4,3,1
anjo,1636.93081,167.425399698,8,5,3,2
ghettowarmachine420,1636.9031358,158.5897193,7,5,2,1
punk panda,1636.83772904,168.758123025,6,4,2,1
nurok,1636.74410632,103.105889126,24,15,9,4
overflow,1636.6668285,145.19431359,9,6,3,1
epidemique,1636.45786272,168.533303846,6,4,2,1
hippo,1636.40443545,159.7426887,8,5,3,1
legion,1636.32931316,89.8360865315,30,18,12,5
mahone,1636.26656767,152.418958868,7,4,3,1
thrash,1636.15694239,96.3322792876,27,18,9,4
toa,1635.43189289,137.681236738,18,11,7,3
dr. chekhov,1635.38164065,161.570045899,6,4,2,1
jet,1635.15616316,131.790647341,12,7,5,2
hubsrico,1635.0637163,274.580045044,1,1,0,1
bluekoops16,1635.0637163,274.580045044,1,1,0,1
bronte,1635.0637163,274.580045044,1,1,0,1
japf,1634.93236827,122.669477774,14,9,5,2
focus,1634.86059676,105.414242005,21,13,8,4
slowking,1634.82196387,105.615642139,17,10,7,2
mr. tuesday,1634.77790328,141.329929299,9,5,4,1
pleasantries,1634.73193015,120.537419755,14,9,5,2
gblade,1634.40934873,97.873365539,32,20,12,4
jackie,1634.39855663,225.216057972,11,7,4,2
beans,1634.31545446,165.571787864,15,9,6,2
signd0g,1634.26246941,114.862419357,14,9,5,2
een!,1634.10372201,167.13858962,7,5,2,1
gardex,1633.85646635,94.1098868391,25,15,10,3
phish-it,1633.83943424,112.304162322,24,15,9,4
hart,1633.63659672,106.610016644,18,11,7,3
bliss,1633.6072573,137.08324159,11,7,4,2
dz,1633.48571784,178.770454495,10,4,6,3
yield,1633.32534087,184.239646778,4,2,2,1
robbo,1633.24301742,175.556042222,6,4,2,1
ludvig4,1633.0962171,159.161787493,7,4,3,1
mexx,1633.01712715,194.691277776,5,3,2,1
blaze,1632.95767855,99.4803437141,39,26,13,4
l2p,1632.87838709,175.935127663,6,4,2,1
sfop,1632.81927485,129.588515163,11,7,4,1
neft,1632.74874309,175.803479384,6,4,2,1
mr. muscles,1632.45423147,115.343676151,16,10,6,2
keto,1632.44411719,138.681030838,10,6,4,2
dj red lantern,1632.31503607,158.901946962,7,4,3,1
salty seth,1632.2049051,88.0095540845,29,18,11,4
vista,1632.08728749,151.952437957,7,4,3,1
hitmonchanondorf,1631.7857536,177.010172475,6,4,2,1
hadoken,1631.40398398,116.957335553,15,10,5,2
riio,1630.98538623,141.04695025,10,6,4,1
davidcanfly,1630.46569094,139.422350989,10,6,4,2
jojo,1630.36525872,147.363554144,8,5,3,1
myztek,1630.26798804,114.23879468,18,11,7,3
hacky,1629.93064837,126.674084403,14,9,5,2
bluezaft,1629.28865933,173.154359533,6,4,2,1
fantomenk,1629.03170733,175.994326657,6,4,2,1
restez,1628.86092407,124.927163376,20,11,9,3
th0rn,1628.69038412,133.08174535,9,6,3,1
atlas,1628.58981748,97.721694072,21,13,8,3
akio,1628.54298296,175.64148933,6,4,2,1
meero,1628.38763014,197.323495872,5,3,2,1
bawstin,1628.37362798,149.15802946,9,6,3,1
lego,1627.9540852,114.168232189,17,11,6,3
upke,1627.81863039,129.900668103,13,9,4,2
gman,1627.75590013,139.166669195,10,6,4,2
dsj,1627.66630196,158.83413423,7,4,3,1
blockhead,1627.63835341,137.417547212,12,8,4,2
phantom,1627.62656424,155.265623912,10,6,4,2
therocketinyourpocket,1627.5541457,169.43486633,6,4,2,1
allen,1627.5121174,178.826285027,7,4,3,2
jank,1627.48458603,92.0917834524,27,17,10,4
brog,1627.44697506,182.063701722,11,7,4,2
jada,1627.40368289,174.81654862,6,4,2,1
farks,1627.34836129,144.592901062,8,5,3,1
trilok,1627.21467701,114.320628827,16,10,6,2
sourdough,1627.04877178,173.42468569,6,4,2,2
regular chris,1627.02803329,181.856971808,5,3,2,1
poopmaister6000,1626.88046922,96.2498570136,26,16,10,3
dano,1626.69282929,157.437514759,7,4,3,1
vudujin,1626.6347393,182.632308241,6,4,2,1
littlebuster,1626.6347393,182.632308241,6,4,2,1
kokichi,1626.6347393,182.632308241,6,4,2,1
ippo,1626.6347393,182.632308241,6,4,2,1
kamiyazaki,1626.6347393,181.850378095,6,4,2,1
rebel,1626.6347393,182.632308241,6,4,2,1
spyderj,1626.6347393,182.632308241,6,4,2,1
hara,1626.6347393,182.528244426,6,4,2,1
docta love,1626.6347393,182.632308241,6,4,2,1
dempsey,1626.6347393,182.632308241,6,4,2,1
ghidorah,1626.6347393,182.632308241,6,4,2,1
rektangle,1626.6347393,182.059221171,6,4,2,1
toiya,1626.6347393,182.632308241,6,4,2,1
nja,1626.6347393,181.641294901,6,4,2,1
sk92,1626.6347393,182.632308241,6,4,2,1
dana,1626.6347393,182.632308241,6,4,2,1
bardull,1626.6347393,182.632308241,6,4,2,1
cobab,1626.6347393,181.641294901,6,4,2,1
prevalence,1626.6347393,182.632308241,6,4,2,1
scrub$,1626.6347393,182.632308241,6,4,2,1
web,1626.6347393,182.059221171,6,4,2,1
timestop,1626.6347393,182.059221171,6,4,2,1
berble,1626.6347393,182.632308241,6,4,2,1
wavebringer,1626.6347393,182.632308241,6,4,2,1
trl,1626.6347393,182.372037367,6,4,2,1
dimsum,1626.6347393,182.632308241,6,4,2,1
austintacious,1626.6347393,182.632308241,6,4,2,1
c_rez,1626.6347393,182.632308241,6,4,2,1
big d,1626.6347393,182.632308241,6,4,2,1
h3aderon,1626.6347393,182.372037367,6,4,2,1
d.m.,1626.6347393,182.632308241,6,4,2,1
zachy,1626.6347393,182.632308241,6,4,2,1
manatee,1626.6347393,182.632308241,6,4,2,1
elcancell,1626.6347393,182.632308241,6,4,2,1
rickshaw,1626.6347393,182.632308241,6,4,2,1
ecto,1626.6347393,182.163552923,6,4,2,1
eg0r,1626.6347393,182.528244426,6,4,2,1
mr. kabuki,1626.6347393,182.632308241,6,4,2,1
beeftip,1626.6347393,182.372037367,6,4,2,1
shmeetah,1626.6347393,182.632308241,6,4,2,1
potato,1626.6347393,182.632308241,6,4,2,1
cheezpuff,1626.6347393,182.632308241,6,4,2,1
tato,1626.6347393,182.632308241,6,4,2,1
mixx,1626.6347393,182.632308241,6,4,2,1
devil may cry 3,1626.6347393,181.79812984,6,4,2,1
conix,1626.6347393,182.632308241,6,4,2,1
envelope,1626.6347393,182.632308241,6,4,2,1
althalous,1626.6347393,182.632308241,6,4,2,1
got em,1626.6347393,182.632308241,6,4,2,1
yirumi,1626.6347393,182.632308241,6,4,2,1
aza,1626.6347393,182.632308241,6,4,2,1
halestorm,1626.6347393,182.632308241,6,4,2,1
baka4moe,1626.6347393,182.632308241,14,9,5,2
codi,1626.6347393,182.632308241,6,4,2,1
eclipsing binary,1626.6347393,182.632308241,6,4,2,1
roid,1626.6347393,182.632308241,6,4,2,1
dep,1626.6347393,182.632308241,6,4,2,1
eastcoastjeff,1626.6347393,182.632308241,6,4,2,1
bimbo mexico,1626.6347393,182.632308241,6,4,2,1
hella,1626.6347393,182.632308241,6,4,2,1
boulevard,1626.6347393,182.632308241,6,4,2,1
decoste in the shell,1626.6347393,182.632308241,6,4,2,1
dzd,1626.6347393,182.632308241,6,4,2,1
fridgebits,1626.6347393,182.632308241,6,4,2,1
simna ibn sind,1626.6347393,182.632308241,6,4,2,1
birdshit,1626.6347393,182.632308241,6,4,2,1
zamma,1626.6347393,182.632308241,6,4,2,1
smopup,1626.6347393,182.632308241,6,4,2,1
aguos,1626.6347393,182.163552923,6,4,2,1
peligro,1626.6347393,182.632308241,6,4,2,1
iram,1626.6347393,182.632308241,6,4,2,1
moe,1626.6347393,182.528244426,6,4,2,1
radar,1626.6347393,182.163552923,6,4,2,1
f.lux,1626.6347393,182.528244426,6,4,2,1
roukiske,1626.6347393,182.632308241,6,4,2,1
coolkid,1626.6347393,182.632308241,6,4,2,1
aria,1626.6347393,182.632308241,6,4,2,1
bubs,1626.6347393,182.163552923,11,6,5,2
zander,1626.6347393,182.632308241,6,4,2,1
draz,1626.6347393,182.528244426,13,9,4,2
saint driven,1626.6347393,182.632308241,6,4,2,1
don,1626.6347393,181.641294901,6,4,2,1
bird jesus,1626.6347393,182.632308241,6,4,2,1
kape,1626.6347393,182.528244426,6,4,2,1
santiago,1626.6347393,182.632308241,6,4,2,1
poobanans,1626.6347393,182.632308241,6,4,2,1
yih,1626.6347393,182.632308241,6,4,2,1
socks,1626.6347393,182.528244426,13,9,4,2
tuxedo mask,1626.6347393,182.632308241,6,4,2,1
mooninite,1626.6347393,182.632308241,6,4,2,1
bluefalcon7,1626.6347393,182.632308241,6,4,2,1
craiger,1626.6347393,182.632308241,6,4,2,1
spades,1626.6347393,182.632308241,6,4,2,1
kmac,1626.6347393,182.632308241,6,4,2,1
seshy,1626.6347393,182.632308241,6,4,2,1
force,1626.6347393,182.632308241,6,4,2,1
maximo,1626.6347393,182.632308241,6,4,2,1
squid,1626.6347393,182.632308241,6,4,2,1
veklor,1626.58005193,121.446182807,14,9,5,2
nagy,1626.50589383,148.037662099,8,5,3,1
sabelan,1626.21221454,142.674257703,15,9,6,3
copycat,1626.19834723,173.158031945,6,4,2,1
alan,1625.91520896,114.826872827,20,12,8,4
captain neckbeard,1625.89051505,196.292762215,5,3,2,1
basic stitch,1625.64165149,136.75385523,12,8,4,2
mums,1625.33392112,123.766777161,15,9,6,2
saxon,1625.29832876,148.263233284,8,5,3,1
flion,1625.18592868,112.135781251,18,11,7,2
village mascot,1625.10487347,103.216590888,19,12,7,3
twistytreats,1625.10238919,145.381715515,8,5,3,1
dfu,1624.97154158,154.965408876,7,4,3,1
shk shk,1624.80300569,156.938334249,8,5,3,2
2krunkvillain,1624.76955442,182.922363087,5,3,2,1
oh,1624.29530819,165.053778641,7,4,3,1
ecco,1624.29305348,174.01828038,6,4,2,1
buddy guysman,1624.23191572,160.445760027,7,4,3,1
mom!,1624.22741821,114.377534063,15,10,5,2
chompskye,1623.95864772,170.88309999,6,4,2,2
irs,1623.84849367,126.432150861,14,8,6,3
thunderpaste,1623.74885956,160.397820431,6,4,2,2
nerd,1623.67105304,171.906472139,6,4,2,1
kip,1623.64267991,182.032136494,5,3,2,1
sillie willie,1623.59085494,131.096700366,12,8,4,2
isdsar,1623.56230615,157.545917917,8,5,3,1
alien,1623.51160736,121.374361113,14,8,6,2
wrackle,1623.36614735,116.440927323,16,10,6,2
zeeop,1623.35355375,145.652153333,8,5,3,1
funcrazyfish,1622.88185131,152.880305013,8,5,3,1
aly,1622.83955665,136.710292429,10,6,4,2
spree,1622.79386679,174.968328284,6,4,2,1
kason,1622.76474854,176.935714944,5,3,2,1
krunkled,1622.61188241,126.196940036,14,9,5,2
ganobrator,1622.58290569,143.462309083,10,6,4,2
wasabi,1622.29316758,122.33007158,16,10,6,2
pocket sand,1622.09900784,150.43652945,8,5,3,1
skillznasty,1622.04077519,127.743397574,13,8,5,2
yashichi,1621.842874,142.159451856,9,5,4,1
davis,1621.80741769,123.174775335,16,9,7,2
wonderbread,1621.76460905,168.535381426,6,4,2,2
eru,1621.6645768,187.861892488,5,3,2,1
zylo,1621.62261311,156.142573493,8,5,3,1
gemini,1621.54506358,123.820376421,13,8,5,2
g1ft v2.0,1621.44741474,164.828810418,6,4,2,1
sqiddwr,1621.13917336,167.431909243,7,4,3,1
orange,1620.63175313,195.100936336,5,3,2,1
monkey,1620.57391314,236.36482941,9,5,4,2
nigo,1620.45839865,151.971928818,10,6,4,2
konati,1620.38149374,176.587771781,16,10,6,2
jpoptosis,1620.37951504,273.004341182,1,1,0,1
a*,1620.32185359,195.507482683,5,3,2,1
roytheboi,1620.17571815,136.52300399,11,7,4,1
digital cannon,1620.06953349,165.519008459,7,4,3,1
kuhls,1619.79284038,159.45823847,8,5,3,1
lildemon,1619.77252504,168.28507314,6,4,2,1
cottons,1619.69423902,171.825018002,6,4,2,1
krumm,1619.51658802,109.62054813,22,12,10,3
wild,1619.39614288,149.755105774,8,5,3,1
juicebox,1619.17136143,158.551364167,8,5,3,1
yikes,1618.85831774,150.985402924,8,5,3,1
toph,1618.76261962,107.382032997,42,27,15,8
magi,1618.67872372,150.185572877,7,4,3,1
trk,1618.60989004,122.640117123,13,8,5,2
wingleborg,1618.58857263,133.535168429,11,7,4,2
elephante,1618.50096197,120.226506561,15,10,5,2
giraphe,1618.42493861,167.740870985,6,4,2,1
bigwenz,1618.16964673,93.3281874245,28,17,11,5
armand,1618.1511563,161.110836562,6,4,2,1
*zen,1618.07238811,161.311761778,8,5,3,1
q,1618.03823887,104.47573558,22,13,9,4
panic,1618.00738777,144.573041605,11,7,4,1
bobi,1617.96109335,170.561715187,7,4,3,1
sorry,1617.9555718,181.639078906,6,4,2,2
k1kk0m4n,1617.79224718,161.743199707,8,5,3,1
kotojo,1617.76363103,159.015073901,8,5,3,1
notmitch,1617.7133357,179.023476018,5,3,2,1
nard dogg,1617.70859545,104.049863847,20,13,7,2
archive,1617.61919702,166.877972518,6,4,2,1
jeff foxworthy,1617.52075115,168.948783593,7,4,3,1
dr. z,1617.38319083,94.6520272831,25,15,10,4
tian,1617.00471698,118.587787346,14,8,6,3
lain,1617.00187742,160.470495012,7,4,3,1
tonight we feast,1616.90295518,177.691786604,6,4,2,1
nuggets,1616.77308507,106.766190598,20,12,8,3
t. webb,1616.67157823,123.792726052,13,8,5,2
neak-o,1616.59903956,287.386126129,1,1,0,1
smoe,1616.59903956,287.022273511,1,1,0,1
tichinde925,1616.54346044,173.190489653,6,4,2,1
explo,1616.46216982,121.322777563,27,17,10,3
damp,1616.45517569,137.928954285,9,6,3,1
dla,1616.44632047,160.295230634,8,5,3,1
fluffs,1615.96809391,138.696552391,8,5,3,1
fortissimis,1615.94783799,118.566073313,16,10,6,2
ott,1615.88838993,133.718933545,10,6,4,2
grabsomeeyes,1615.82767896,181.834356872,5,3,2,1
krkkvpl,1615.77807671,172.103684495,5,3,2,1
crimsonkid,1615.71996943,123.069040282,12,7,5,2
musgraves,1615.47122074,134.208250896,13,8,5,2
sizzle,1615.37376732,175.637525702,6,4,2,1
plz,1615.37376732,176.393141688,6,4,2,1
jwilli,1615.37072492,123.915800311,12,7,5,2
knubs.,1615.28394138,109.933891842,17,11,6,2
imrainh2o,1615.26306212,176.916178344,6,4,2,1
el paco,1615.16896438,185.790859953,5,3,2,1
keithrep,1615.1640372,121.647424012,16,10,6,2
hannydoon,1615.08135536,166.819095518,6,4,2,1
cupofwater,1614.92049451,175.541492243,6,4,2,1
norwood,1614.88913693,123.36660262,11,7,4,1
silence,1614.55798235,134.124966928,11,7,4,2
logos,1614.55247543,122.333217191,15,8,7,3
dirty mike,1614.07112086,165.163933896,6,4,2,1
vigilance,1613.88723893,169.407266345,6,4,2,1
breezy,1613.83290746,128.504868616,13,8,5,2
argo,1613.74623731,187.321067993,5,3,2,1
pablobear8,1613.72197503,143.01016988,8,5,3,1
runwithit,1613.665109,172.501829715,5,3,2,1
$tijn,1613.62514894,158.51678114,8,5,3,1
kanye rest,1613.50388115,133.162002019,21,14,7,3
quig,1613.45303621,130.888525418,11,7,4,2
stitchface,1613.41953104,145.170161159,11,7,4,2
puppeh,1613.11652853,114.099241082,16,10,6,3
chaitea,1613.11520862,174.731230676,5,3,2,1
nix,1613.01092257,210.811942837,11,7,4,2
icy,1612.8711596,134.148759627,11,6,5,2
bolvelt,1612.66737229,177.256773457,14,9,5,2
sneddy,1612.54463852,199.788817033,13,8,5,2
@ssbm_ichigo,1612.30723643,181.238902913,5,3,2,1
kman,1612.15633847,183.932408823,7,4,3,3
trademark,1612.11653547,137.092943105,10,6,4,2
bpow,1611.65208409,148.896836797,9,6,3,1
50 quid,1611.4778347,187.981855417,5,3,2,1
freessbm,1611.4778347,187.981855417,5,3,2,1
chief,1611.33478776,162.312431527,7,4,3,1
blizz,1611.25147511,172.104029933,6,4,2,1
karson,1611.15824985,150.473065704,10,6,4,1
tessa,1610.96175891,170.989161164,6,4,2,1
j,1610.8805062,120.875851701,15,9,6,2
toodee,1610.76124441,193.258399411,5,3,2,1
ted,1610.74432815,127.49279746,14,9,5,2
chai,1610.45635707,141.922174529,10,6,4,1
a-wall,1610.3887926,113.356363531,14,7,7,2
mr. potatobread,1610.18144248,163.417346901,13,6,7,2
red sheik,1610.07464807,177.291665319,7,4,3,1
elfman,1610.03678651,140.636437713,9,6,3,1
snoosnoo,1609.97341604,113.924932298,19,12,7,3
joe k,1609.85663816,136.497316104,11,7,4,1
mordicon,1609.78078254,166.676503407,6,4,2,1
walt,1609.50713131,172.637141426,6,4,2,1
krazy kev,1609.0183847,179.329688615,5,3,2,1
jays on my feet jordan,1608.667646,192.701354348,5,3,2,1
fireflyhi,1608.61861796,173.195222451,5,3,2,1
metallix,1608.46451037,159.718618922,8,5,3,1
infernoomni,1608.46451037,159.540080325,8,5,3,1
tas,1608.27448663,154.534293755,13,8,5,2
guac,1608.15266202,160.34974624,8,5,3,1
frosti,1608.10768611,192.27128932,5,3,2,1
xiivi,1608.04864409,81.051298946,49,29,20,8
deliciouskale,1607.99528163,192.000905906,5,3,2,1
kulczak,1607.79828067,148.0294901,8,4,4,1
cdub,1607.6093626,157.217828864,8,5,3,2
robin,1607.4689618,137.752114985,11,7,4,2
ultimascout,1607.42026436,174.050046488,6,4,2,1
simian,1607.26096684,123.295728745,14,9,5,2
sooji,1606.97269507,119.729691018,16,10,6,2
shwa$bb,1606.78620777,178.430984807,6,4,2,1
simple,1606.71672333,115.683669163,17,11,6,2
androyd,1606.24461066,180.786823541,5,3,2,1
jsteezus,1606.21591432,190.989685267,5,3,2,1
stress,1606.21591432,190.989685267,5,3,2,1
jonathan cotto,1606.18254369,128.71638881,9,6,3,1
beewesley,1606.01476455,187.285161111,5,3,2,1
gumble,1605.98333712,125.819379036,14,9,5,2
suezo,1605.97508667,118.534879986,18,10,8,4
slug,1605.66357224,148.284913845,10,6,4,2
dyl,1604.73956919,142.775982021,10,6,4,1
team nick,1604.52838601,152.71874624,7,4,3,1
russell,1604.44990759,191.295588669,5,3,2,1
snorlaxes,1604.38781648,190.803510072,5,3,2,1
p2thedr,1604.36424211,193.030465015,5,3,2,1
malex,1604.21244821,172.983646136,6,4,2,1
ovenn,1604.10083235,157.097367318,8,5,3,1
mementomori,1603.92591947,158.801844343,7,4,3,1
kasparv,1603.85636736,232.638615041,14,9,5,2
zuluking,1603.85636736,232.638615041,12,6,6,2
yark,1603.85636736,232.638615041,11,6,5,2
tse,1603.80610284,166.804930863,6,4,2,1
cheesepuff,1603.7231387,166.724838985,5,3,2,1
jaybird klutz,1603.67691597,139.547013637,10,6,4,2
capitainemitaine,1603.61121232,146.152454991,10,6,4,2
jbluray,1603.46784457,166.823299119,6,4,2,1
belia,1603.44818393,192.410791955,17,12,5,2
tylenol p-m,1603.26295286,153.233104212,7,4,3,1
shuckle,1603.25454074,139.796680232,11,7,4,2
brick,1603.02659899,148.270060092,11,7,4,2
core,1603.00295336,143.828758432,11,7,4,2
gus,1602.96544493,124.890591345,13,8,5,3
aperture,1602.79594257,104.307372899,24,14,10,5
l crimson,1602.51025146,140.504540113,11,7,4,2
pilldemon,1602.41909825,190.602817222,5,3,2,1
pgh carroll,1602.41455363,134.013663699,11,7,4,2
8,1602.40221849,146.40329535,8,5,3,1
hvac,1601.97505814,147.684513554,18,8,10,3
theprime,1601.9315441,128.247668128,14,9,5,2
seabass,1601.86193697,108.712513015,20,11,9,4
lacroix,1601.80745077,163.515687381,8,5,3,1
nut,1601.80745077,164.03773962,8,5,3,1
corgi gucci wolf,1601.80745077,164.03773962,8,5,3,1
bork,1601.80745077,164.03773962,8,5,3,1
donkey kong main,1601.80745077,164.03773962,8,5,3,1
chzy,1601.80745077,164.03773962,8,5,3,1
rih,1601.80745077,164.03773962,8,5,3,1
nasa,1601.80745077,164.03773962,8,5,3,1
justin,1601.80745077,164.03773962,8,5,3,1
dilla,1601.80745077,164.03773962,8,5,3,1
oli,1601.80745077,164.03773962,8,5,3,1
mogwai,1601.80745077,164.03773962,8,5,3,1
kevbot,1601.80745077,164.03773962,11,6,5,2
yingling,1601.80745077,164.03773962,8,5,3,1
soju,1601.80745077,164.03773962,8,5,3,1
samate,1601.80745077,164.03773962,8,5,3,1
sebovich,1601.80745077,163.921871694,8,5,3,1
kalimari,1601.80745077,164.03773962,8,5,3,1
baker,1601.80745077,163.747916077,8,5,3,1
punk,1601.80745077,164.03773962,8,5,3,1
rainbow,1601.80745077,164.03773962,8,5,3,1
phidx,1601.80745077,164.03773962,8,5,3,1
ae.,1601.80745077,163.921871694,8,5,3,1
a4foot1giant,1601.80745077,164.03773962,8,5,3,1
aubfox,1601.80745077,164.03773962,8,5,3,1
kizzo,1601.80745077,164.03773962,8,5,3,1
2highsofly,1601.80745077,164.03773962,8,5,3,1
zmby,1601.80745077,164.03773962,8,5,3,1
erik reeds,1601.80745077,164.03773962,8,5,3,1
heliodoxy,1601.80745077,164.03773962,8,5,3,1
arc tres,1601.80745077,163.747916077,8,5,3,1
capem,1601.80745077,164.03773962,15,10,5,2
| jeezimsobored,1601.80745077,164.03773962,8,5,3,1
hdyambo,1601.80745077,164.03773962,8,5,3,1
yuna,1601.80745077,163.921871694,8,5,3,1
the prince,1601.80745077,164.03773962,8,5,3,1
calta,1601.80745077,164.03773962,8,5,3,1
dsl_pl0x,1601.73676397,158.64276929,8,5,3,1
shady,1601.67096903,147.474830084,10,6,4,2
big dick bandit,1601.60337401,146.408430788,10,6,4,2
bacon,1601.55978869,125.113077335,21,13,8,3
azen zagenite,1601.51475621,165.065867015,8,5,3,2
holy ham,1601.42994998,139.922171994,8,5,3,1
zannthemann,1601.31420575,171.975198867,5,3,2,1
low5,1601.29070206,168.416169929,8,4,4,2
burlap,1600.77310311,179.990553398,5,3,2,1
koopakev,1600.5226801,139.619030592,10,6,4,2
ardent rage,1600.50520456,191.748911612,5,3,2,1
nala,1600.12884346,177.941983025,5,3,2,1
european greazemans,1600.12301771,126.474403858,13,8,5,2
night,1599.96933997,187.062102883,5,3,2,1
capone,1599.96933997,186.553558891,5,3,2,1
brail_l2k,1599.96933997,187.417262639,5,3,2,1
cool lime,1599.9489927,119.50523519,13,8,5,2
liqued,1599.93914352,140.643429779,10,6,4,2
dakpo,1599.92519297,144.872413536,10,6,4,1
rpg,1599.75752106,182.393641454,6,4,2,1
phatcat,1599.75752106,182.237319018,6,4,2,1
pusheen queen,1599.71533905,203.674356865,4,2,2,1
tempest,1599.51926142,130.627482877,12,7,5,2
macgruber,1599.49896316,157.907834576,8,5,3,1
riff,1599.44929517,168.81790364,7,4,3,1
riddy,1599.44357803,166.810661896,6,4,2,1
adamkex,1599.39434794,130.730266027,18,11,7,3
glory,1599.23624868,181.013745105,19,14,5,2
mprime,1599.1860527,190.127957398,5,3,2,1
zaf,1599.004008,116.37912166,16,10,6,2
lil isai,1599.00355002,153.014755417,7,4,3,1
chandy,1598.93467528,121.770883891,16,10,6,2
will pickles,1598.68869084,128.582932292,14,9,5,2
nuckels,1598.67195951,185.264211548,5,3,2,1
bonfire10,1598.5525806,182.466341081,5,3,2,1
gin,1598.55230167,103.283403833,20,12,8,3
n0z1ck,1598.51977592,123.329577063,20,11,9,3
enemy unit,1598.35905827,155.024734883,8,5,3,1
christ himself,1598.20000059,168.219396616,5,3,2,1
homestar,1597.99161835,173.694396463,6,4,2,1
vulfaerix,1597.92750668,166.486055566,7,4,3,1
gtone,1597.88263516,125.872989359,13,8,5,2
the lil d that could,1597.7192712,118.254409779,13,8,5,2
haiyaku,1597.68800362,180.474339978,5,3,2,1
gunhaver,1597.50344094,130.593591876,12,7,5,2
jiichan,1597.13347182,159.238770089,7,4,3,1
drage,1597.01755504,179.903582617,6,4,2,1
char,1596.95376633,102.419175807,28,17,11,4
scarecrow,1596.79095884,157.301465688,7,4,3,1
sc00p,1596.7776374,132.747968174,11,7,4,2
jaywalker,1596.51303626,159.184722854,7,4,3,1
knight,1596.51117903,156.255334812,9,5,4,2
pipsqueak,1596.46491931,191.5666551,6,4,2,1
krevlar,1596.29889262,135.781098461,9,5,4,1
foxcapacitor,1596.28123494,122.796177419,14,8,6,2
braev,1596.21437316,99.494034773,23,14,9,4
krax_,1596.04482373,176.566886528,5,3,2,1
kamikaze,1595.83832226,205.97371725,8,4,4,2
villain,1595.62020492,190.633940895,13,6,7,2
ziren,1595.43024676,158.504126421,8,5,3,1
den,1595.24720796,105.750866474,21,13,8,3
vilness,1595.15117413,151.424437661,9,6,3,1
xf awkward,1595.13738704,142.021045842,10,6,4,2
the fury,1595.11150414,155.335852873,8,5,3,1
silver,1594.90968569,133.026832312,17,10,7,3
bair,1594.90695658,130.08967842,11,7,4,1
kid fantastic,1594.60161766,178.548452795,5,3,2,1
masquerade,1594.5811171,150.354383313,8,5,3,1
birdlordmasterbeak,1594.56384936,165.917798096,6,4,2,1
farko,1594.43407672,181.18100891,5,3,2,1
triple c,1594.36797751,178.750752943,5,3,2,1
cwhit,1594.34925256,227.488955655,2,1,1,1
bestfriendjohn,1594.1311407,152.511189788,8,5,3,1
danil,1594.00935629,115.057356087,20,12,8,3
greenwalk,1593.99019617,113.596890842,18,11,7,4
coin chaser,1593.95596876,159.40210264,8,5,3,1
duel,1593.77736687,142.636695017,8,5,3,1
ursa,1593.75700405,153.7785784,7,4,3,1
sebson,1593.75549739,130.684102224,13,7,6,2
zamu,1593.68303883,187.748777963,5,3,2,1
qtip,1593.65262035,114.966322882,15,9,6,2
calzum,1593.46119477,173.709790075,17,11,6,2
bulbnut,1593.38002754,290.232858525,1,1,0,1
thekibk,1593.38002754,290.232858525,1,1,0,1
frogge,1593.18092999,180.42703822,5,3,2,1
bun,1593.0930201,188.454592899,5,3,2,1
jedijake,1593.02832755,174.063484329,5,3,2,1
cniu,1593.01789245,181.289393926,5,3,2,1
nice boy,1592.6921983,170.917673823,6,4,2,1
padre,1592.67005329,186.499154004,15,7,8,2
invinceabull,1592.53979677,178.445318898,5,3,2,1
mom?,1592.40426735,182.098538851,5,3,2,1
ggdoe,1592.39159527,146.644904758,10,6,4,1
lansky,1592.27876626,187.911689908,5,3,2,1
conn man,1592.27255381,169.704804084,6,4,2,1
mon,1592.19044698,172.568761676,5,3,2,1
mountaingoating,1592.18976612,187.801973149,5,3,2,1
loki,1591.90871374,171.200419697,7,4,3,1
taba81,1591.6340416,202.161313673,4,2,2,1
parmsib,1591.55906006,184.393889151,5,3,2,1
lookalike,1591.47943262,157.773253526,9,5,4,2
smith,1591.43306795,178.242990168,5,3,2,1
davemon,1591.42895188,144.706372208,8,5,3,1
wowzers,1591.42587361,138.703272952,11,7,4,2
fancey,1591.34759991,178.012277741,6,4,2,1
jeppegryn,1591.33745685,171.77315144,7,4,3,1
mm720,1591.32981637,132.293602995,13,8,5,2
mexican ghost,1591.27778944,171.426866403,6,4,2,1
fliinchy,1591.21207999,165.302911041,7,4,3,1
scoopy,1590.9522264,131.120406569,11,7,4,2
patcombo,1590.81880596,140.860553293,10,6,4,1
jbash,1590.81805913,117.8297675,15,9,6,3
4bs,1590.72229151,192.362566445,5,3,2,1
darkhero,1590.59125659,182.821994084,5,3,2,1
quint,1590.44372205,182.960845007,5,3,2,1
chango,1590.39468669,123.367497531,21,9,12,4
mike,1590.38361978,125.391350971,13,8,5,2
sway,1590.25630163,187.817924952,5,3,2,1
kelly,1590.18998811,193.178053681,5,3,2,1
3huna,1590.06278537,141.20773836,10,6,4,1
tauvalian,1589.76072277,189.842080052,5,3,2,1
dj. dickdown,1589.75185376,154.717377758,9,5,4,2
claw,1589.41580846,168.431417972,6,4,2,1
miyagi,1589.32912964,188.853915476,5,3,2,1
acid fuccboi,1588.91149087,123.809740739,14,8,6,2
luka,1588.80193709,188.02929127,5,3,2,1
jedijakethemystical,1588.6964162,154.315990432,6,4,2,1
wolfeye,1588.63462748,135.496290795,10,6,4,2
5-1,1588.44385445,137.725579595,11,7,4,1
valor,1588.08504301,184.742643886,5,3,2,1
mervis,1588.0750442,184.262737984,6,4,2,2
sawrik,1587.66193654,166.200311064,7,4,3,1
pad,1587.51383982,166.729928471,7,4,3,1
joanna dark,1587.48246046,105.02608084,19,11,8,3
ch0ice,1587.40737141,188.042518576,5,3,2,1
kiwigivi,1587.345018,139.651120305,12,7,5,2
hoogsen,1587.33131254,185.853031198,5,3,2,1
nugget,1587.17199744,123.064153124,15,9,6,3
dahl,1587.13157881,130.469590945,12,7,5,2
oujia,1587.03595449,185.420531928,5,3,2,1
vzakat,1586.95605133,155.141494551,7,4,3,1
ryf1sh,1586.87084257,113.81284311,17,10,7,3
tonic,1586.82018904,117.689086498,18,11,7,2
zent,1586.80977141,132.329762292,10,6,4,2
mika,1586.72909707,154.53394967,8,4,4,1
qwins,1586.71643945,152.726403157,8,5,3,1
eradicator,1586.58829319,152.889624085,9,5,4,2
kwik,1586.58253837,184.821889632,5,3,2,1
mt,1586.50328368,125.175614253,11,5,6,3
metaknight0,1586.38155432,187.501996899,5,3,2,1
mado,1586.38155432,188.007975472,14,9,5,3
ego,1586.37495282,187.345499311,5,3,2,1
light,1586.35466505,129.455184967,18,10,8,4
jiggy,1586.02242674,178.738325498,5,3,2,1
maybe,1585.92909326,127.063958375,13,7,6,3
senn,1585.80029631,139.353362541,12,8,4,2
kihyun,1585.74348737,146.560963436,10,6,4,1
gayluigi,1585.7374028,146.256472024,10,6,4,2
moose,1585.57049397,131.071180052,15,9,6,2
dkarnage,1585.53353524,177.534488322,6,3,3,1
4serial,1585.18807598,150.568381303,10,6,4,2
young,1585.18114863,132.419748434,10,6,4,2
firefly,1585.11942018,150.819376838,10,6,4,2
drynanigans,1585.00880201,180.873519287,5,3,2,1
bertbusdriver,1584.87646409,118.251084523,17,10,7,3
boamba,1584.80494754,109.150841109,18,10,8,4
mc david,1584.62257419,147.87409769,10,6,4,2
kalvar,1584.40476306,117.855808928,14,8,6,2
maruku,1584.34858393,186.737413933,5,3,2,1
quasar,1584.25254849,152.265336898,13,7,6,3
ppmd,1584.16118536,109.080724097,16,8,8,2
jonah,1584.12153153,186.548305494,5,3,2,1
rare,1583.88005667,158.742674753,7,4,3,1
steiner,1583.86351488,180.312051532,5,3,2,1
duckpimp,1583.796798,182.761316248,5,3,2,1
eigen,1583.78628802,152.673586567,10,6,4,2
sephyrate,1583.57399151,173.808094422,6,4,2,1
green,1583.46190874,186.525641777,5,3,2,1
chrisrn,1583.46190874,187.034261675,5,3,2,1
tootmoses,1583.46190874,186.983461944,5,3,2,1
infernalcolonel,1583.46190874,187.490839884,5,3,2,1
pyro,1583.1643809,131.889296924,18,10,8,4
panties,1583.15818713,113.703455081,16,9,7,3
forge,1583.10503834,187.569343266,5,3,2,1
robbyk,1583.04368462,126.56984715,18,11,7,5
yold,1582.9973874,108.167448132,17,10,7,3
husbrann,1582.69039191,134.16688276,12,7,5,2
kofi,1582.6680527,188.819960653,5,3,2,1
veggietales,1582.6680527,188.819960653,5,3,2,1
tipper,1582.6680527,188.819960653,5,3,2,1
hea7,1582.6680527,188.819960653,5,3,2,1
boston's finest,1582.6509933,193.947512563,4,2,2,1
keo,1582.63203954,139.48845863,10,6,4,2
greener,1582.45030392,180.510914192,5,3,2,1
keon,1582.45030392,180.510914192,5,3,2,1
arby,1582.32568249,196.158829381,4,2,2,1
frogman [charette],1582.15492118,182.140936127,5,3,2,1
ryucloud,1581.90247026,173.835906067,5,3,2,1
alliecat,1581.686164,118.184936216,21,13,8,4
m3k,1581.64386462,180.685655963,5,3,2,1
papa john,1581.53874808,188.005999844,5,3,2,1
shoyo,1581.43501222,154.761745066,7,4,3,1
ita,1581.33653603,179.658242474,5,3,2,1
bloodbowler,1581.33327954,157.70905412,15,9,6,2
bravo,1581.26849954,103.076278448,30,18,12,4
et,1581.15616156,174.27435522,5,3,2,1
iifter,1580.92684821,119.062730284,13,8,5,2
hype!,1580.86746996,187.599870404,5,3,2,1
blitzbolt,1580.86617163,134.588899185,10,6,4,2
645development,1580.73722988,192.784342482,5,3,2,1
trout oracle,1580.69352821,179.353190097,5,3,2,1
tace,1580.65085029,186.021855755,5,3,2,1
mayan ryan,1580.35385251,165.154037305,8,5,3,1
bhoogs,1580.27403379,175.797608706,6,4,2,1
crescent monkey,1580.22312403,163.650919133,8,5,3,1
thumbs,1580.22312403,163.650919133,8,5,3,1
caup,1580.22312403,163.244060636,8,5,3,1
baconpancakes,1580.20920606,183.113935295,5,3,2,1
miqi,1580.02869248,189.388219557,5,3,2,1
xtrooper,1580.02869248,189.187467098,5,3,2,1
stricnyn3.,1580.00878715,186.451724623,5,3,2,1
winnie,1579.85508165,169.623684464,6,4,2,1
ken,1579.82209557,129.918483594,12,7,5,2
trap,1579.74086831,166.099150799,7,4,3,1
zap101,1579.62644089,122.268247244,15,8,7,3
sapoc,1579.60923471,157.742080462,8,5,3,1
sasha,1579.53567763,131.529952819,12,7,5,2
duo,1579.4722189,195.003060127,4,2,2,1
sambr,1579.45716349,110.317775331,14,8,6,2
ambition,1579.34879612,160.731173226,11,6,5,2
rayd,1579.21274515,182.425621716,5,3,2,1
jackkenney,1579.17983526,147.69777298,10,6,4,3
free,1579.09515516,164.704884962,7,4,3,1
kingly,1578.81010798,144.405242417,10,6,4,2
hipo,1578.52058945,219.741475832,4,2,2,1
kurt kobain,1578.42678402,159.758725185,7,4,3,1
blackjack,1578.1755193,154.932203863,9,5,4,2
b-boy anakin,1578.05436975,179.101102831,5,3,2,1
gooley,1577.96019495,180.426259751,5,3,2,1
full metal jarod,1577.94012693,163.744899424,7,4,3,1
hyo,1577.79567045,157.940137071,7,4,3,1
siddartha,1577.77177596,125.834330057,12,7,5,2
phax,1577.68907526,198.129630776,4,2,2,1
the box ghost,1577.66284596,183.765819766,5,3,2,1
gator [slater],1577.12546084,156.600680354,7,4,3,1
pip,1577.11159708,123.78576666,14,8,6,3
near,1577.1112003,136.020318361,11,6,5,2
admiral,1576.95079865,120.351374705,15,9,6,2
jwalker,1576.86936768,143.405710991,10,6,4,2
krispysmooth,1576.7557958,219.072647968,4,2,2,1
sonofashepherd,1576.68190088,182.439163905,5,3,2,1
tuesday,1576.60826551,99.1052003977,23,12,11,5
tastygoldfish,1576.55599129,219.036932079,10,4,6,2
slime,1576.55095102,259.067827492,11,6,5,2
kneedoking,1576.50454417,167.853411601,6,3,3,1
stax,1576.49929405,124.723480603,15,8,7,2
rensxd,1576.27015577,161.52081662,7,4,3,1
mantis,1576.00947016,116.634249225,12,6,6,2
benstillerfan69,1575.97446835,128.828842854,13,7,6,3
yung zunga,1575.87624585,179.823160102,5,3,2,1
xpilot,1575.87474873,176.21908496,5,3,2,1
$nooze,1575.8104241,143.103670219,9,5,4,2
zeta,1575.69628124,94.0458007295,28,16,12,6
noodle,1575.61879303,144.355316579,9,5,4,2
mentaculus,1575.36262193,124.76488324,12,7,5,2
dhoho,1575.30889766,183.23311398,5,3,2,1
nu,1575.24803544,173.114599439,6,3,3,1
gongfactor,1575.19904299,162.265668564,7,4,3,1
bugatti,1575.19904299,162.265668564,7,4,3,1
clouded,1574.98698138,169.341158785,7,4,3,1
hayrow,1574.88665526,114.598300803,16,10,6,2
dru2,1574.86179202,218.186967231,4,2,2,1
trevman,1574.76434573,186.61116874,5,3,2,1
thef,1574.76434573,186.560253801,5,3,2,1
garbage prince,1574.6754035,187.157799742,5,3,2,1
saiyan,1574.53040658,168.46724018,7,4,3,1
kidlink,1574.43784659,199.862018819,4,2,2,1
joebigs,1574.39652103,145.830651437,9,5,4,2
frostbyte,1574.35363272,146.282334222,9,5,4,2
pookie,1574.21476964,158.332799461,7,4,3,1
answer,1574.20768701,147.058784152,10,6,4,2
tinojoe,1574.19938687,160.506259286,7,4,3,1
chevy,1574.17926103,166.395904059,7,4,3,1
pr0tein,1574.15481173,149.746353232,8,5,3,1
halzyn,1574.02759397,186.497033422,5,3,2,1
alex kidd,1574.01605654,187.422470675,5,3,2,1
pokno,1574.01605654,187.67573768,5,3,2,1
polar,1574.01605654,187.321067993,5,3,2,1
linksta,1574.01605654,187.67573768,5,3,2,1
glaz,1574.01605654,188.029738376,5,3,2,1
thoobs,1574.01605654,187.67573768,5,3,2,1
marche,1574.01605654,187.321067993,5,3,2,1
hondafoo,1573.8651435,144.631291778,9,5,4,1
patrick,1573.85971089,92.9148901854,29,16,13,5
king fedora,1573.79455591,91.0899076954,25,14,11,3
pwrup!,1573.72597422,137.041047078,12,7,5,2
potentis,1573.43557479,141.723434714,10,6,4,2
lildoozie,1573.41651018,180.493357056,5,3,2,1
noobking,1573.13515851,167.300251601,7,4,3,1
r & r,1572.96013281,168.906149357,5,3,2,1
bonsaiwarrior,1572.93162663,177.369729349,5,3,2,1
coyote,1572.64847141,185.587502365,5,3,2,1
soda,1572.56984572,162.380803875,7,4,3,1
vts,1572.55363957,142.366964151,10,6,4,2
insomnia,1572.42090516,184.724998844,5,3,2,1
ryko,1572.37009816,142.072407779,9,5,4,3
nth,1572.27495065,186.743630647,5,3,2,1
yamham,1572.19790706,132.8501705,13,8,5,2
magikarp,1572.10991729,194.731533917,5,3,2,1
skylan,1572.10991729,194.291971789,5,3,2,1
fly sloth,1572.10991729,194.487455384,12,6,6,2
dayge,1572.10991729,194.731533917,5,3,2,1
chetter,1572.10991729,194.731533917,5,3,2,1
tee knock,1572.10991729,194.731533917,5,3,2,1
cincell,1572.10991729,193.557149963,5,3,2,1
sajeel,1572.10991729,194.731533917,5,3,2,1
ari,1572.10991729,194.731533917,10,3,7,2
tippered,1572.10991729,194.194156199,5,3,2,1
devastation,1572.10991729,194.731533917,5,3,2,1
gabytime,1572.10991729,194.633939234,5,3,2,1
stemu,1572.10991729,194.633939234,5,3,2,1
w33dl0rd840,1572.10991729,194.731533917,5,3,2,1
docmo,1572.10991729,194.731533917,5,3,2,1
foolz,1572.10991729,194.731533917,5,3,2,1
wonderbean,1572.10991729,194.731533917,5,3,2,1
gambs,1572.10991729,194.731533917,5,3,2,1
rca,1572.10991729,194.731533917,5,3,2,1
triffle,1572.10991729,194.487455384,5,3,2,1
eleven,1572.10991729,194.487455384,5,3,2,1
dz rei,1572.10991729,194.487455384,5,3,2,1
bashking,1572.10991729,194.731533917,5,3,2,1
roko,1572.10991729,193.949401396,5,3,2,1
bajef,1572.10991729,194.731533917,5,3,2,1
asura,1572.10991729,194.731533917,5,3,2,1
gorbachev,1572.10991729,193.998377059,5,3,2,1
khadia,1572.10991729,194.731533917,5,3,2,1
guluheend,1572.10991729,194.731533917,5,3,2,1
eval,1572.10991729,194.731533917,5,3,2,1
pillowmaker,1572.10991729,194.731533917,5,3,2,1
tts,1572.10991729,194.633939234,12,6,6,2
snivy102,1572.10991729,194.291971789,5,3,2,1
gale,1572.10991729,194.633939234,5,3,2,1
bbc,1572.10991729,194.633939234,5,3,2,1
joshuwasha,1572.10991729,194.731533917,5,3,2,1
sizzling solzo,1572.10991729,193.949401396,5,3,2,1
floppy,1572.10991729,194.731533917,5,3,2,1
agi,1572.10991729,194.731533917,5,3,2,1
commanderkool,1572.10991729,194.731533917,5,3,2,1
glenjamin,1572.10991729,194.731533917,5,3,2,1
future,1572.10991729,194.731533917,10,6,4,2
madman,1572.10991729,194.731533917,5,3,2,1
perhapsman,1572.10991729,194.291971789,5,3,2,1
strega,1572.10991729,194.291971789,5,3,2,1
zemcitrus,1572.10991729,194.731533917,5,3,2,1
lucidity,1572.10991729,194.047340362,5,3,2,1
artist,1572.10991729,193.949401396,5,3,2,1
brandingo,1572.10991729,194.291971789,5,3,2,1
deep,1572.10991729,194.731533917,5,3,2,1
n1ck,1572.10991729,194.487455384,5,3,2,1
bliutwo,1572.10991729,194.731533917,5,3,2,1
thenumber47,1572.10991729,194.487455384,11,7,4,2
muttnik,1572.10991729,194.731533917,5,3,2,1
lecceo,1572.10991729,193.949401396,5,3,2,1
diaper,1572.10991729,194.731533917,5,3,2,1
doyoung2win,1572.10991729,194.731533917,5,3,2,1
trogdor,1572.10991729,193.949401396,5,3,2,1
azureflame,1572.10991729,194.047340362,5,3,2,1
stacky mcbears,1572.10991729,194.731533917,5,3,2,1
beanwolf,1572.10991729,193.802400144,5,3,2,1
xtal,1572.10991729,194.291971789,5,3,2,1
nav,1572.10991729,194.731533917,5,3,2,1
zenaga,1572.10991729,194.487455384,5,3,2,1
commissioner gordon,1572.10991729,194.731533917,5,3,2,1
pdub,1572.10991729,194.731533917,5,3,2,1
anthony,1572.10991729,194.731533917,5,3,2,1
votega,1572.10991729,193.949401396,5,3,2,1
marlwolfe,1572.10991729,194.291971789,5,3,2,1
jakx,1572.10991729,194.731533917,5,3,2,1
.fb,1572.10991729,193.900413361,5,3,2,1
kim,1572.10991729,194.731533917,5,3,2,1
apples,1572.10991729,194.731533917,5,3,2,1
kestrel,1572.10991729,194.731533917,5,3,2,1
rm,1572.10991729,194.731533917,5,3,2,1
dracula,1572.10991729,194.731533917,5,3,2,1
schwiebs,1572.10991729,194.731533917,5,3,2,1
brgod,1572.10991729,194.731533917,5,3,2,1
genesis,1572.10991729,194.145229923,5,3,2,1
irish,1572.10991729,194.731533917,5,3,2,1
| b-war,1572.10991729,194.487455384,5,3,2,1
fear,1572.10991729,194.731533917,8,4,4,2
ccdm,1572.10991729,194.731533917,5,3,2,1
wakka,1572.10991729,194.291971789,5,3,2,1
ozumi,1572.10991729,193.998377059,5,3,2,1
mossgarden,1572.10991729,194.731533917,5,3,2,1
turnip4what?,1572.10991729,194.731533917,5,3,2,1
uncle onion,1572.10991729,194.731533917,5,3,2,1
jwolf,1572.10991729,194.731533917,5,3,2,1
bernz,1572.10991729,194.731533917,5,3,2,1
captain schfifty,1572.10991729,194.731533917,5,3,2,1
fro,1572.10991729,193.949401396,5,3,2,1
arson (aka mc sweden),1572.10991729,194.633939234,5,3,2,1
jose ole,1572.10991729,194.731533917,5,3,2,1
akt,1572.10991729,194.047340362,5,3,2,1
ru$$,1572.10991729,194.731533917,5,3,2,1
eastea,1572.10991729,194.291971789,5,3,2,1
_glook,1572.10991729,194.731533917,5,3,2,1
rootbeerfloat,1572.10991729,193.949401396,5,3,2,1
remioli,1572.10991729,194.731533917,5,3,2,1
alphicans,1572.10991729,194.731533917,5,3,2,1
pikminbutdeadly,1572.10991729,194.731533917,5,3,2,1
941cs,1572.10991729,194.731533917,5,3,2,1
mariopartywbeer,1572.10991729,194.731533917,5,3,2,1
jaggedcole,1572.10991729,194.731533917,5,3,2,1
jc,1572.10991729,194.731533917,5,3,2,1
stormtrooper,1572.10991729,194.047340362,5,3,2,1
stickman,1572.10991729,194.291971789,5,3,2,1
panduhz,1572.10991729,194.731533917,5,3,2,1
animal,1572.10991729,194.731533917,5,3,2,1
mr. nima,1572.10991729,194.731533917,5,3,2,1
pale chub,1572.10991729,194.731533917,5,3,2,1
ride,1572.10991729,194.731533917,5,3,2,1
yrex,1572.10991729,194.731533917,5,3,2,1
nagate,1572.10991729,194.731533917,5,3,2,1
steamfriedasian,1572.10991729,194.731533917,5,3,2,1
chuck lee,1572.10991729,194.731533917,5,3,2,1
lord chin chin,1572.10991729,194.731533917,5,3,2,1
ansuke,1572.10991729,194.731533917,5,3,2,1
oyako,1572.10991729,194.731533917,5,3,2,1
sailormoon420,1572.10991729,194.731533917,5,3,2,1
| kitsune91,1572.10991729,194.731533917,5,3,2,1
atlus,1572.10991729,194.731533917,5,3,2,1
lldl,1572.10991729,194.487455384,5,3,2,1
ocifer,1572.10991729,194.731533917,5,3,2,1
smokey meat sweats bbq,1572.10991729,194.731533917,5,3,2,1
naota650,1572.10991729,194.731533917,5,3,2,1
ghettotastic,1572.10991729,194.731533917,5,3,2,1
iron chief,1572.10991729,193.949401396,5,3,2,1
larfen,1572.10991729,193.949401396,5,3,2,1
mind assassin,1572.10991729,194.731533917,5,3,2,1
xell,1572.10991729,194.731533917,5,3,2,1
gragledump,1572.10991729,194.731533917,5,3,2,1
ooshii,1572.10991729,194.731533917,5,3,2,1
strain,1572.10991729,194.731533917,5,3,2,1
whatisfear,1572.10991729,194.731533917,5,3,2,1
slumped,1572.10991729,194.731533917,5,3,2,1
nastynard,1572.10991729,194.145229923,5,3,2,1
blueguy,1572.10991729,194.731533917,5,3,2,1
luxus,1572.10991729,193.900413361,5,3,2,1
mister dawson,1572.10991729,194.731533917,5,3,2,1
munch,1572.10991729,194.731533917,5,3,2,1
diabound,1572.10991729,194.633939234,12,7,5,2
store-bought pancakes,1572.10991729,194.731533917,5,3,2,1
jazzawockee,1572.10991729,194.487455384,5,3,2,1
thebigopness,1572.10991729,194.731533917,5,3,2,1
myko,1572.10991729,194.731533917,5,3,2,1
m00nshoez,1572.10991729,194.731533917,5,3,2,1
kramepie,1572.10991729,194.731533917,5,3,2,1
eight%,1572.10991729,193.557149963,5,3,2,1
shady pyro,1572.10991729,194.731533917,5,3,2,1
krzy8,1572.10991729,194.731533917,5,3,2,1
dannypaguiao,1572.10991729,194.731533917,5,3,2,1
lugia,1572.10991729,194.731533917,5,3,2,1
smuv,1572.10991729,194.291971789,5,3,2,1
femto,1572.10991729,194.633939234,5,3,2,1
chiefcherry,1572.10991729,193.949401396,5,3,2,1
morgneer,1572.10991729,194.731533917,5,3,2,1
dr. grin,1572.10991729,194.731533917,5,3,2,1
kenz,1572.10991729,194.633939234,5,3,2,1
sgt flow,1572.10991729,194.731533917,5,3,2,1
infin,1572.10991729,194.731533917,5,3,2,1
hg-swizzlesnacks,1572.10991729,194.731533917,5,3,2,1
akiva,1572.10991729,194.731533917,5,3,2,1
henrius,1572.10991729,194.731533917,5,3,2,1
hylian reaper,1572.10991729,194.633939234,11,7,4,2
lilo&stitchface,1572.10991729,194.731533917,5,3,2,1
joel,1572.10991729,194.291971789,5,3,2,1
pog0,1572.10991729,194.731533917,5,3,2,1
thegtree,1572.10991729,194.731533917,5,3,2,1
royce,1572.10991729,194.731533917,5,3,2,1
g~man the cosmic destroyer,1572.10991729,194.731533917,5,3,2,1
cmac,1572.10991729,194.291971789,5,3,2,1
gabezilla,1572.10991729,194.731533917,5,3,2,1
carcosa,1572.10991729,194.731533917,5,3,2,1
2dollarslices,1572.10991729,194.731533917,5,3,2,1
feynman,1572.10991729,194.731533917,5,3,2,1
dkuo,1572.10991729,194.731533917,5,3,2,1
pdk,1572.10991729,194.731533917,5,3,2,1
thane,1572.10991729,194.731533917,5,3,2,1
michaeldouglas,1572.10991729,194.633939234,12,6,6,2
runescape,1572.10991729,194.731533917,5,3,2,1
tl | 343,1572.10991729,194.731533917,5,3,2,1
arpah,1572.10991729,193.949401396,5,3,2,1
judge,1572.10991729,194.731533917,5,3,2,1
delphiki,1572.10991729,194.731533917,5,3,2,1
gooey,1572.10991729,193.557149963,5,3,2,1
net1234,1572.10991729,194.731533917,5,3,2,1
shrip,1572.10991729,194.731533917,5,3,2,1
m,1572.10991729,194.731533917,5,3,2,1
gentlefox,1572.10991729,194.731533917,5,3,2,1
dragos,1572.10991729,194.633939234,5,3,2,1
t1s,1572.10991729,194.731533917,5,3,2,1
puzzle,1572.10991729,193.949401396,5,3,2,1
bobby big ballz,1572.10991729,194.047340362,5,3,2,1
dot,1572.10991729,194.731533917,13,5,8,2
almond,1572.10991729,193.557149963,5,3,2,1
f s u,1572.10991729,194.731533917,5,3,2,1
zeus,1572.10991729,193.949401396,5,3,2,1
xxbounty,1572.10991729,194.731533917,5,3,2,1
captain falco,1572.10991729,194.731533917,5,3,2,1
goatlink,1572.10991729,194.731533917,5,3,2,1
drjwns,1572.10991729,194.731533917,5,3,2,1
mikkuz,1572.10991729,194.731533917,5,3,2,1
schmav,1572.10991729,194.291971789,12,8,4,2
choknater,1572.10991729,194.731533917,5,3,2,1
impact series,1572.10991729,194.731533917,5,3,2,1
juicen,1572.10991729,194.731533917,5,3,2,1
x-rey,1572.10991729,194.731533917,5,3,2,1
wphp,1572.10991729,194.731533917,5,3,2,1
el pollo flaco,1572.10991729,194.731533917,5,3,2,1
jamesconquest,1572.10991729,194.731533917,5,3,2,1
22k,1572.10991729,193.949401396,5,3,2,1
divinius,1572.10991729,193.900413361,5,3,2,1
janet,1572.10991729,194.731533917,5,3,2,1
quixotic,1572.10991729,194.731533917,5,3,2,1
death arcana,1572.10991729,194.731533917,5,3,2,1
falcoty,1572.10991729,194.731533917,5,3,2,1
biscuittricks,1572.10991729,194.731533917,5,3,2,1
grey,1572.10991729,193.557149963,5,3,2,1
zeldafreak,1572.10991729,194.731533917,5,3,2,1
burnt out ninja,1572.10991729,194.731533917,5,3,2,1
corleone,1572.10991729,194.731533917,5,3,2,1
colony,1572.04307497,161.57021632,8,4,4,2
puddle,1572.01950713,157.996132912,9,5,4,2
soil,1572.01469687,178.822854002,5,3,2,1
sudo,1571.99520825,165.259449244,6,4,2,1
gurglehusk,1571.70010001,138.983652326,9,5,4,2
lockerific,1571.69916966,193.194159494,4,2,2,1
onisser,1571.67829131,164.499405276,6,4,2,1
1der,1571.57289527,178.133604422,5,3,2,1
purple sku,1571.56180697,187.479569706,5,3,2,1
mt. crushmore,1571.54450936,194.852955414,4,2,2,1
otg,1571.47971906,179.369199419,5,3,2,1
sealand,1571.46955379,185.553670457,5,3,2,1
toy,1571.36871116,177.565802554,6,4,2,1
guero,1571.28610297,168.09107464,7,4,3,1
scar,1570.71190768,126.522649856,14,8,6,3
petery,1570.71011781,184.5653652,5,3,2,1
deep c. squid,1570.33968269,181.053633573,5,3,2,1
datrooph,1570.32068585,193.305750433,4,2,2,1
batterydc,1570.29201848,154.756095119,10,5,5,2
jake13,1570.27191749,116.949660671,17,9,8,4
plufball,1570.25876584,167.257006172,7,4,3,1
yocus_pocus,1569.98799449,154.164681333,7,4,3,1
dunkasaurus_rex,1569.9652359,181.415737502,6,4,2,1
ringler,1569.89550142,87.2184300681,38,19,19,10
dashdancedan,1569.8188562,256.58836267,8,4,4,2
deja,1569.8048862,159.341736719,7,4,3,2
spitzy,1569.75823323,143.008865396,10,6,4,2
dragedo,1569.72677334,144.260484715,9,5,4,1
dubs,1569.51165358,186.155039045,5,3,2,1
xanmor,1569.46534372,165.440574945,7,4,3,1
p0pe,1569.35512445,202.019275189,4,2,2,1
faddiaddi,1569.27703615,148.400567695,9,6,3,1
karenradish,1569.24427261,191.416268612,4,2,2,1
general tso,1569.18369269,151.022154923,9,5,4,2
hert,1569.08006349,180.816666513,5,3,2,1
llama,1569.03769946,128.767594931,14,8,6,2
younger,1569.03730262,113.010959923,16,9,7,3
oreo,1569.00477591,129.876210215,11,6,5,2
dash,1568.92504754,128.586590586,20,13,7,3
syd,1568.58082546,123.980258604,14,8,6,2
dove,1568.49857587,135.858270269,12,7,5,2
k8a,1568.01842871,179.49715024,5,3,2,1
joseidon,1567.96765682,128.947851673,14,8,6,2
master,1567.75769742,192.720751062,5,3,2,1
stanky,1567.68790945,200.554177479,4,2,2,1
golf,1567.37961371,122.82561795,15,8,7,3
feradit,1567.24706753,124.814826712,25,15,10,3
inspector waffles,1566.96181849,175.083292554,5,3,2,1
santa,1566.95130311,177.513148143,7,4,3,2
prozak,1566.88184064,177.204948682,11,6,5,2
phenoz,1566.80634848,185.788623829,5,3,2,1
pogopeanut,1566.80634848,185.737483412,5,3,2,1
bp,1566.80634848,185.635160312,5,3,2,1
el jefe,1566.80634848,185.635160312,5,3,2,1
the end,1566.76634801,175.87163199,5,3,2,1
l1fe,1566.64332249,186.575552617,5,3,2,1
fizzba,1566.51564704,162.100441907,7,4,3,1
catastrophe,1566.40102946,181.638933193,4,2,2,1
saron,1566.34997623,180.203747994,5,3,2,1
rappsody,1566.32479845,116.396487987,31,19,12,5
fugu,1566.24397064,182.777392755,5,3,2,1
mvzy,1566.23150573,154.502035025,8,5,3,1
spider,1566.19225954,133.784325782,11,6,5,2
woogity wu,1565.97322693,119.915916922,12,7,5,2
giogio,1565.95160212,123.27273736,13,7,6,2
jab [fritz],1565.91136431,195.255966727,4,2,2,1
clyvedaddy,1565.74119528,177.512293199,6,4,2,1
timemuffinphd,1565.525478,168.509785864,19,13,6,2
hugo popov,1565.50411837,172.014798592,6,3,3,1
visualwatch,1565.45982946,124.123622422,13,7,6,2
drasil,1565.4366641,164.829603321,7,4,3,1
will,1565.09288692,170.427174923,4,2,2,1
aiya,1565.00910157,186.096659893,5,3,2,1
supergoomba,1564.90596364,227.284367523,11,5,6,2
kunai,1564.82745315,172.147755311,5,3,2,1
cup,1564.5503543,122.666714061,14,8,6,2
bozo the fox,1564.54954421,208.277509007,4,2,2,1
felix,1564.50225873,179.833261123,6,3,3,1
grognar,1564.2175153,202.174842177,4,2,2,1
zhea,1564.08899668,103.242232893,21,11,10,4
rice,1563.98511617,128.30022922,15,8,7,3
ryse,1563.96558732,127.930290783,11,6,5,2
tangerine,1563.90237768,188.916014182,5,3,2,1
simon,1563.90237768,188.765093209,5,3,2,1
isafestrafe,1563.90237768,188.966294387,5,3,2,1
kendrick lamarth,1563.90237768,188.966294387,5,3,2,1
scyzel,1563.90237768,189.468362568,5,3,2,1
rookiejake,1563.90237768,188.513289755,5,3,2,1
banyoshi2015,1563.7561573,181.948663455,5,3,2,1
liva,1563.68878098,166.882279985,5,3,2,1
slim,1563.5130957,180.732016073,5,3,2,1
prosmashertim,1563.46589399,163.824977744,8,5,3,1
zepto,1563.41885033,123.904591737,14,8,6,2
monkeykills27,1563.41505141,186.298766327,5,3,2,1
nair-b,1563.41505141,187.265133794,5,3,2,1
squid kid,1563.41505141,186.960504746,5,3,2,1
benneh,1563.41505141,186.757142661,5,3,2,1
youngster joey,1563.41505141,187.062102883,5,3,2,1
milf,1563.41505141,186.655378532,5,3,2,1
coda,1563.41505141,186.960504746,5,3,2,1
amber,1563.41505141,186.298766327,5,3,2,1
jesus,1563.35695273,126.311200753,13,7,6,3
jip,1563.31194194,172.575490208,6,3,3,1
fizzi,1563.19643378,133.500070944,17,9,8,4
lightning weeg,1562.98830734,179.350316193,5,3,2,1
igge,1562.69735631,176.665392083,5,3,2,1
jwinks,1562.678951,197.511919826,4,2,2,1
jakpox,1562.50734976,179.27132804,5,3,2,1
tomato soup,1562.50235478,180.209149583,5,3,2,1
deadwing,1562.45667306,213.308862561,4,2,2,1
wawa,1562.38978039,134.526644356,12,6,6,2
mayb,1562.36775982,166.481481504,7,4,3,1
microsoft j,1562.31133126,183.07867085,5,3,2,1
mijo,1562.28870632,119.800096731,16,9,7,4
snax,1562.28103509,135.737659544,11,6,5,2
ghidra,1562.23772736,180.808302533,4,2,2,1
dang,1562.18889487,161.310371153,7,4,3,1
ryan mercado,1562.00502259,178.749342488,5,3,2,1
nintnt,1561.88263407,114.364759398,26,14,12,4
l,1561.72947169,148.367918658,10,6,4,2
epic!,1561.56464644,160.162431991,7,4,3,1
roma,1561.39562631,142.300850496,10,6,4,2
dynamic,1561.26036268,170.806026606,5,3,2,1
brian,1561.25470264,87.6878146338,32,17,15,5
pj,1560.93678753,140.810541282,13,6,7,2
yeti,1560.91889792,143.966325343,10,6,4,2
cuno,1560.90492981,162.88963265,7,4,3,1
b3n,1560.84588248,183.679144441,5,3,2,1
ibc,1560.80311483,107.052181819,19,11,8,3
luke,1560.79792643,202.915567226,4,2,2,1
arvi,1560.7819351,182.664445894,5,3,2,1
scoback,1560.68927561,200.223635962,4,2,2,1
semi,1560.6740564,189.689863311,5,3,2,1
mr fluffles,1560.55016288,147.414521128,9,5,4,2
ctl,1560.42982894,164.191331171,7,4,3,1
xeno,1560.18069893,213.73102133,8,4,4,2
hazard,1560.1406798,160.357051337,7,4,3,1
yohobojoe,1559.9626801,165.444480913,7,4,3,1
drugfreechu,1559.87805977,130.57306894,11,6,5,2
snowy,1559.81117761,123.080348884,12,7,5,2
thimo,1559.7362197,193.470991868,5,3,2,1
metroxe,1559.70079739,186.675834706,4,2,2,1
elu,1559.59540938,184.754096589,5,3,2,1
pb&j,1559.58699585,106.211276454,21,12,9,4
donaxi,1559.48428102,166.284133449,7,4,3,1
plat,1559.38186902,167.08247273,19,14,5,2
jopri,1559.34143178,180.493978845,5,3,2,1
zela,1559.34143178,180.493978845,5,3,2,1
daddy's milk,1559.28233453,135.502191295,12,7,5,2
elementalpenguin,1559.0953995,115.92877729,17,10,7,3
binary clone,1558.79023994,167.3922807,7,4,3,1
looke,1558.79023994,167.449023998,15,9,6,2
kone,1558.79023994,167.84568996,7,4,3,1
booteking,1558.78416629,130.728275759,17,10,7,3
aniolas,1558.67169173,127.017291833,25,17,8,3
paintman,1558.61609332,163.577228436,12,7,5,2
funk doctor,1558.54418592,184.694865454,5,3,2,1
emil,1558.48326291,120.371878153,14,8,6,3
cheez,1558.09405452,211.478212898,4,2,2,1
spot,1558.06626535,191.141582124,4,2,2,1
fearturkey,1557.95738703,177.995588386,5,3,2,1
xii,1557.79655242,144.841054568,8,5,3,1
spoked,1557.79442705,188.261302818,6,3,3,1
mtl-wizards,1557.79442705,188.261302818,6,3,3,1
josniff,1557.75730133,132.049820759,12,7,5,2
rudo,1557.73429749,151.946969248,9,5,4,2
kid,1557.73233218,135.312517224,18,10,8,3
johsyjam,1557.56703866,134.662998633,12,7,5,2
sora,1557.54900597,121.600611981,22,11,11,4
gas$,1557.5127138,161.995061914,7,4,3,1
jball,1557.43947197,184.904916323,5,3,2,1
utto,1557.43947197,185.264211548,5,3,2,1
wryr,1557.3144003,178.860585874,5,3,2,1
frikky,1557.26087428,132.515116756,12,7,5,2
pinkman,1557.2466425,253.009165096,11,4,7,2
parcheesy,1557.16573977,211.240311537,4,2,2,1
macintosh,1557.0205198,180.640045442,5,3,2,1
slartibartfast42,1556.98322966,107.095008681,21,12,9,3
tonymalone,1556.94470172,114.417146165,19,10,9,3
hestoned,1556.81803172,107.055776757,20,12,8,5
kal-el,1556.65723029,118.638572122,15,8,7,3
snap,1556.58291314,148.371780984,9,5,4,2
swag,1556.47871663,184.607847925,5,3,2,1
shlomer,1556.47871663,184.607847925,5,3,2,1
og swaglord,1556.43689129,123.701652981,13,7,6,2
magicalhatsdx,1556.43598489,172.572251236,7,4,3,1
cipher,1556.43598489,172.572251236,7,4,3,1
tpwn,1556.43598489,172.020876339,7,4,3,1
chibo,1556.43598489,172.572251236,7,4,3,1
noremac,1556.43598489,172.572251236,7,4,3,1
cera,1556.43598489,172.572251236,7,4,3,1
roochi,1556.43598489,172.572251236,7,4,3,1
realdingoes,1556.43598489,172.572251236,7,4,3,1
braixen,1556.43598489,172.572251236,7,4,3,1
suntherion,1556.43598489,172.462117279,7,4,3,1
zodiac,1556.43598489,172.296784348,7,4,3,1
datsun,1556.43598489,172.572251236,7,4,3,1
saba,1556.43598489,172.572251236,7,4,3,1
the___cheese,1556.43598489,172.572251236,7,4,3,1
b flat,1556.43598489,172.572251236,7,4,3,1
yeeman,1556.43598489,172.572251236,7,4,3,1
sgt5,1556.43598489,172.572251236,7,4,3,1
cobbler,1556.43598489,172.572251236,7,4,3,1
nokes,1556.43598489,172.572251236,7,4,3,1
yat,1556.43598489,172.296784348,7,4,3,1
hommsar,1556.43598489,172.572251236,7,4,3,1
billz,1556.43598489,172.572251236,7,4,3,1
aqua,1556.43598489,172.020876339,7,4,3,1
glitchbird,1556.43598489,172.572251236,7,4,3,1
pk_fired,1556.43598489,172.076093332,7,4,3,1
batterybird,1556.43598489,172.572251236,7,4,3,1
baise,1556.43598489,172.572251236,7,4,3,1
r.o.m.,1556.43598489,172.572251236,7,4,3,1
scape,1556.43598489,172.572251236,7,4,3,1
third strongest,1556.43598489,172.572251236,7,4,3,1
speedy,1556.43598489,172.462117279,7,4,3,1
massheist,1556.43598489,172.572251236,7,4,3,1
kaddy,1556.43598489,171.744525085,7,4,3,1
kony,1556.43598489,172.572251236,7,4,3,1
ja-fraud,1556.43598489,172.572251236,7,4,3,1
momoraine,1556.43598489,172.572251236,7,4,3,1
brand,1556.43598489,172.572251236,7,4,3,1
theunabletable,1556.43598489,172.572251236,7,4,3,1
ninji,1556.43598489,172.572251236,7,4,3,1
k27,1556.43598489,172.572251236,7,4,3,1
salvadoc,1556.43598489,172.572251236,7,4,3,1
omadon,1556.43598489,172.462117279,11,4,7,2
pod,1556.43598489,172.572251236,7,4,3,1
ac_anon,1556.43598489,172.462117279,14,8,6,2
pyntarn,1556.43598489,172.462117279,7,4,3,1
bryan,1556.43598489,172.572251236,7,4,3,1
you,1556.37893415,172.465779651,5,3,2,1
birdo,1556.30392644,186.804267641,5,3,2,1
perryg45,1556.30392644,186.804267641,5,3,2,1
beegs,1556.16749351,182.889832435,11,6,5,2
arm & hammer,1556.13129578,134.022780638,11,6,5,2
wisely,1556.1181497,153.208756022,9,5,4,2
aero,1556.11585335,146.529424265,12,6,6,3
dair raid,1555.91273919,186.389116411,5,3,2,1
floss,1555.36387604,153.431759242,9,5,4,2
epsilon,1555.1077093,187.344283538,5,3,2,1
g.i. moe,1555.04994993,181.765293248,6,3,3,1
joatguy,1554.8632193,211.483844891,9,5,4,2
jofj,1554.83974205,177.190258605,5,3,2,1
tainted,1554.7383441,197.972220407,4,2,2,1
weissclimbers,1554.48366912,182.360047617,5,3,2,1
shiki,1554.38959298,185.07444817,5,3,2,1
kieran,1554.34403095,193.237039215,13,8,5,2
shameless,1554.27814816,143.259089292,10,6,4,2
armo,1554.12605496,152.783649369,9,5,4,2
moss,1554.05900165,180.751655806,5,3,2,1
treetz,1554.03916843,171.270978327,6,3,3,1
slickah,1553.83766008,177.158969361,5,3,2,1
d. disciple,1553.75372373,119.537151984,17,10,7,3
snow wiener,1553.6064548,180.980515253,5,3,2,1
dr. robotnik,1553.42059639,200.328363834,4,2,2,1
clockmire,1553.24298224,165.964539959,7,4,3,1
pants,1553.22929106,127.486880695,13,7,6,2
dodge,1553.22216271,176.847890281,5,3,2,1
ctm,1553.13552114,131.290329049,11,6,5,2
ceephax,1552.54573275,124.707392163,12,6,6,2
flerr,1552.51386863,193.276383514,5,3,2,1
cakeassault,1552.51386863,192.981243711,5,3,2,1
zuppy,1552.48751266,183.197740191,12,5,7,2
didact,1552.39904755,165.587633311,7,4,3,1
ploopy,1552.31578295,178.187164448,5,3,2,1
moo,1552.21857295,143.34598497,15,7,8,4
jussy,1551.94826507,182.656268478,4,2,2,1
stane,1551.79550712,200.190777483,4,2,2,1
alexisstarving,1551.59918628,171.442633975,5,3,2,1
volume,1551.35525793,156.39287245,8,4,4,2
lectril,1551.28161361,136.62052894,11,6,5,4
golden,1551.13620039,148.527751173,9,5,4,2
rebaz,1551.06859253,153.268278016,8,4,4,2
anytime99,1550.91290324,161.570069245,7,4,3,1
wezl,1550.50256675,208.981618339,4,2,2,1
cd,1550.47447956,208.700705805,4,2,2,1
wavy j,1550.46465128,187.490839884,5,3,2,1
pandawasp,1550.46465128,187.490839884,5,3,2,1
zirix,1550.4079192,199.774261664,4,2,2,1
shuffle,1550.32572734,133.076667163,13,8,5,2
hotline,1550.20339559,166.396427588,7,4,3,1
yuji,1550.15619129,181.004517092,5,3,2,1
boga,1550.02733085,208.745906696,4,2,2,1
dingus,1549.8569039,96.0477329272,26,15,11,5
2jayys,1549.75925517,209.706815764,4,2,2,1
m00nbarker,1549.69893171,168.099654599,5,3,2,1
yankee,1549.63027862,129.582905079,13,7,6,2
peachicedt,1549.57445137,197.354404968,4,2,2,1
seaghost,1549.57443681,120.167747172,17,10,7,4
wndy,1549.56015691,146.380322143,8,4,4,1
lama,1549.31369212,150.019891812,9,5,4,2
anti,1549.22098359,148.847553733,9,5,4,2
nml,1549.20212322,198.332957773,4,2,2,1
vesp,1549.10979035,172.871591856,7,4,3,1
pappa,1549.10979035,172.871591856,7,4,3,1
cross,1548.96383355,176.362466638,5,3,2,1
grrg,1548.93960473,153.502413795,9,5,4,2
ragingcherry,1548.9284056,153.485203458,9,5,4,2
gay falcon,1548.89586453,204.409567402,5,3,2,1
truth,1548.6291316,157.671673329,9,5,4,2
ginjew,1548.57069346,171.593236975,6,3,3,1
wumpus,1548.54697375,153.945671195,9,5,4,2
agud,1548.52476917,175.315652538,5,3,2,1
truckasaurus,1548.42787623,207.947755113,14,6,8,2
lvvn,1548.39314428,174.57682662,5,3,2,1
fish$auce,1548.31124526,182.988648923,5,3,2,1
freeshampoo,1548.2455221,183.521576885,5,3,2,1
bad horse,1548.10158953,154.141817572,9,5,4,2
themaik,1548.04065567,165.376653495,7,4,3,1
sveet,1547.9985918,131.661970041,11,6,5,2
mw,1547.89063984,195.470435209,4,2,2,1
thebourgelispig,1547.72271062,154.265556777,9,5,4,1
trixter,1547.45630294,112.131598276,16,9,7,2
bunbun,1546.75748782,190.119484597,4,2,2,1
pops,1546.67869128,130.86011374,12,6,6,2
issi^,1546.65635674,124.485692611,15,8,7,2
reset,1546.61257921,193.550771888,5,3,2,2
dain bramage,1546.50800252,149.607600277,9,5,4,2
benx,1546.48235312,156.580463998,9,5,4,2
royal flush,1546.48235312,156.580463998,9,5,4,2
bluefalcon,1546.41527616,156.772477999,9,5,4,2
fitz,1546.35925876,156.982550121,9,5,4,2
cronus,1546.35925876,156.072166136,9,5,4,1
bevan,1546.35925876,156.072166136,9,5,4,1
mama's little baby,1546.35925876,156.072166136,9,5,4,1
loota,1546.35925876,156.558363055,9,5,4,1
kenji,1546.35925876,156.679676546,9,5,4,1
oldiz,1546.29069103,118.440672338,17,9,8,3
metallic,1546.21337728,157.608115381,9,5,4,2
super,1546.21337728,157.608115381,9,5,4,2
cortex,1546.20496584,157.633220235,9,5,4,2
skiddy,1546.01456154,185.197029244,5,3,2,1
compton,1545.98570646,189.692104277,4,2,2,1
flux,1545.82872905,131.286740148,13,7,6,3
puncayshun,1545.80095867,157.659481694,6,3,3,1
pizza,1545.61899248,111.670865381,19,10,9,3
kratos,1545.54172292,142.853688405,10,6,4,2
renke,1545.52476515,184.20848089,4,2,2,1
paf,1545.4522934,143.788474421,12,6,6,2
gamba,1545.35808583,211.343632053,13,4,9,2
paco,1545.32599481,158.978459481,8,4,4,2
momspaghetti,1545.25750947,158.24730903,16,5,11,3
disciple,1545.20182356,154.184285452,8,4,4,2
barbado,1545.19627029,176.501929243,6,3,3,1
marky,1545.17740615,195.937419808,4,2,2,1
wonder,1544.94662425,158.663827129,9,5,4,2
kpopoppa,1544.80991637,208.192967541,4,2,2,1
spoonfullofpasta,1544.79365168,196.555142924,4,2,2,1
arcadia,1544.67170273,125.591595698,16,9,7,3
ringringring,1544.63032025,221.259190576,4,2,2,1
vt stickman,1544.61351099,169.516287389,5,3,2,1
slag,1544.50351478,137.706951341,10,6,4,2
kirbstir,1544.48830252,139.03737011,10,6,4,2
genoblast,1544.45196219,131.479717821,10,5,5,2
deep fox,1544.3988364,152.336092732,9,5,4,2
2shotko,1544.36892726,150.153966907,9,5,4,1
jedi master kushala,1544.33397498,186.465683415,5,3,2,1
high-c,1544.31395954,130.173952055,13,7,6,2
im_jk,1544.28580296,172.410568725,6,3,3,1
mongoose,1544.18986499,150.530266133,9,5,4,2
x,1544.11345944,158.72883684,9,5,4,2
wumbologist,1543.85307424,182.676888617,5,3,2,1
burritowolf,1543.85307424,182.988648923,5,3,2,1
shanahan,1543.83553134,180.268231277,5,3,2,1
dragmire jr,1543.80213347,130.46580553,20,11,9,3
phalanx,1543.79369874,140.64594367,10,6,4,2
roboticphish,1543.7378509,96.5306722293,25,14,11,4
yohosebastion,1543.68112235,181.278130377,4,2,2,1
one_trickpony,1543.45082927,189.252649144,4,2,2,1
cucco puffs,1543.36909571,160.357149056,7,4,3,1
skoopdish,1543.34685311,182.564572211,5,3,2,1
radamen,1543.22943125,206.123904434,4,2,2,1
supadice2,1543.09955407,143.652210075,10,6,4,2
cranberry,1543.06944363,194.607584686,4,2,2,1
dirty,1542.73766201,177.322124925,5,3,2,1
moonpanda,1542.732589,189.425582785,4,2,2,1
luxy,1542.67195623,146.5751005,9,5,4,2
hrctypo,1542.66810423,146.564019662,9,5,4,2
tails,1542.60506497,156.427644131,11,5,6,2
pixel,1542.54729644,138.478506872,18,8,10,3
riff [harpster],1542.31721517,179.018995494,5,3,2,1
citizen snips,1542.29030203,147.99280203,9,5,4,2
tyrø,1542.23252857,124.065501912,15,8,7,3
mpfuture,1542.15611589,168.340571259,7,4,3,1
nair (wolf),1542.15014366,202.115289915,4,2,2,1
tehpinkemobunni,1541.88223966,144.401218798,10,6,4,2
wizard,1541.68727612,144.685019029,10,6,4,2
enemy,1541.59949896,193.834142512,5,3,2,1
shriekin' desparado,1541.59949896,193.981119709,5,3,2,1
sk_jynx,1541.59949896,193.834142512,5,3,2,1
bench,1541.59949896,193.637999379,5,3,2,1
goad,1541.59949896,193.785125341,5,3,2,1
worldstar,1541.59949896,193.834142512,5,3,2,1
mak,1541.59949896,193.637999379,5,3,2,1
the jazz,1541.59949896,193.392540713,5,3,2,1
icefang,1541.59949896,193.785125341,5,3,2,1
lafungo,1541.29647996,170.367977131,5,3,2,1
ders,1541.26373361,148.856995564,9,5,4,2
skiddmarx,1541.19340774,199.37353212,4,2,2,1
waves,1541.08952929,180.92211321,5,3,2,1
thecivilyoshi,1540.92962121,137.996131036,11,6,5,2
crossie,1540.89753126,160.277864267,8,4,4,2
rannulf,1540.8838952,183.500318525,5,3,2,1
krump,1540.70374044,184.958200847,5,3,2,1
lion,1540.56903011,143.208129801,11,6,5,2
mr. brandandorf,1540.24153046,130.628388181,13,7,6,2
billyboy48,1540.11794235,167.401867081,7,4,3,1
bees!,1540.11794235,167.117877865,7,4,3,1
schlag,1540.05141104,116.078779101,16,8,8,2
solarbear,1539.99018189,135.132725753,11,6,5,2
linder,1539.92290055,194.403600177,4,2,2,1
tetsu,1539.65260923,191.69419454,5,3,2,1
ancient genesis,1539.53853561,206.090106309,4,2,2,1
lucifer,1539.46977894,185.968394069,4,2,2,1
marko64,1539.29690317,139.278909257,19,8,11,3
ritaverdronk,1539.27779244,206.497814955,4,2,2,1
stew,1539.1804208,182.777392755,5,3,2,1
mr. manager,1539.1804208,183.348235067,5,3,2,1
malcodafalco,1538.91515624,146.218815864,16,10,6,3
fate,1538.66534785,210.373266904,8,4,4,2
phrigid,1538.43767091,154.834843063,9,4,5,2
suidt,1538.38987413,172.950534589,6,3,3,1
zaik,1538.3401784,113.944523794,17,8,9,3
squeakie,1538.29788935,182.36236808,11,6,5,2
mellamo,1538.29788935,182.36236808,5,3,2,1
zeal,1538.24923656,97.8892474438,37,21,16,6
fout nl,1538.06572038,199.903217683,4,2,2,1
saggystardust,1538.06572038,200.283040819,4,2,2,1
milk,1538.00252798,105.135620324,22,12,10,6
borp,1537.95840516,178.859018622,5,3,2,1
red rice,1537.86910599,187.783398028,5,3,2,1
samyboy03,1537.84446069,204.974835894,4,2,2,1
xin,1537.63740441,198.195219994,4,2,2,1
faheid,1537.50203601,206.122654716,4,2,2,1
trix,1537.38447935,128.653092073,13,6,7,1
koschka,1537.37301476,145.056377779,9,5,4,2
xiii,1537.25554674,181.703309121,5,3,2,1
mombacat,1537.07195077,168.596747025,7,3,4,2
schmep,1537.03422425,166.528121337,7,4,3,1
hunt,1536.57717384,156.754594799,8,4,4,2
ivan,1536.33784143,148.600941531,7,4,3,1
jeremy,1536.25261171,204.385010431,4,2,2,1
nogget,1536.08995154,169.510958969,6,3,3,1
ein,1536.05583449,200.556981597,4,2,2,1
thesuslur14,1536.05295173,204.986753312,11,5,6,2
gosu,1536.00485565,132.606995879,11,6,5,2
q. amp,1535.96336514,204.232505127,4,2,2,1
daddy,1535.96306236,124.103793075,13,7,6,2
thorne,1535.94513037,139.792679317,11,6,5,2
stroker,1535.80117243,175.77063403,6,3,3,1
bob-omb,1535.79886314,148.312384495,9,5,4,2
syphichan,1535.51938652,141.508084261,11,6,5,2
squelch,1535.47548481,204.882034106,4,2,2,1
scoot,1535.4537698,194.804191334,5,3,2,1
angryfalco,1535.43642012,190.88980704,4,2,2,1
dickey,1535.37131975,204.952920766,4,2,2,1
crucible,1535.16130805,186.610724743,5,3,2,1
rael,1535.08748671,177.687750751,5,2,3,1
kooper,1535.07778045,184.405374981,5,3,2,1
beefcake,1535.05402427,142.909919657,10,5,5,2
twunt,1535.04946125,156.572060351,8,4,4,2
pride,1535.04925706,152.804924572,10,5,5,2
pax,1535.04542839,172.422124029,6,3,3,2
radiowar,1534.98888899,193.987783137,5,3,2,1
di guy,1534.98091985,189.267695116,5,3,2,1
celesti,1534.98091985,188.765093209,5,3,2,1
maddog,1534.98091985,188.513289755,5,3,2,1
babybird,1534.98091985,188.966294387,5,3,2,1
kablooey,1534.93851317,196.724887847,4,2,2,1
spikeymike,1534.78227382,204.068340563,4,2,2,1
log,1534.7557396,150.115625706,8,4,4,1
kore,1534.69167222,159.750192643,6,3,3,1
adair,1534.68460277,178.289770082,5,3,2,1
boo,1534.54974371,176.70225618,14,6,8,3
jelijm,1534.42345036,197.301801612,4,2,2,1
king potato,1534.3319027,127.925866554,13,7,6,2
h2o,1534.2394324,172.199556333,6,3,3,1
harriet tubman,1534.1003505,204.244669771,4,2,2,1
cake,1533.78564042,164.370423692,6,3,3,1
mags,1533.66097521,183.714763486,4,2,2,1
jib,1533.58301145,118.220230901,16,9,7,3
arsholino,1533.52731052,188.551240689,5,3,2,1
mk.ii,1533.40194491,168.125554715,6,3,3,1
greenjinjo,1533.38597439,189.226240327,4,2,2,1
lots,1533.23506396,189.655594945,4,2,2,1
egman,1533.23506396,189.655594945,4,2,2,1
supahot,1533.14016482,192.698914608,4,2,2,1
w3emdream,1532.89383346,192.182033897,4,2,2,1
vudoo,1532.84075868,202.354346595,4,2,2,1
ahampster,1532.78442368,166.081064338,6,3,3,1
stelios,1532.7595465,204.790558448,4,2,2,1
lgt,1532.7538442,196.36960086,5,3,2,2
g pipes,1532.58715263,205.240908557,13,5,8,2
darkwolf,1532.56940432,171.9073952,7,4,3,1
xyk,1532.45710418,204.952105893,4,2,2,1
orbit,1532.39432696,189.852281464,4,2,2,1
donutgames43,1532.27774732,149.896798737,9,5,4,2
ludderix,1532.21358326,165.729102752,7,4,3,1
kmol,1532.15354101,199.759275539,4,2,2,1
killjaykill,1531.99483238,181.280772142,6,3,3,1
laser thunder,1531.95356016,139.112453566,12,6,6,2
phobos,1531.89480788,158.542052503,8,4,4,1
ewd444,1531.87337968,191.792738915,4,2,2,1
tree,1531.75541261,156.98746184,7,4,3,1
jecht,1531.64815481,151.283117096,8,4,4,2
ycj,1531.51734328,192.03767858,4,2,2,1
mojo8675309,1531.4846563,144.13509896,9,5,4,2
antic,1531.36870911,129.727452887,13,7,6,2
fullprice,1531.30483416,202.144671567,4,2,2,1
treyvon tustronk,1531.17051677,138.385797729,12,6,6,2
railz,1530.79356513,179.916231552,6,3,3,1
dysfunkti0nal,1530.7540303,120.726042902,14,7,7,3
jerry,1530.7117432,116.146547893,16,8,8,3
mr.watchandlearn,1530.69207205,148.60522975,8,4,4,2
deg,1530.51712646,145.655989578,10,5,5,2
peyto,1530.47768029,188.47112066,5,3,2,1
o'boy,1530.41621751,186.695713852,5,3,2,1
bluecheez,1530.22976518,128.016942203,12,7,5,2
rhyme,1530.22235432,150.24712563,8,4,4,2
lk,1530.19550859,105.625365513,22,12,10,4
~20%,1530.01795715,149.696732262,9,5,4,2
grim,1530.00874315,139.010174384,12,6,6,3
argonaut,1529.9101477,200.548230206,4,2,2,1
odderon,1529.86718343,166.528241101,6,3,3,1
duckslayer,1529.82420059,141.097322769,11,6,5,2
iycewynd,1529.73892372,200.841016221,5,3,2,1
tapsody,1529.56404003,110.441812453,16,9,7,2
kfj,1529.53926292,164.556613131,7,4,3,1
yorozuya volk-chan,1529.53631848,181.874868777,5,3,2,1
omd,1529.48336955,202.190564921,4,2,2,1
southballz,1529.42913315,208.074577617,4,2,2,1
szapat,1529.42001178,157.207078811,9,5,4,2
sith lord sauce boss,1529.37691673,178.347739189,5,3,2,1
havok,1529.33413854,157.655710753,8,4,4,2
heartbreaker,1529.13218439,184.343563019,4,2,2,1
ybot,1528.99083533,153.149453021,8,5,3,1
pots,1528.82439888,128.02364937,13,6,7,2
typo,1528.66545619,146.677726979,10,5,5,3
guts,1528.4387277,191.976502208,4,2,2,1
rad,1528.34196639,154.220510764,9,5,4,2
c-bass,1528.3334111,187.315996546,5,3,2,1
globe,1528.32767391,139.8677039,12,6,6,3
poskii,1528.26623177,132.391338263,13,7,6,2
wjang,1528.1789186,192.37331037,4,2,2,1
om,1527.87493118,126.947768646,19,11,8,4
fingerblast,1527.55581255,200.164901281,4,2,2,1
pendragon,1527.43878896,187.990330782,4,2,2,1
corn,1527.31839572,195.030065256,4,2,2,1
soy,1527.31836159,158.228582826,17,10,7,4
messenger,1527.09077744,126.285245598,14,7,7,3
kickpunch,1526.99703361,178.832922657,5,3,2,1
goobershadow,1526.97085901,94.6720249411,25,13,12,4
belgish,1526.88631986,197.69687849,4,2,2,1
crispy,1526.85330532,108.266681143,21,12,9,3
lange,1526.82053831,202.864241214,4,2,2,1
matthijs,1526.73718718,145.905211742,9,5,4,1
bcn,1526.71243564,187.951758123,4,2,2,1
doghug,1526.64326258,216.855330397,2,1,1,1
quantum_x,1526.48820107,202.168450323,4,2,2,1
nachloride,1526.47593785,186.495630802,4,2,2,1
squeg,1526.07379425,163.616888602,6,4,2,1
mikehaggarssbm,1526.05619082,138.782909561,24,15,9,3
habilecho,1525.98242116,139.409053571,12,6,6,3
mouf,1525.95964902,158.93855071,8,4,4,2
ptet,1525.95822916,196.180415232,4,2,2,1
action master,1525.66058311,171.348913314,6,4,2,1
mgeezus,1525.6254944,165.272571821,7,4,3,1
hud,1525.52874724,201.578995159,4,2,2,1
gobbleboners,1525.47765411,177.134101687,5,3,2,1
ogsupersand,1525.36701886,178.535376314,5,3,2,1
rarik,1525.27053936,201.78046066,4,2,2,1
zluchs,1525.23707483,197.169163319,5,3,2,1
jelly,1525.16299914,149.345930086,9,5,4,2
happy,1525.08857645,203.86713078,4,2,2,1
dono42,1525.07425913,201.612436788,4,2,2,1
paper tiger,1525.03342623,134.481802872,13,7,6,4
emilywaves,1525.00368433,144.188369312,16,8,8,4
pataflafla,1524.9088262,186.688272991,4,2,2,1
skm,1524.85453451,202.643003821,4,2,2,1
sak,1524.56126873,125.058035235,13,7,6,2
bok choy,1524.51450632,181.393453368,4,2,2,1
radicalfox,1524.48570017,201.474173853,4,2,2,1
the salty smasher,1524.48570017,201.474173853,4,2,2,1
wok,1524.41306884,195.270479889,4,2,2,1
tuna,1524.40045639,131.798377437,13,7,6,3
timtempor,1524.36630987,154.458280577,8,4,4,1
nameless joe,1524.30282638,203.652912079,7,3,4,2
zed,1524.30282638,203.652912079,4,2,2,1
k.i.d ace,1524.25170124,201.451683823,4,2,2,1
xeon,1524.1664335,176.877852581,4,2,2,1
yungwavedash,1524.10256167,180.65689954,5,3,2,1
dmg,1523.85950845,153.753773029,8,4,4,1
heretic,1523.70106915,193.260374525,4,2,2,1
bepis,1523.66965442,201.935643731,4,2,2,1
metric,1523.63493246,111.690800349,19,10,9,4
aqux,1523.59913919,202.064749125,4,2,2,1
dansofree,1523.15845432,182.896049636,5,3,2,1
toss event,1523.02538853,195.642113969,4,2,2,2
holiday,1523.0205857,154.624873033,7,3,4,1
gimli,1523.01882602,202.22188714,4,2,2,2
zamassus,1522.89732871,177.750748743,6,3,3,1
slim jesus,1522.85605453,199.008153286,4,2,2,1
schnurb,1522.57624993,110.629986401,16,8,8,2
tangmang,1522.46990274,128.536311573,13,7,6,2
jonny gumball gamble,1522.40200735,152.907389628,6,3,3,1
hatcrab,1522.29956837,198.749655058,4,2,2,1
cweb,1522.20117234,201.32015896,4,2,2,1
yung fuccboii,1522.20117234,201.32015896,4,2,2,1
popehat,1522.04130757,184.364987332,5,3,2,1
sat,1521.83882362,207.893800752,4,2,2,1
thegravytrain,1521.70942186,239.526147468,2,1,1,1
.ðempt,1521.63430014,164.149950645,6,3,3,1
microwaveyourhead,1521.444685,201.305443635,4,2,2,1
cigs,1521.1761511,200.161700592,4,2,2,1
beej danger,1521.14222082,204.008502192,4,2,2,1
hi im mikey,1521.07122216,177.421908486,6,3,3,1
nomad,1521.05972182,121.901961626,13,7,6,2
kvn,1521.05855836,133.544791593,12,6,6,3
jobes,1520.85429914,116.09660835,17,9,8,3
rapatap,1520.84141024,187.251160661,5,3,2,1
boomstick,1520.68809291,159.656379009,7,4,3,1
old mcjonald,1520.683528,200.407536493,4,2,2,1
thechocolatelava,1520.5588338,155.256798482,8,4,4,2
shieldz,1520.25151424,146.850446791,11,5,6,3
stif,1520.20757252,210.797607081,5,3,2,2
xest,1520.17356438,127.016729956,13,7,6,3
jon,1520.13050759,112.721244478,19,10,9,4
kaiser-gl,1520.10228955,139.03879208,10,5,5,2
kobe,1520.09112502,167.02370988,11,5,6,2
lo1ts,1520.04841888,192.109645431,4,2,2,1
lac,1520.03003135,154.364581245,8,4,4,2
jorge,1519.77751823,157.017432309,8,4,4,2
big time rush,1519.51754899,197.93589851,4,2,2,1
rudmarker,1519.33878037,170.279996902,6,3,3,1
k,1519.18588902,101.838028526,23,12,11,5
marvel,1519.14215245,170.315759902,14,7,7,3
sans,1519.10393035,160.007362021,6,3,3,1
lahti,1519.00090438,174.306433633,6,3,3,1
scale,1518.94116017,201.270314437,4,2,2,2
bpna,1518.94116017,200.750440781,4,2,2,1
pancake mix.,1518.94116017,200.750440781,4,2,2,1
slickis,1518.94116017,200.086829836,4,2,2,1
shineasaurusflex,1518.94116017,199.849291902,4,2,2,1
krusty,1518.94116017,200.229217333,4,2,2,1
sartoris,1518.86995327,199.356101208,4,2,2,1
peliq,1518.62425829,139.120737095,11,6,5,2
stylo ren,1518.5107718,179.36908509,5,3,2,1
wasp,1518.4182032,160.693660997,7,4,3,1
pootthebox,1518.39535706,162.019510235,10,4,6,3
rumble,1518.32983301,153.262098877,8,4,4,2
flex,1518.2973894,191.266001558,4,2,2,1
simba,1518.2217238,155.550090751,8,4,4,2
sabz,1518.07685656,138.2440135,17,9,8,5
deenuna,1517.92214136,173.58951279,6,3,3,1
scrapmettle,1517.87318046,194.323634187,5,3,2,1
milkmuffinman,1517.87318046,193.981119709,5,3,2,1
tack,1517.87318046,194.323634187,5,3,2,1
figment,1517.23477866,199.606717227,4,2,2,1
brohad,1517.0800907,181.390966252,5,3,2,1
joelypoleybigbelly,1516.96011862,202.107306906,4,2,2,1
ryanxe,1516.69858395,183.993887402,4,2,2,1
mrjungstuffed,1516.59541366,195.557983671,4,2,2,1
citius,1516.37793626,167.656953762,6,3,3,1
z a x o,1516.31906076,200.486672814,4,2,2,1
ako,1516.2186478,152.381127833,9,5,4,2
absolome,1516.17134332,194.2623041,4,2,2,1
nami,1516.16962622,192.950651032,4,2,2,1
john lemon,1515.80723061,196.981652205,4,2,2,1
goldman snacks,1515.75903473,160.738868842,9,4,5,2
slush,1515.68674307,126.285037934,23,11,12,4
istock,1515.49218921,171.279936996,5,3,2,1
blanky,1515.32820001,164.313404019,8,4,4,2
neil,1515.29342939,193.4818383,4,2,2,1
duhssert,1514.70864452,148.930596723,9,5,4,2
sweetwilly,1514.69449589,193.387068768,4,2,2,1
2a4t,1514.62938719,108.531523633,17,10,7,3
blayd,1514.61408886,176.742535799,6,3,3,1
art,1514.5048189,199.475601247,4,2,2,1
jus,1514.46651444,154.769015793,8,4,4,2
reggie,1514.32987897,166.238209451,6,3,3,2
yung bones villain,1514.29353426,135.835684687,11,6,5,2
tgrass,1514.22174766,201.282430976,4,2,2,1
mothra,1514.21926168,189.765726597,4,2,2,1
valdo,1514.11638659,173.980825184,5,2,3,1
leet,1513.90078146,157.114628239,7,4,3,1
cowhunter,1513.89122425,176.273026302,5,3,2,1
kabbage$$,1513.85605257,199.89418943,4,2,2,1
zettavolt,1513.44269478,199.717432915,4,2,2,1
subsuck,1513.34916296,160.541760561,6,3,3,1
luigi master tae,1513.31637295,187.039435705,5,3,2,1
brujo,1513.24217686,154.205968807,8,4,4,2
spire_fan,1513.18506349,141.191216033,9,5,4,1
2 johns,1513.09726504,176.683921519,6,3,3,2
wind,1513.08581905,113.67543507,18,9,9,4
5ive,1512.99200298,234.794741238,2,1,1,1
pleeba,1512.91094607,155.062972142,8,4,4,1
pono,1512.90505028,199.138485338,4,2,2,1
weo weo jax,1512.75252422,179.014308834,5,3,2,1
cava,1512.66176955,136.496524553,10,5,5,2
melpyx,1512.62349781,163.078186336,8,4,4,2
fatnomen,1512.48564214,197.036372514,4,2,2,1
skywalker,1512.47757823,116.851709454,15,8,7,2
yungbami,1512.4657561,242.886531541,11,6,5,2
remolinoferoz,1512.43129108,170.773993836,5,3,2,1
animeh,1512.40818119,187.427526445,4,2,2,1
mrboffo,1512.33883689,179.586185746,7,3,4,2
risen,1512.33850099,159.294863472,7,4,3,1
readbarren,1512.13762073,198.703637884,4,2,2,1
kneevel knievel,1512.04995761,191.546577605,4,2,2,1
pres,1512.04995761,191.546577605,4,2,2,1
boner,1512.01946084,192.525589669,4,2,2,1
rawdrigo,1511.89652564,199.943598961,4,2,2,1
afb,1511.86305024,193.224314556,4,2,2,1
zeddy,1511.79494266,154.53608696,7,4,3,1
salt mine,1511.56163097,187.528772165,4,2,2,1
moze,1511.40475807,178.730587279,6,3,3,1
nfreak,1511.26743305,114.866430652,17,9,8,4
forerunner,1511.13109789,197.990346576,4,2,2,1
balatee,1511.07538074,239.750845349,2,1,1,1
spy,1510.81264801,180.977372036,4,2,2,1
squil,1510.79765282,190.450937053,4,2,2,1
ulsi,1510.79182443,142.810170738,9,5,4,2
erisez,1510.73554874,210.271083785,3,1,2,1
bagelz,1510.68864965,175.867007428,5,3,2,1
shiftybadger,1510.61657289,160.57032608,8,4,4,2
gangly,1510.39238993,137.472614091,12,6,6,3
yeezus,1510.37943647,195.012251033,4,2,2,1
flamingo,1510.25707967,172.264409688,6,3,3,1
chef,1510.24590946,350,11,1,10,3
mole,1509.74112339,192.704414126,11,2,9,2
connor,1509.68267237,136.566407895,12,6,6,3
timpz,1509.6509104,191.897485925,5,2,3,1
idgas,1509.4380477,190.560336267,4,2,2,1
praxis,1509.41145831,198.569534117,4,2,2,1
fooly,1509.32081203,166.425975745,6,3,3,1
typhoon,1509.25798581,199.390397897,4,2,2,1
never,1509.25798581,199.8187448,4,2,2,1
klutzy klutch,1509.25798581,200.293611415,4,2,2,1
kota,1509.25798581,199.771196056,4,2,2,1
tariqdx,1509.25798581,199.723635991,4,2,2,1
wii-kai,1509.2406193,154.07844099,8,4,4,1
seeze,1509.18186906,135.116109333,12,6,6,3
ezezo,1508.85448171,186.135287935,5,3,2,1
scarjo,1508.69509329,200.186979915,4,2,2,1
jeffthecheff,1508.67155642,174.346224566,6,3,3,1
spidermad,1508.67155642,174.346224566,6,3,3,1
rarebitfiend,1508.64743776,218.967196225,4,2,2,1
kezzup,1508.62715247,147.364033171,8,4,4,2
thomas the legend,1508.49461848,148.84373426,8,4,4,2
bloop,1508.36277607,192.862120351,4,2,2,1
vesetnet,1508.26101484,143.865434373,16,10,6,3
ryku,1508.12027489,193.069153531,4,2,2,1
rileyreads,1508.10907719,188.122377614,4,2,2,1
tyle,1508.02515137,197.784927624,4,2,2,1
arsi,1508.02515137,197.784927624,4,2,2,1
nscyte,1507.7851087,159.273051215,8,4,4,1
jury,1507.78033368,200.707382417,4,2,2,1
goya beans x,1507.78033368,200.565334384,4,2,2,1
buu,1507.78033368,201.227367315,4,2,2,1
cop crusher,1507.78033368,200.565334384,4,2,2,1
arcade,1507.78033368,200.707382417,4,2,2,1
pcgbones,1507.78033368,200.707382417,4,2,2,1
frame$,1507.78033368,200.707382417,4,2,2,1
xrunriot,1507.78033368,201.227367315,4,2,2,1
mossman,1507.78033368,201.03843751,10,3,7,2
zofrea,1507.78033368,201.227367315,4,2,2,1
bunsunkun,1507.6976232,197.932548784,4,2,2,1
maku,1507.67837497,182.173674168,5,3,2,1
smillzor,1507.66117612,185.263008788,5,3,2,1
smirked,1507.48085871,132.566313114,12,6,6,3
sukou,1507.30856405,136.686168586,12,6,6,2
gaz!,1507.30590257,135.546575462,11,5,6,2
law,1507.3030025,94.2396556557,29,14,15,5
ron paul,1507.29789175,160.501121888,7,4,3,1
get loose,1507.28652065,201.161598949,4,2,2,1
turtle,1507.12083022,119.652628885,24,10,14,4
robotnick,1507.05408072,231.849291554,3,1,2,1
weirdo dunno,1507.01826586,197.962318618,4,2,2,1
spood,1507.00033996,186.410578155,4,2,2,1
cow,1506.84530435,122.038867451,13,6,7,2
dad,1506.78313507,127.835214255,19,9,10,5
mekk,1506.77325866,120.533435871,17,7,10,3
pav nasty,1506.48334794,219.193228545,3,1,2,1
gh0st,1506.40594668,154.456633362,10,5,5,3
mike4real,1506.39667214,203.041723871,4,2,2,1
nuro,1506.39667214,203.041723871,4,2,2,1
jxc,1506.39313624,197.939483371,4,2,2,1
sangho,1506.34361449,190.173175602,4,2,2,1
feelings,1506.29523053,198.535191572,4,2,2,1
papa nooch,1506.28459205,198.143389911,4,2,2,1
dingo,1506.16905459,179.833882919,13,7,6,3
phil collins,1506.14475612,194.028063851,4,2,2,1
bananashark,1506.09808559,189.116227008,5,3,2,1
brandermeer,1506.05370067,197.994670598,4,2,2,1
kingquiggles,1505.996353,176.150290116,6,3,3,1
vondo,1505.92016021,196.97346011,4,2,2,1
zíng,1505.82140287,112.636480399,19,9,10,3
lil brown,1505.69944201,196.990039046,4,2,2,1
djniinii,1505.62538972,198.090335125,4,2,2,1
spell,1505.56094792,198.53926756,4,2,2,1
koopi,1504.87788517,159.478927285,8,4,4,1
solharath,1504.87788517,159.478927285,8,4,4,1
greeb,1504.87317152,174.276514895,6,3,3,1
dovler,1504.81985973,196.69110201,4,2,2,1
bees?,1504.80563929,128.47106517,12,6,6,3
para,1504.79814727,167.84895114,6,3,3,1
papa zondo,1504.78993346,188.475841243,4,2,2,1
freky,1503.91653523,142.472674547,12,6,6,3
in progress,1503.87270319,159.39301896,7,3,4,1
lew lew,1503.8639617,156.840547792,8,4,4,2
boxes,1503.63487527,199.830382899,4,2,2,1
kafka,1503.49391696,166.92052526,12,3,9,2
dr. gg,1503.48804022,152.821093894,9,5,4,2
timesink,1503.47420109,143.641373197,10,5,5,2
alday,1503.34604926,169.216981217,6,3,3,1
telechubby,1503.34308437,184.703641935,4,2,2,1
webs,1503.29946412,110.831003691,24,12,12,5
super fang chan,1503.02014794,128.804334108,13,7,6,2
stoned toddler,1502.87701482,174.989830928,6,3,3,1
cyberdelic,1502.8369256,173.391300927,7,3,4,1
super ginger,1502.78074674,142.554188798,10,5,5,2
nomis,1502.5371583,158.820020394,7,4,3,1
phrez,1502.50430847,148.082752305,9,5,4,2
haelst,1502.28435365,169.772278544,6,3,3,1
sylar,1502.15900067,178.832635872,5,3,2,1
snabbdjur,1502.06358534,173.056810369,6,3,3,1
dayman,1501.98208501,197.271133371,10,6,4,2
bean,1501.74713031,128.456732537,14,7,7,2
af,1501.70732501,191.305153838,4,2,2,1
black^sheep,1501.651369,165.850751985,8,4,4,2
crupyo,1501.57038206,149.74661292,8,4,4,1
remix,1501.43901739,192.9769005,4,2,2,1
mixit,1501.38392256,165.348837393,8,4,4,2
flimwad,1501.1214999,241.802022258,7,3,4,3
rivers,1500.84865411,140.231304224,14,7,7,2
ochoa_97,1500.81210237,197.990101648,4,2,2,1
carrigan,1500.76115734,198.440814878,4,2,2,1
ogino,1500.76115734,198.440814878,4,2,2,1
zepherz,1500.76115734,199.348330842,4,2,2,1
funkymacgee,1500.76115734,198.680036767,4,2,2,1
shadow light master,1500.63531332,210.526202392,4,2,2,2
nice climbers,1500.49815634,85.0739498131,32,15,17,6
curlydave,1500.16764661,183.924332534,6,3,3,1
ncr0,1500.07467122,176.107978279,5,3,2,1
letsduet,1500.0,209.255166634,4,2,2,1
boosted,1500.0,208.937131126,4,2,2,1
breeze,1500.0,209.164348691,4,2,2,1
dcmaster,1500.0,209.663360564,4,2,2,1
connorasada,1500.0,209.663360564,4,2,2,1
theoneburger,1500.0,209.663360564,4,2,2,1
doubleo_tp,1500.0,209.663360564,4,2,2,1
carso,1500.0,163.457578655,8,4,4,1
flakes,1500.0,208.800681903,4,2,2,1
prospekt,1500.0,208.937131126,4,2,2,1
blooky,1500.0,209.436684378,4,2,2,1
ijiz,1500.0,208.800681903,4,2,2,1
d-tek,1500.0,209.663360564,4,2,2,1
ben123dx,1500.0,253.683029361,2,1,1,1
sun,1500.0,209.663360564,4,2,2,1
rato,1500.0,209.663360564,4,2,2,1
info,1500.0,209.663360564,4,2,2,1
teo,1500.0,209.663360564,4,2,2,1
boandrew,1500.0,209.663360564,4,2,2,1
grandma dan,1500.0,209.663360564,4,2,2,1
p.body,1500.0,182.632308241,6,3,3,1
mexray,1500.0,209.663360564,4,2,2,1
wyne,1500.0,209.663360564,4,2,2,1
krusty kurt,1500.0,209.663360564,4,2,2,1
forbidden,1500.0,209.118924928,4,2,2,1
dabvillefl,1500.0,209.663360564,4,2,2,1
sharkskeepmoving,1500.0,209.663360564,4,2,2,1
canadianbank,1500.0,209.255166634,4,2,2,1
bishop,1500.0,209.663360564,4,2,2,1
falco,1500.0,208.573068163,4,2,2,1
harvey,1500.0,163.921871694,8,4,4,1
ezra,1500.0,209.663360564,4,2,2,1
bude,1500.0,209.663360564,4,2,2,1
jett,1500.0,209.663360564,4,2,2,1
azianraven,1500.0,209.663360564,7,3,4,2
cuda,1500.0,209.164348691,4,2,2,1
wsp,1500.0,209.118924928,4,2,2,1
slash,1500.0,209.663360564,4,2,2,1
cudr,1500.0,209.663360564,4,2,2,1
meh,1500.0,209.663360564,4,2,2,1
ltigre,1500.0,209.663360564,4,2,2,1
cottoncandy,1500.0,209.663360564,4,2,2,1
littleone,1500.0,209.663360564,4,2,2,1
your3rdgradeteacher,1500.0,209.663360564,4,2,2,1
weez,1500.0,209.255166634,4,2,2,1
miggy,1500.0,208.800681903,4,2,2,1
loid,1500.0,254.28149635,2,1,1,1
glaikit,1500.0,182.528244426,13,7,6,2
yum,1500.0,208.573068163,4,2,2,1
gimr,1500.0,209.663360564,4,2,2,1
heemoglobin,1500.0,208.573068163,4,2,2,1
sir illiam,1500.0,209.663360564,4,2,2,1
howdoismash,1500.0,209.663360564,4,2,2,1
method,1500.0,209.663360564,4,2,2,1
volton,1500.0,208.800681903,4,2,2,1
siren,1500.0,209.663360564,4,2,2,1
machinegungeek,1500.0,209.663360564,4,2,2,1
palm top,1500.0,209.663360564,4,2,2,1
themagnumdragon,1500.0,209.663360564,4,2,2,1
deadstorm,1500.0,209.663360564,4,2,2,1
knocker,1500.0,260.006550899,10,4,6,2
ranger guy,1500.0,209.663360564,4,2,2,1
mertoxiac,1500.0,209.663360564,4,2,2,1
douchebag dylan,1500.0,209.663360564,4,2,2,1
and1,1500.0,209.663360564,4,2,2,1
rice climbers,1500.0,209.663360564,4,2,2,1
tönt,1500.0,209.663360564,4,2,2,1
tfec,1500.0,208.937131126,4,2,2,1
andu,1500.0,209.255166634,11,5,6,2
prem,1500.0,209.663360564,4,2,2,1
morale,1500.0,209.255166634,4,2,2,1
nevs,1500.0,208.573068163,4,2,2,1
kennybuchi,1500.0,209.663360564,4,2,2,1
flytide,1500.0,209.663360564,4,2,2,1
thespymachine,1500.0,209.663360564,4,2,2,1
scrums,1500.0,209.436684378,4,2,2,1
tenshii,1500.0,209.663360564,4,2,2,1
xnpio,1500.0,209.663360564,4,2,2,1
vyq,1500.0,182.528244426,6,3,3,1
avenu,1500.0,209.663360564,4,2,2,1
grazi,1500.0,209.663360564,4,2,2,1
gerryog,1500.0,209.663360564,4,2,2,1
vonfancy,1500.0,254.28149635,2,1,1,1
army,1500.0,209.663360564,4,2,2,1
argyros,1500.0,209.436684378,4,2,2,1
raxomukus,1500.0,182.528244426,6,3,3,1
marco,1500.0,209.663360564,4,2,2,1
kaz,1500.0,208.937131126,4,2,2,1
whoopiecow,1500.0,209.255166634,4,2,2,1
kingofleaves,1500.0,209.663360564,4,2,2,1
sirreginald,1500.0,209.255166634,4,2,2,1
goliath,1500.0,209.663360564,4,2,2,1
jazz,1500.0,209.663360564,4,2,2,1
bluemarine,1500.0,163.457578655,8,4,4,1
anathema,1500.0,209.663360564,4,2,2,1
lupoor,1500.0,209.663360564,4,2,2,1
thatnastypasta,1500.0,209.663360564,4,2,2,1
phaedrus,1500.0,208.800681903,4,2,2,1
merlisker,1500.0,208.800681903,4,2,2,1
bluemonkek,1500.0,209.663360564,4,2,2,1
fortefreak,1500.0,182.632308241,6,3,3,1
rust,1500.0,209.663360564,4,2,2,1
taternator,1500.0,209.663360564,4,2,2,1
cryo,1500.0,209.663360564,4,2,2,1
oro,1500.0,209.436684378,4,2,2,1
ai,1500.0,209.663360564,4,2,2,1
wanderew,1500.0,209.663360564,4,2,2,1
yng$falcon,1500.0,209.663360564,6,2,4,2
outthecuts,1500.0,209.663360564,4,2,2,1
sundark,1500.0,209.164348691,4,2,2,1
joe schmo,1500.0,208.573068163,4,2,2,1
moistbruh,1500.0,209.663360564,4,2,2,1
old$,1500.0,209.663360564,4,2,2,1
enduro,1500.0,209.436684378,4,2,2,1
abcactus,1500.0,209.663360564,4,2,2,1
bryciepoo,1500.0,209.663360564,4,2,2,1
vanilla coke,1500.0,209.436684378,4,2,2,1
spookyman,1500.0,209.663360564,4,2,2,1
kelan,1500.0,209.663360564,4,2,2,1
wyzdm,1500.0,208.937131126,4,2,2,1
cartega,1500.0,209.436684378,4,2,2,1
mono,1500.0,209.663360564,4,2,2,1
a$ap p0cky,1500.0,209.663360564,4,2,2,1
e102y,1500.0,209.663360564,4,2,2,1
g,1500.0,182.528244426,13,8,5,2
vorpal,1500.0,209.663360564,4,2,2,1
wabunga,1500.0,209.663360564,4,2,2,1
taxmoney,1500.0,209.663360564,4,2,2,1
kingu,1500.0,208.937131126,4,2,2,1
narfanator,1500.0,209.663360564,4,2,2,1
frogman,1500.0,209.436684378,4,2,2,1
just jason,1500.0,209.436684378,4,2,2,1
jzee,1500.0,208.800681903,4,2,2,1
yogurt,1500.0,208.937131126,4,2,2,1
solariiii,1500.0,208.891657955,4,2,2,1
kaygee,1500.0,209.663360564,4,2,2,1
ezpz,1500.0,209.663360564,4,2,2,1
zan,1500.0,209.663360564,4,2,2,1
official slime,1500.0,209.663360564,4,2,2,1
spoodbeest,1500.0,209.436684378,4,2,2,1
ultraman,1500.0,209.663360564,4,2,2,1
whitemike,1500.0,209.663360564,4,2,2,1
maru,1500.0,209.436684378,4,2,2,1
gobi,1500.0,209.255166634,4,2,2,1
beigemush,1500.0,209.663360564,4,2,2,1
dyno,1500.0,209.164348691,4,2,2,1
juna,1500.0,208.800681903,4,2,2,1
bee,1500.0,209.164348691,4,2,2,1
kellen,1500.0,182.632308241,6,3,3,1
fonzie,1500.0,208.937131126,4,2,2,1
kolea,1500.0,209.436684378,4,2,2,1
clorox,1500.0,209.436684378,4,2,2,1
hero,1500.0,209.255166634,4,2,2,1
rundmx,1500.0,209.164348691,4,2,2,1
berk,1500.0,209.663360564,4,2,2,1
iamcreditcard,1500.0,209.663360564,4,2,2,1
empire,1500.0,209.255166634,4,2,2,1
jt,1500.0,209.663360564,4,2,2,1
helix,1500.0,209.663360564,4,2,2,1
qt,1500.0,209.436684378,4,2,2,1
glaze,1500.0,209.663360564,4,2,2,1
scrambled,1500.0,209.663360564,4,2,2,1
229,1500.0,209.436684378,4,2,2,1
sung475,1500.0,209.663360564,4,2,2,1
blargh257,1500.0,209.663360564,4,2,2,1
nathansandwich,1500.0,209.663360564,4,2,2,1
employee,1500.0,208.937131126,4,2,2,1
mdm,1500.0,209.663360564,4,2,2,1
hot_dogg,1500.0,209.663360564,4,2,2,1
armor,1500.0,209.663360564,4,2,2,1
tranmobile,1500.0,209.663360564,4,2,2,1
veranibbles,1500.0,209.255166634,4,2,2,1
whisky wizard,1500.0,208.891657955,4,2,2,1
raito,1500.0,208.573068163,4,2,2,1
shridiculous,1500.0,253.982439129,2,1,1,1
corruption925,1500.0,209.663360564,4,2,2,1
flake,1500.0,209.663360564,4,2,2,1
kcg,1500.0,182.528244426,6,3,3,1
final,1500.0,209.663360564,4,2,2,1
napz,1500.0,208.937131126,4,2,2,1
hq,1500.0,208.800681903,4,2,2,1
hi,1500.0,209.663360564,4,2,2,1
madjick,1500.0,208.573068163,4,2,2,1
ironblock,1500.0,209.663360564,4,2,2,1
tino joe,1500.0,209.663360564,4,2,2,1
trustmeimblack,1500.0,209.663360564,4,2,2,1
hoodcash,1500.0,182.372037367,6,3,3,1
ync,1500.0,209.663360564,4,2,2,1
reverb,1500.0,209.572719511,4,2,2,1
krad,1500.0,209.663360564,4,2,2,1
cab,1500.0,209.663360564,4,2,2,1
blues,1500.0,209.663360564,4,2,2,1
riko,1500.0,208.982594402,4,2,2,1
whitekneegrow,1500.0,209.255166634,4,2,2,1
tekk,1500.0,350,15,12,3,3
psychictandemwarelephant,1500.0,209.663360564,4,2,2,1
howie,1500.0,182.528244426,13,8,5,2
halfjack,1500.0,208.800681903,4,2,2,1
cat wrestler,1500.0,208.800681903,4,2,2,1
bottle opener guy,1500.0,209.663360564,4,2,2,1
agora,1500.0,209.118924928,4,2,2,1
guavajuice,1500.0,209.663360564,4,2,2,1
toomanyboxes,1500.0,209.663360564,4,2,2,1
darksim,1500.0,209.436684378,4,2,2,1
flab,1500.0,182.528244426,6,3,3,1
stevedode,1500.0,209.663360564,4,2,2,1
j.p,1500.0,209.663360564,4,2,2,1
kcaz,1500.0,209.663360564,4,2,2,1
xtreme,1500.0,163.457578655,8,4,4,1
jameson,1500.0,209.663360564,4,2,2,1
sexy,1500.0,209.663360564,4,2,2,1
cardd.sd,1500.0,209.436684378,4,2,2,1
frotaz,1500.0,209.663360564,4,2,2,1
hard reid,1500.0,209.663360564,4,2,2,1
xhyrri,1500.0,209.663360564,4,2,2,1
shybagger,1500.0,209.663360564,4,2,2,1
han,1500.0,209.663360564,4,2,2,1
peggle master,1500.0,209.663360564,4,2,2,1
odey,1500.0,209.663360564,4,2,2,1
true dong,1500.0,209.663360564,4,2,2,1
young $,1500.0,209.663360564,4,2,2,1
sempaikush,1500.0,209.255166634,4,2,2,1
rift,1500.0,209.663360564,4,2,2,1
despair,1500.0,182.528244426,6,3,3,1
aeoluxar,1500.0,209.663360564,4,2,2,1
surfero,1500.0,209.663360564,4,2,2,1
abulize,1500.0,209.663360564,4,2,2,1
thundrio,1500.0,208.573068163,4,2,2,1
illegalalien,1500.0,150.551931739,10,5,5,2
foodmanchew,1500.0,209.663360564,4,2,2,1
perrilox,1500.0,209.663360564,4,2,2,1
jacobyf,1500.0,209.663360564,4,2,2,1
unlucky,1500.0,181.79812984,6,3,3,1
bradendu,1500.0,209.663360564,4,2,2,1
exembe,1500.0,209.663360564,4,2,2,1
pizzamaster,1500.0,208.937131126,4,2,2,1
caped baldy,1500.0,209.663360564,4,2,2,1
champloo,1500.0,209.663360564,4,2,2,1
gliphy,1500.0,208.937131126,4,2,2,1
bikerknight,1500.0,182.528244426,6,3,3,1
louie.exe,1500.0,209.663360564,4,2,2,1
ads,1500.0,209.164348691,4,2,2,1
supreme,1500.0,209.663360564,4,2,2,1
joaco,1500.0,209.663360564,4,2,2,1
semen demon,1500.0,209.663360564,4,2,2,1
viridian,1500.0,209.663360564,4,2,2,1
zanderwill,1500.0,208.573068163,4,2,2,1
lysozy,1500.0,209.663360564,8,4,4,2
exumer,1500.0,209.663360564,4,2,2,1
dennis,1500.0,182.111394518,6,3,3,1
nasty,1500.0,209.663360564,7,3,4,2
jotinos,1500.0,209.663360564,4,2,2,1
yung dactyl,1500.0,209.663360564,4,2,2,1
play4fun,1500.0,182.528244426,6,3,3,1
big ben,1500.0,209.663360564,4,2,2,1
raves,1500.0,209.663360564,4,2,2,1
cablebox,1500.0,208.800681903,4,2,2,1
frozenspade,1500.0,209.663360564,4,2,2,1
birdybirds,1500.0,209.164348691,4,2,2,1
stormchicken,1500.0,209.436684378,4,2,2,1
tuck dynasty,1500.0,209.663360564,4,2,2,1
defiant,1500.0,209.663360564,4,2,2,1
huggermugger,1500.0,209.663360564,4,2,2,1
dr. wa,1500.0,209.663360564,4,2,2,1
fastestrock,1500.0,209.663360564,4,2,2,1
dunkchai,1500.0,208.982594402,4,2,2,1
robohobo,1500.0,209.663360564,4,2,2,1
jzhao098,1500.0,209.663360564,4,2,2,1
dayz,1500.0,209.164348691,4,2,2,1
branchan,1500.0,209.663360564,4,2,2,1
snowboardcat,1500.0,208.800681903,4,2,2,1
destroyer,1500.0,209.663360564,4,2,2,1
lev,1500.0,209.663360564,4,2,2,1
pvc chris,1500.0,208.800681903,4,2,2,1
puc,1500.0,208.573068163,4,2,2,1
langkow,1500.0,209.255166634,4,2,2,1
sir skaro,1500.0,209.663360564,4,2,2,1
rusty shacklefurd,1500.0,209.663360564,4,2,2,1
yamcha,1500.0,254.28149635,2,1,1,1
arstneio,1500.0,209.436684378,4,2,2,1
seven,1500.0,209.663360564,4,2,2,1
steph curry,1500.0,209.436684378,4,2,2,1
scarb,1500.0,182.528244426,6,3,3,1
bland,1500.0,208.573068163,4,2,2,1
brosef stylin,1500.0,209.663360564,4,2,2,1
neiled it,1500.0,209.663360564,4,2,2,1
relish,1500.0,209.436684378,4,2,2,1
pretty cool guy,1500.0,209.663360564,4,2,2,1
toucan sam,1500.0,209.118924928,4,2,2,1
deathpie,1500.0,208.800681903,4,2,2,1
deepfriedtickles,1500.0,209.255166634,4,2,2,1
a.i.,1500.0,209.663360564,9,5,4,2
myroknpancakes,1500.0,209.663360564,4,2,2,1
pchu,1500.0,253.832778391,2,1,1,1
tm75,1500.0,182.111394518,6,3,3,1
panny,1500.0,209.028047791,4,2,2,1
raish,1500.0,209.663360564,4,2,2,1
god!tucksinthesheets,1500.0,209.663360564,4,2,2,1
nastynate,1500.0,209.663360564,4,2,2,1
vaati,1500.0,209.164348691,4,2,2,1
the_superiortaste,1500.0,209.663360564,4,2,2,1
bestpie,1500.0,209.663360564,4,2,2,1
the moutai prince,1500.0,209.663360564,4,2,2,1
silentakuma,1500.0,209.663360564,4,2,2,1
symes,1500.0,209.255166634,4,2,2,1
$haqtus,1500.0,209.663360564,4,2,2,1
lamb,1500.0,209.255166634,4,2,2,1
spunky,1500.0,209.663360564,4,2,2,1
disk0,1500.0,209.164348691,4,2,2,1
lyme,1500.0,209.663360564,4,2,2,1
dinosaur29,1500.0,182.111394518,6,3,3,1
manny,1500.0,209.663360564,4,2,2,1
grandma's cleavage,1500.0,209.663360564,4,2,2,1
mkan,1500.0,209.663360564,4,2,2,1
jsal,1500.0,209.663360564,4,2,2,1
danger doggo,1500.0,208.937131126,4,2,2,1
diplomatictucan,1500.0,209.663360564,4,2,2,1
christhenoob,1500.0,209.663360564,4,2,2,1
taycen,1500.0,253.870201847,2,1,1,1
d4c,1500.0,209.663360564,4,2,2,1
s-man,1500.0,209.436684378,4,2,2,1
steven,1500.0,254.28149635,2,1,1,1
slacker,1500.0,182.528244426,6,3,3,1
mugifi,1500.0,209.255166634,4,2,2,1
gigglyfart,1500.0,209.255166634,4,2,2,1
shiv,1500.0,209.663360564,4,2,2,1
freajk,1500.0,209.663360564,4,2,2,1
v$,1500.0,209.663360564,4,2,2,1
bick.trip,1500.0,208.800681903,4,2,2,1
charlezard,1500.0,209.663360564,4,2,2,1
gkinfinity,1500.0,209.663360564,4,2,2,1
nipunn,1500.0,209.663360564,4,2,2,1
cruz,1500.0,182.111394518,6,3,3,1
jabroni,1500.0,209.436684378,4,2,2,1
zaaa,1500.0,209.663360564,4,2,2,1
loafers,1500.0,208.982594402,4,2,2,1
big huge man,1500.0,209.663360564,4,2,2,1
eiyuu,1500.0,209.663360564,4,2,2,1
slappy,1500.0,209.436684378,4,2,2,1
merc,1500.0,209.663360564,4,2,2,1
andymosity,1500.0,209.663360564,4,2,2,1
trevarthepastor,1500.0,208.573068163,4,2,2,1
fredricoswe,1500.0,182.528244426,6,3,3,1
layabout,1500.0,182.528244426,13,8,5,2
whiskeyd,1500.0,209.028047791,4,2,2,1
marbleblaster,1500.0,208.800681903,4,2,2,1
matticus,1500.0,209.663360564,4,2,2,1
reubthedoob,1500.0,209.255166634,4,2,2,1
dmac,1500.0,253.570659553,2,1,1,1
hotlineching,1500.0,209.663360564,4,2,2,1
griff the jiff,1500.0,209.663360564,4,2,2,1
mystery,1500.0,208.937131126,4,2,2,1
db,1500.0,208.937131126,4,2,2,1
liz,1500.0,208.937131126,4,2,2,1
lostluggage256,1500.0,209.663360564,4,2,2,1
typicalbad,1500.0,209.663360564,4,2,2,1
lildragon,1500.0,208.800681903,4,2,2,1
big guy,1500.0,208.937131126,4,2,2,1
raisin bran,1500.0,209.255166634,4,2,2,1
furb,1500.0,209.436684378,4,2,2,1
robby,1500.0,209.663360564,4,2,2,1
tid,1500.0,209.663360564,4,2,2,1
blinkrider,1500.0,208.982594402,4,2,2,1
grapefruit,1500.0,209.255166634,10,4,6,2
jekyll,1500.0,209.663360564,4,2,2,1
ot eric,1500.0,209.255166634,4,2,2,1
smiles,1500.0,253.982439129,2,1,1,1
caivs,1500.0,209.663360564,4,2,2,1
astropancakes,1500.0,209.663360564,4,2,2,1
coin,1500.0,208.800681903,4,2,2,1
daicko,1500.0,209.663360564,4,2,2,1
rabit,1500.0,208.937131126,4,2,2,1
dcap,1500.0,209.663360564,4,2,2,1
mamu,1500.0,209.436684378,4,2,2,1
mr. biz,1500.0,209.663360564,4,2,2,1
imnotgood,1500.0,209.663360564,4,2,2,1
pimp jong illest,1500.0,182.632308241,6,3,3,1
ziggy,1500.0,182.111394518,6,3,3,1
padoki,1500.0,163.921871694,8,4,4,1
bortogo,1500.0,208.937131126,4,2,2,1
tah.,1500.0,209.436684378,4,2,2,1
kali,1500.0,209.663360564,4,2,2,1
cpwho,1500.0,209.663360564,4,2,2,1
joseluisasdfg,1500.0,182.528244426,6,3,3,1
aeiou,1500.0,209.663360564,4,2,2,1
tr0y,1500.0,209.663360564,4,2,2,1
batistay,1500.0,209.663360564,4,2,2,1
sleeves,1500.0,209.436684378,4,2,2,1
akared,1500.0,209.663360564,4,2,2,1
dr.shots,1500.0,209.255166634,4,2,2,1
eater,1500.0,209.663360564,4,2,2,1
vomjom,1500.0,209.663360564,4,2,2,1
digg,1500.0,209.663360564,4,2,2,1
mcnutly,1500.0,209.436684378,4,2,2,1
vitamind,1500.0,209.663360564,4,2,2,1
lada,1500.0,209.663360564,4,2,2,1
e.t.,1500.0,209.663360564,4,2,2,1
tuff,1500.0,209.663360564,4,2,2,1
tom,1500.0,164.153428794,8,4,4,2
cyan,1500.0,209.255166634,4,2,2,1
tars,1500.0,209.663360564,4,2,2,1
ryanlightman,1500.0,209.255166634,4,2,2,1
fiction,1500.0,182.632308241,6,3,3,1
fiercekyo,1500.0,209.663360564,4,2,2,1
lilypad,1500.0,208.800681903,10,5,5,2
maher,1500.0,209.255166634,4,2,2,1
hoogie,1500,350,4,2,2,1
pwof,1500,350,6,4,2,1
pripps,1500,350,10,7,3,1
lactose lad,1500,350,4,0,4,1
cyr,1500,350,13,11,2,1
luckerdog,1500,350,6,2,4,1
one punch van,1500,350,0,0,0,1
bride,1500,350,7,0,7,1
jiffy,1500,350,3,1,2,1
ezryph,1500,350,0,0,0,1
octomom,1500,350,0,0,0,1
questcake,1500,350,4,2,2,1
gaussbet,1500,350,7,5,2,1
mozey,1500,350,4,0,4,1
wills,1500,350,5,3,2,1
shufu,1500,350,7,4,3,1
nagatocchi,1500,350,3,1,2,1
it's a wonderful world,1500,350,6,4,2,1
fenlet,1500,350,3,1,2,1
nero,1500,350,2,0,2,1
mini,1500,350,7,3,4,1
nars,1500,350,4,2,2,1
sappy,1500,350,6,0,6,1
franknbean,1500,350,3,1,2,1
bison.m,1500,350,4,2,2,1
jaxin,1500,350,5,3,2,1
destinite,1500,350,3,1,2,1
rashattack,1500,350,6,4,2,1
ben,1500,350,7,3,4,1
slow,1500,350,5,3,2,1
smashdad,1500,350,4,2,2,1
zora,1500,350,3,1,2,1
kellner,1500,350,11,9,2,1
moby,1500,350,7,2,5,1
zerthex,1500,350,2,0,2,1
pjon,1500,350,6,1,5,1
missing,1500,350,3,1,2,1
stonerocks,1500,350,3,1,2,1
dogcopter,1500,350,2,0,2,1
mint,1500,350,12,10,2,1
seen,1500,350,6,3,3,1
revelation,1500,350,2,0,2,1
dankiel,1500,350,3,1,2,1
naru,1500,350,7,5,2,1
fieryvale47,1500,350,2,0,2,1
glitch,1500,350,7,3,4,1
nextile,1500,350,2,0,2,1
10quidshoes,1500,350,4,0,4,1
jbiz,1500,350,2,0,2,1
2salty,1500,350,2,0,2,1
willy,1500,350,11,9,2,1
dankasswondergimps,1500,350,0,0,0,1
yaruzu,1500,350,6,2,4,1
itrez,1500,350,2,0,2,1
karma (jp),1500,350,10,4,6,1
munki,1500,350,7,0,7,1
boz,1500,350,6,3,3,1
strangersa,1500,350,7,5,2,1
vanna,1500,350,4,2,2,1
leomeror,1500,350,6,1,5,1
jedisalazar,1500,350,0,0,0,1
galaxy idol,1500,350,4,0,4,1
jrhmz,1500,350,7,1,6,1
t-rekt,1500,350,3,1,2,1
mattyice,1500,350,6,4,2,1
harriet,1500,350,5,3,2,1
bakon,1500,350,3,1,2,1
vierance,1500,350,6,2,4,1
rockcrock,1500,350,8,5,3,1
unhaven,1500,350,8,5,3,1
amnesiac,1500,350,6,3,3,1
scribble,1500,350,7,5,2,1
nishi,1500,350,0,0,0,1
passa,1500,350,7,3,4,1
teriyaki weeaboo,1500,350,2,0,2,1
ramon,1500,350,12,10,2,1
lord.ape.69,1500,350,7,1,6,1
galaxy heart,1500,350,7,2,5,1
carpenter,1500,350,0,0,0,1
kaizen,1500,350,4,2,2,1
takedown53,1500,350,4,2,2,1
nuisance,1500,350,0,0,0,1
dusttin,1500,350,0,0,0,1
domsta,1500,350,2,0,2,1
ironchef,1500,350,3,1,2,1
osp975,1500,350,2,0,2,1
fuzyll,1500,350,2,0,2,1
munx,1500,350,7,2,5,1
auxv,1500,350,7,3,4,1
deku_don,1500,350,7,1,6,1
freed00m,1500,350,6,3,3,1
dacacia,1500,350,9,5,4,1
benguin,1500,350,2,0,2,1
bom,1500,350,2,0,2,1
steele,1500,350,2,0,2,1
altodor,1500,350,5,3,2,1
candyman,1500,350,2,0,2,1
trekt,1500,350,3,1,2,1
desolation,1500,350,4,2,2,1
luk,1500,350,8,5,3,1
nasty$lckback,1500,350,3,1,2,1
ladz,1500,350,7,3,4,1
frankie,1500,350,6,2,4,1
nickelsclam,1500,350,4,2,2,1
pasi,1500,350,11,9,2,1
binxxx,1500,350,3,1,2,1
cohenski,1500,350,6,4,2,1
harmonics,1500,350,3,1,2,1
taters,1500,350,6,2,4,1
kälte,1500,350,3,1,2,1
fool94,1500,350,2,0,2,1
murky,1500,350,3,1,2,1
maz,1500,350,6,2,4,1
swan,1500,350,7,1,6,1
baj,1500,350,6,4,2,1
jooce,1500,350,7,3,4,1
wheat,1500,350,5,3,2,1
commander ice,1500,350,6,1,5,1
reek,1500,350,7,0,7,1
proto,1500,350,6,2,4,1
limez,1500,350,6,3,3,1
sweaty slowpoke,1500,350,7,3,4,1
kayko,1500,350,5,3,2,1
shake,1500,350,2,1,1,1
fde,1500,350,0,0,0,1
mediocre,1500,350,4,2,2,1
jonpon,1500,350,2,0,2,1
tkoverkill,1500,350,3,1,2,1
makno,1500,350,0,0,0,1
memo,1500,350,6,4,2,1
pazuzu,1500,350,7,3,4,1
sunrisebanana,1500,350,7,3,4,1
guwop,1500,350,7,2,5,1
chinmi,1500,350,7,2,5,1
spence,1500,350,3,1,2,1
saint shaden,1500,350,3,1,2,1
sizzler,1500,350,3,1,2,1
metafalo,1500,350,7,4,3,1
kebin,1500,350,3,1,2,1
the running banana,1500,350,2,0,2,1
sto0fo0,1500,350,3,1,2,1
cco,1500,350,6,2,4,1
broshadian,1500,350,6,2,4,1
launders,1500,350,7,3,4,1
scooty booty man,1500,350,7,4,3,1
noscrubuk,1500,350,7,2,5,1
falumps,1500,350,7,3,4,1
omar,1500,350,2,0,2,1
ningildo,1500,350,7,3,4,1
xychojack,1500,350,7,0,7,1
tfu,1500,350,7,5,2,1
tempestpeak,1500,350,7,3,4,1
gawes,1500,350,5,3,2,1
dro,1500,350,4,2,2,1
mouse shampoo,1500,350,4,2,2,1
exoty,1500,350,3,1,2,1
mike g,1500,350,8,5,3,1
kune,1500,350,7,2,5,1
bmgz,1500,350,7,3,4,1
tina,1500,350,6,3,3,1
idk,1500,350,5,3,2,1
shyseven,1500,350,2,0,2,1
noble,1500,350,3,1,2,1
wreck,1500,350,4,2,2,1
msbach,1500,350,0,0,0,1
amitwin,1500,350,7,1,6,1
doommasterofdoom,1500,350,6,1,5,1
cdrom,1500,350,3,1,2,1
syix,1500,350,2,0,2,1
patchy knowly,1500,350,7,0,7,1
shah,1500,350,7,1,6,1
eviox,1500,350,3,1,2,1
ook!,1500,350,7,4,3,1
dog,1500,350,5,3,2,1
blitz,1500,350,6,3,3,1
soup,1500,350,5,1,4,1
working class hero,1500,350,5,3,2,1
mcswanky,1500,350,4,2,2,1
ricky jo,1500,350,2,0,2,1
huskygamer,1500,350,6,3,3,1
affirmative action,1500,350,5,3,2,1
renshai,1500,350,0,0,0,1
cubansandwich,1500,350,5,3,2,1
krono,1500,350,6,2,4,1
silentwah,1500,350,5,3,2,1
karhu,1500,350,7,3,4,1
maskproducer,1500,350,4,2,2,1
burr,1500,350,5,3,2,1
ozp,1500,350,2,0,2,1
syrup,1500,350,3,1,2,1
moonshine,1500,350,2,0,2,1
a1-ex,1500,350,3,1,2,1
owls,1500,350,3,1,2,1
jinzo,1500,350,1,0,1,1
apop99,1500,350,2,0,2,1
jjjlad,1500,350,4,2,2,1
candlefire,1500,350,0,0,0,1
kimosabae,1500,350,2,0,2,1
derdian,1500,350,5,3,2,1
implix,1500,350,7,3,4,1
kau,1500,350,3,1,2,1
synaspe,1500,350,9,5,4,1
thedoc,1500,350,6,2,4,1
notorious,1500,350,0,0,0,1
ceo,1500,350,2,0,2,1
le toucan,1500,350,3,1,2,1
blazza,1500,350,7,0,7,1
stretch armstrong,1500,350,7,2,5,1
smokin' penelope,1500,350,4,2,2,1
eric,1500,350,11,7,4,1
theworst,1500,350,7,2,5,1
yiivo,1500,350,7,3,4,1
sorzan,1500,350,3,1,2,1
drolian,1500,350,9,6,3,1
eoe,1500,350,4,0,4,1
iblis,1500,350,7,4,3,1
astra,1500,350,2,0,2,1
11 - 9 grabs,1500,350,4,2,2,1
frozenlight1337,1500,350,18,14,4,2
hy,1500,350,7,3,4,1
papakek,1500,350,6,1,5,1
gg,1500,350,7,4,3,1
johan green,1500,350,7,2,5,1
kem0therapy,1500,350,2,0,2,1
fro fo sho,1500,350,4,2,2,1
briefs,1500,350,8,3,5,1
excal,1500,350,7,5,2,1
syntax,1500,350,1,0,1,1
hairybeast,1500,350,7,2,5,1
| porkchops,1500,350,8,5,3,1
giantsquidtech,1500,350,7,2,5,1
elemental,1500,350,3,1,2,1
trickyjeff,1500,350,4,2,2,1
the piledriver,1500,350,3,1,2,1
huck,1500,350,2,0,2,1
meth,1500,350,7,0,7,1
marteeen,1500,350,6,0,6,1
septagons,1500,350,3,1,2,1
polychrome,1500,350,6,3,3,1
jellyman64,1500,350,2,0,2,1
tracer,1500,350,3,1,2,1
weon-x,1500,350,0,0,0,1
bgsatchel,1500,350,4,2,2,1
captain ireland,1500,350,7,0,7,1
kug,1500,350,6,2,4,1
angelaanaconda,1500,350,0,0,0,1
generalred,1500,350,3,1,2,1
samadisafadi,1500,350,2,0,2,1
crabby,1500,350,2,0,2,1
a4nd,1500,350,0,0,0,1
mom [jamerson],1500,350,0,0,0,1
quesalupa,1500,350,2,0,2,1
squeachu,1500,350,7,3,4,1
maverlck21,1500,350,3,0,3,1
ramblingjosh,1500,350,6,2,4,1
dirty lasagna,1500,350,4,2,2,1
clifford,1500,350,3,1,2,1
carlito,1500,350,4,2,2,1
mokocchi,1500,350,3,1,2,1
ocelot,1500,350,2,0,2,1
nilesly,1500,350,3,1,2,1
emukiller,1500,350,6,4,2,1
ducker,1500,350,7,2,5,1
mumb0 jumb0,1500,350,2,0,2,1
ares,1500,350,13,11,2,1
demodairy,1500,350,2,0,2,1
crab master race,1500,350,4,0,4,1
sayle,1500,350,4,0,4,1
christian,1500,350,6,4,2,1
nwa,1500,350,0,0,0,1
renegade!,1500,350,3,1,2,1
kdxkdot,1500,350,2,0,2,1
elfonzio,1500,350,2,0,2,1
sono,1500,350,7,3,4,1
burrhe,1500,350,7,3,4,1
thecrimsonblur,1500,350,0,0,0,1
lumi,1500,350,7,3,4,1
rob$,1500,350,5,3,2,1
jessi snow,1500,350,2,0,2,1
ruffian,1500,350,3,1,2,1
darkshadowed,1500,350,3,1,2,1
dembo,1500,350,3,1,2,1
zoso,1500,350,2,0,2,1
pisces,1500,350,3,1,2,1
admj,1500,350,3,1,2,1
dr. avis,1500,350,0,0,0,1
moone,1500,350,7,0,7,1
zeek,1500,350,2,0,2,1
na5h,1500,350,2,0,2,1
fawlty,1500,350,7,0,7,1
meisterjäger77,1500,350,7,5,2,1
whales,1500,350,3,1,2,1
visuals,1500,350,2,0,2,1
rach,1500,350,9,6,3,1
s.k.a.n. the scrub,1500,350,2,0,2,1
aozorax,1500,350,6,4,2,1
shockjock,1500,350,3,1,2,1
ahmad,1500,350,7,4,3,1
mumbles,1500,350,7,2,5,1
hondo,1500,350,0,0,0,1
slik,1500,350,6,4,2,1
bzrk,1500,350,7,5,2,1
ferox,1500,350,8,2,6,1
follow,1500,350,7,3,4,1
ilskowa,1500,350,3,1,2,1
ale,1500,350,2,0,2,1
ali,1500,350,7,4,3,1
jeez,1500,350,2,0,2,1
wifl,1500,350,2,0,2,1
ghoti,1500,350,3,1,2,1
sleepywaifu,1500,350,7,0,7,1
gorbo,1500,350,7,3,4,1
thunderchunkie,1500,350,3,1,2,1
tm12,1500,350,5,3,2,1
can~d,1500,350,6,3,3,1
chrim foish,1500,350,0,0,0,1
a_e_d,1500,350,5,3,2,1
twentytwo,1500,350,0,0,0,1
star99,1500,350,3,1,2,1
t3nshi,1500,350,7,5,2,1
crashman,1500,350,6,3,3,1
geezaku,1500,350,7,4,3,1
beak,1500,350,2,0,2,1
stivo,1500,350,11,9,2,1
baron brody,1500,350,12,9,3,1
wex,1500,350,6,3,3,1
midori,1500,350,7,3,4,1
westbreezy,1500,350,3,1,2,1
sweet_lu,1500,350,3,1,2,1
paul,1500,350,7,1,6,1
niar,1500,350,6,1,5,1
kushty,1500,350,7,1,6,1
ebola,1500,350,6,4,2,1
sorrus,1500,350,3,1,2,1
powe,1500,350,7,4,3,1
swordz,1500,350,2,0,2,1
saucytho,1500,350,4,2,2,1
sinbad,1500,350,8,5,3,1
proga,1500,350,2,0,2,1
zayas,1500,350,3,1,2,1
mad4men,1500,350,7,3,4,1
elili,1500,350,6,3,3,1
kyball,1500,350,4,2,2,1
aska,1500,350,7,4,3,1
anvil,1500,350,6,2,4,1
2k12,1500,350,7,2,5,1
cruz control,1500,350,5,3,2,1
vega,1500,350,2,0,2,1
cheakiwara,1500,350,7,4,3,1
jyrow,1500,350,6,2,4,1
halfrican,1500,350,3,1,2,1
sickroy,1500,350,3,1,2,1
locke,1500,350,5,3,2,1
prinny,1500,350,3,1,2,1
kiddo,1500,350,3,1,2,1
electric,1500,350,7,1,6,1
tgbd,1500,350,7,0,7,1
umeki,1500,350,2,0,2,1
b-millz,1500,350,6,3,3,1
kdat,1500,350,2,0,2,1
whatmore,1500,350,7,2,5,1
indecisive,1500,350,5,1,4,1
abaasy,1500,350,3,1,2,1
gwabs,1500,350,5,3,2,1
linguini,1500,350,7,5,2,1
ustanak-rising,1500,350,2,0,2,1
pleb,1500,350,3,1,2,1
bullet bill,1500,350,7,5,2,1
vist,1500,350,0,0,0,1
chipgroove,1500,350,7,5,2,1
tomo,1500,350,7,0,7,1
kittymw,1500,350,0,0,0,1
arkada,1500,350,3,1,2,1
massive,1500,350,0,0,0,1
matchu,1500,350,6,4,2,1
wumpt,1500,350,7,1,6,1
mr flibble,1500,350,7,1,6,1
flaf,1500,350,3,1,2,1
dreamlad,1500,350,6,0,6,1
wiseclown,1500,350,4,2,2,1
winston churtrill,1500,350,7,3,4,1
mickey blue,1500,350,7,3,4,1
chucknasty,1500,350,3,1,2,1
bolder,1500,350,1,0,1,1
teach,1500,350,3,1,2,1
jonnyfox,1500,350,3,1,2,1
ayyolado,1500,350,2,0,2,1
robot owl,1500,350,3,1,2,1
nguyenning,1500,350,0,0,0,1
sgt. snuggles,1500,350,7,4,3,1
jonny,1500,350,2,0,2,1
kabs,1500,350,7,1,6,1
l3w!,1500,350,6,3,3,1
c15,1500,350,2,0,2,1
Pi,1500,350,7,1,6,1
alextheant,1500,350,7,3,4,1
jexal,1500,350,7,2,5,1
rechen,1500,350,7,4,3,1
lalzu,1500,350,7,2,5,1
joey bag o' donuts,1500,350,2,0,2,1
independent,1500,350,4,2,2,1
chezz,1500,350,4,2,2,1
nasan,1500,350,3,1,2,1
skydragon,1500,350,6,3,3,1
avester,1500,350,3,1,2,1
puppy,1500,350,3,1,2,1
pantsless,1500,350,7,3,4,1
design out of shield,1500,350,7,1,6,1
212 degrees,1500,350,3,1,2,1
master brawler,1500,350,2,0,2,1
fury,1500,350,0,0,0,1
nathan,1500,350,3,1,2,1
sickolas,1500,350,5,3,2,1
enigma,1500,350,10,1,9,2
equi,1500,350,0,0,0,1
tektite,1500,350,7,3,4,1
inferno bop,1500,350,6,2,4,1
cpu,1500,350,2,0,2,1
chuman,1500,350,6,0,6,1
pengie,1500,350,7,4,3,1
exo,1500,350,3,1,2,1
cyclops,1500,350,7,1,6,1
schwifty,1500,350,7,4,3,1
thoth,1500,350,7,3,4,1
cogfist,1500,350,7,3,4,1
ac,1500,350,7,5,2,1
ad,1500,350,3,1,2,1
johnny,1500,350,2,0,2,1
stowaway,1500,350,7,0,7,1
frio,1500,350,2,0,2,1
ballz d33p,1500,350,2,0,2,1
phoenix2448,1500,350,3,1,2,1
mystic_mane,1500,350,3,1,2,1
jon carr,1500,350,2,0,2,1
rayburn,1500,350,5,3,2,1
harrisondorf,1500,350,2,0,2,1
plum,1500,350,11,9,2,2
jbomb,1500,350,6,4,2,1
duke,1500,350,2,0,2,1
kirito green,1500,350,3,1,2,1
testament,1500,350,7,5,2,1
miggs,1500,350,3,1,2,1
kiisu,1500,350,5,1,4,1
vsc al_bouggie,1500,350,2,0,2,1
r0cky,1500,350,2,0,2,1
chillypotpie,1500,350,6,4,2,1
30lb,1500,350,6,3,3,1
jtrig,1500,350,7,2,5,1
srd_javi,1500,350,4,2,2,1
andyboy,1500,350,6,3,3,1
creature,1500,350,5,3,2,1
terb,1500,350,7,3,4,1
vii,1500,350,2,0,2,1
dilly,1500,350,3,1,2,1
tony hawk,1500,350,2,0,2,1
ponski,1500,350,7,3,4,1
zeruko,1500,350,4,0,4,1
nychee,1500,350,2,0,2,1
sonnen,1500,350,3,1,2,1
doon,1500,350,7,0,7,1
highwata,1500,350,7,3,4,1
raze,1500,350,3,1,2,1
taintedtriforce,1500,350,7,1,6,1
zettroxx,1500,350,11,9,2,1
ryzon,1500,350,7,3,4,1
the king,1500,350,3,1,2,1
n00b64,1500,350,6,0,6,1
sgtsalty,1500,350,7,1,6,1
icearrow,1500,350,3,1,2,1
1000,1500,350,6,3,3,1
resolute,1500,350,2,0,2,1
shulgin,1500,350,2,0,2,1
pancake,1500,350,7,1,6,1
dublin,1500,350,5,3,2,1
cyber,1500,350,3,1,2,1
baki,1500,350,3,1,2,1
trent,1500,350,7,5,2,1
bake,1500,350,3,1,2,1
hafwit,1500,350,3,1,2,1
thegood,1500,350,7,3,4,1
richard,1500,350,0,0,0,1
crb,1500,350,3,1,2,1
kirbyvert,1500,350,7,4,3,1
zectron,1500,350,2,0,2,1
moop,1500,350,6,2,4,1
dom dunc,1500,350,7,2,5,1
photon,1500,350,3,1,2,1
orz,1500,350,6,0,6,1
ketchupnmustard,1500,350,2,0,2,1
jntabeast,1500,350,4,2,2,1
orin,1500,350,6,3,3,1
brownthumb,1500,350,7,2,5,1
marquee,1500,350,6,4,2,1
cdoe,1500,350,6,4,2,1
pop$,1500,350,6,4,2,1
badnight,1500,350,7,3,4,1
nicthekiwi,1500,350,4,2,2,1
bocaj,1500,350,7,2,5,1
young craig,1500,350,2,0,2,1
diabetodan,1500,350,2,0,2,1
acurutax,1500,350,7,5,2,1
pootrain,1500,350,7,0,7,1
rampage,1500,350,7,2,5,1
jeffz0r,1500,350,7,4,3,1
shken,1500,350,0,0,0,1
k1ngcr0w,1500,350,3,1,2,1
_milktea,1500,350,5,3,2,1
miko$,1500,350,7,3,4,1
kyran,1500,350,7,3,4,1
geobreaker,1500,350,7,3,4,1
hobowolf,1500,350,7,1,6,1
millsipan,1500,350,5,3,2,1
bloodzure,1500,350,2,0,2,1
dunch,1500,350,7,3,4,1
yeezy,1500,350,7,1,6,1
j$727,1500,350,4,2,2,1
leftover rice,1500,350,4,2,2,1
waytoopro,1500,350,2,0,2,1
trail,1500,350,7,3,4,1
gzlrgzlr,1500,350,3,1,2,1
the amazing busterino,1500,350,0,0,0,1
itsadair,1500,350,3,1,2,1
chav,1500,350,7,4,3,1
apm,1500,350,7,0,7,1
starko,1500,350,7,1,6,1
beachmaster,1500,350,5,3,2,1
keenan,1500,350,4,2,2,1
fearless,1500,350,6,4,2,1
louis dk,1500,350,0,0,0,1
mineshaft798,1500,350,2,0,2,1
sharkboi,1500,350,0,0,0,1
lguy,1500,350,10,7,3,1
henley,1500,350,4,0,4,1
rossu,1500,350,2,0,2,1
candyman!,1500,350,3,1,2,1
saltsheikah,1500,350,7,2,5,1
makko_slade,1500,350,2,0,2,1
ezan,1500,350,7,4,3,1
hen,1500,350,10,7,3,1
nanaba,1500,350,7,3,4,1
0xyswag,1500,350,3,1,2,1
bozy,1500,350,6,3,3,1
spiderhater,1500,350,7,3,4,1
sea,1500,350,2,0,2,1
craft,1500,350,10,7,3,1
poe,1500,350,4,2,2,1
samplay,1500,350,12,10,2,1
stockholmsyndrome,1500,350,4,2,2,1
butterlord,1500,350,7,3,4,1
picky,1500,350,7,4,3,1
swagbag,1500,350,2,0,2,1
donny p.,1500,350,4,2,2,1
voo,1500,350,6,4,2,1
v01d,1500,350,7,5,2,1
4orty,1500,350,6,3,3,1
harvey wallbanger,1500,350,7,2,5,1
bladeless,1500,350,6,2,4,1
50k!,1500,350,2,0,2,1
dr. phil,1500,350,3,1,2,1
yandere tet$uo,1500,350,10,4,6,1
djoy,1500,350,3,1,2,1
hayatoxx,1500,350,0,0,0,2
ak47,1500,350,6,3,3,1
quodan,1500,350,7,0,7,1
monkee,1500,350,6,2,4,1
warriorknight,1500,350,7,4,3,1
awsmsean,1500,350,0,0,0,1
kaike,1500,350,6,4,2,1
post,1500,350,2,0,2,1
bqck,1500,350,7,0,7,1
le fou,1500,350,5,3,2,1
wobbaduck,1500,350,6,2,4,1
bonntoes,1500,350,7,3,4,1
x1,1500,350,8,5,3,1
brado,1500,350,7,5,2,1
m o o n m a n,1500,350,7,1,6,1
gsk8,1500,350,6,1,5,1
brimiq,1500,350,3,1,2,1
okameed,1500,350,7,4,3,1
crash,1500,350,6,2,4,1
killua,1500,350,3,1,2,1
oddomattx,1500,350,3,1,2,1
fisheatcorn,1500,350,8,5,3,1
leck,1500,350,10,7,3,1
firenze,1500,350,3,1,2,1
pistallion,1500,350,0,0,0,1
sasquach,1500,350,6,2,4,1
exbanditzero,1500,350,6,4,2,1
stngr,1500,350,6,3,3,1
biggs,1500,350,6,0,6,1
swampy,1500,350,3,1,2,1
zarlen,1500,350,4,2,2,1
sonsofsparda,1500,350,7,1,6,1
jjlinyard,1500,350,7,4,3,1
oc zack,1500,350,6,4,2,1
cptnebula,1500,350,7,5,2,1
young thug is a legend,1500,350,6,4,2,1
badlands,1500,350,6,2,4,1
amcd,1500,350,7,5,2,1
tommy,1500,350,0,0,0,1
way,1500,350,11,9,2,1
dev,1500,350,13,11,2,1
mcbabe,1500,350,6,0,6,1
manon,1500,350,7,3,4,1
up-besus,1500,350,0,0,0,1
joebags,1500,350,3,1,2,1
johnjohn,1500,350,0,0,0,1
hallow,1500,350,2,0,2,1
guin,1500,350,7,0,7,1
c^2,1500,350,1,0,1,1
debo,1500,350,6,3,3,1
king momo,1500,350,6,4,2,1
klabautermann,1500,350,6,3,3,1
ta wolf,1500,350,5,3,2,1
herrok,1500,350,7,5,2,1
darkrain,1500,350,0,0,0,1
jayb,1500,350,6,1,5,1
silentswag,1500,350,0,0,0,1
jbgood,1500,350,7,0,7,1
germ,1500,350,0,0,0,1
aileron,1500,350,2,0,2,1
sheepdog,1500,350,2,0,2,1
blueman,1500,350,7,3,4,1
colonel claw,1500,350,2,0,2,1
express,1500,350,2,0,2,1
perciprius,1500,350,2,0,2,1
cylinder,1500,350,8,2,6,1
yellowbob0,1500,350,7,3,4,1
downaironly,1500,350,4,2,2,1
thc,1500,350,7,3,4,1
focus miss,1500,350,7,0,7,1
kepa,1500,350,2,0,2,1
prinz,1500,350,12,10,2,1
golly,1500,350,3,1,2,1
xversusz,1500,350,7,2,5,1
horus,1500,350,3,1,2,1
vitamin a,1500,350,4,0,4,1
droblexero,1500,350,7,3,4,1
indie_dave,1500,350,0,0,0,1
jrrd,1500,350,2,0,2,1
a.c.o.,1500,350,3,1,2,1
kitanamonk,1500,350,7,5,2,1
brett3,1500,350,0,0,0,1
dr. acula zx,1500,350,3,1,2,1
smo,1500,350,6,0,6,1
epicramen,1500,350,3,1,2,1
smeuh,1500,350,7,1,6,1
fuddyduddy,1500,350,7,5,2,1
asuka!,1500,350,5,3,2,1
thad,1500,350,5,3,2,2
skaterdude,1500,350,3,1,2,1
friend,1500,350,7,5,2,1
deathorse,1500,350,7,3,4,1
sosuk,1500,350,7,5,2,1
kujo~,1500,350,0,0,0,1
ober,1500,350,4,2,2,1
lultam,1500,350,7,4,3,1
blink,1500,350,3,1,2,1
captain_hawaiian,1500,350,7,1,6,1
laurster,1500,350,10,7,3,1
dwhatever,1500,350,7,2,5,1
ez,1500,350,3,1,2,1
griz,1500,350,2,0,2,1
mop,1500,350,4,2,2,1
lean,1500,350,5,3,2,1
makenshi,1500,350,11,9,2,1
baldr,1500,350,6,2,4,1
tortellini tyler,1500,350,3,1,2,1
metal gear salad,1500,350,6,2,4,1
pachakamakk,1500,350,7,4,3,1
bragia,1500,350,7,2,5,1
invkrmainr,1500,350,7,5,2,1
broasty,1500,350,3,1,2,1
chewy,1500,350,4,2,2,1
molten,1500,350,7,2,5,1
boggle,1500,350,7,2,5,1
soniike,1500,350,10,7,3,1
doritocrumbman,1500,350,3,1,2,1
lovedelic,1500,350,2,0,2,1
voltampt,1500,350,9,4,5,1
clickclack,1500,350,0,0,0,1
sirjosh,1500,350,3,1,2,1
monkeymut,1500,350,7,2,5,1
starman,1500,350,5,3,2,1
izek,1500,350,10,8,2,1
koop,1500,350,7,3,4,1
angelfail,1500,350,9,6,3,1
jomo,1500,350,5,3,2,1
jmg,1500,350,10,7,3,1
supervacilon,1500,350,7,4,3,1
narps,1500,350,6,4,2,1
chaler,1500,350,7,1,6,1
matador,1500,350,7,1,6,1
ytry,1500,350,0,0,0,1
angelo,1500,350,6,2,4,1
bbq,1500,350,6,4,2,1
diamond zero,1500,350,7,1,6,1
suey,1500,350,4,0,4,1
santieur52,1500,350,7,1,6,1
fp9,1500,350,6,0,6,1
colinfly,1500,350,2,0,2,1
dp's mario,1500,350,6,4,2,1
slhoka,1500,350,7,3,4,1
cochise,1500,350,6,3,3,1
demo_d,1500,350,7,5,2,1
milk $$$,1500,350,0,0,0,1
the fractal effect,1500,350,2,0,2,1
banbang,1500,350,7,2,5,1
shiara,1500,350,7,0,7,1
idris,1500,350,0,0,0,1
yami,1500,350,4,2,2,1
freeze!,1500,350,0,0,0,1
supra,1500,350,2,0,2,1
fraudzilla,1500,350,2,0,2,1
type1,1500,350,7,5,2,1
aoe,1500,350,3,1,2,1
smoof,1500,350,3,1,2,1
lela,1500,350,7,3,4,1
fil,1500,350,4,2,2,1
brokenyew,1500,350,8,5,3,1
mr. clean,1500,350,0,0,0,2
marhda,1500,350,7,0,7,1
jambon,1500,350,7,4,3,1
quasarwolf,1500,350,2,0,2,1
laine,1500,350,2,0,2,1
symptomized,1500,350,6,3,3,1
rstevoa,1500,350,2,0,2,1
jibril cameron tomaz,1500,350,7,5,2,1
emo,1500,350,2,0,2,1
xbeke,1500,350,3,1,2,1
furta,1500,350,6,4,2,1
cosmicswagdaddy,1500,350,3,0,3,1
mordo,1500,350,7,3,4,1
zane,1500,350,0,0,0,1
thebabycheese,1500,350,7,3,4,1
chinaux,1500,350,2,0,2,1
articanus,1500,350,9,6,3,2
kadano,1500,350,10,7,3,1
talos,1500,350,2,0,2,1
lymp,1500,350,6,2,4,1
zhao_guang,1500,350,9,3,6,1
cpt.zeppo,1500,350,9,5,4,1
racci,1500,350,3,1,2,1
chain,1500,350,7,3,4,1
origamisalami,1500,350,5,3,2,1
toadee,1500,350,7,4,3,1
smash_falco3,1500,350,7,3,4,1
l.k.,1500,350,7,3,4,1
whitemare,1500,350,6,1,5,1
dansdaman,1500,350,6,4,2,1
frardvark,1500,350,2,0,2,1
dawangthang,1500,350,2,0,2,1
jabs,1500,350,4,2,2,1
-1up,1500,350,3,1,2,1
repsguy,1500,350,2,0,2,1
papa,1500,350,0,0,0,1
lad,1500,350,5,3,2,1
fap,1500,350,2,0,2,1
nombre,1500,350,6,3,3,1
| straywolf,1500,350,4,1,3,1
icysummers,1500,350,7,0,7,1
steav,1500,350,7,1,6,1
aiika,1500,350,7,3,4,1
clemens,1500,350,10,8,2,1
masterbravo,1500,350,5,3,2,1
krudo,1500,350,7,5,2,1
boback,1500,350,0,0,0,1
dosrogers,1500,350,0,0,0,1
warui,1500,350,3,1,2,1
yert,1500,350,3,1,2,1
bang,1500,350,2,0,2,1
glistening,1500,350,2,0,2,1
whack,1500,350,2,0,2,1
emk,1500,350,7,3,4,1
minubrute,1500,350,6,1,5,1
jdb!,1500,350,3,1,2,1
lucas anderson,1500,350,6,2,4,1
fake,1500,350,6,2,4,1
infamousneon,1500,350,7,2,5,1
cypherzel,1500,350,7,1,6,1
crusifix,1500,350,5,3,2,1
reb,1500,350,7,4,3,1
pugmug,1500,350,7,4,3,1
shekler,1500,350,3,1,2,1
air conditioner,1500,350,4,2,2,1
youma,1500,350,6,4,2,1
lordtoko,1500,350,0,0,0,1
hitomi j puff,1500,350,2,0,2,1
stan sasquatch,1500,350,6,2,4,1
juicymoose,1500,350,2,0,2,1
captain blowjob,1500,350,7,2,5,1
sr-cue,1500,350,6,4,2,1
squidoo,1500,350,3,1,2,1
dragonfly,1500,350,6,2,4,1
styx,1500,350,2,0,2,1
who?,1500,350,5,3,2,1
gcs,1500,350,7,5,2,1
thelake,1500,350,0,0,0,1
shade_hr,1500,350,6,3,3,1
aiken,1500,350,7,4,3,1
hentaiking420,1500,350,7,2,5,1
sigh,1500,350,5,3,2,1
the rock,1500,350,2,0,2,1
kw/ak,1500,350,3,1,2,1
euo,1500,350,7,1,6,1
redslasher,1500,350,7,0,7,1
turtleclub,1500,350,6,3,3,1
bronze,1500,350,2,0,2,1
oldmiat,1500,350,0,0,0,1
dax,1500,350,5,3,2,1
mgmg,1500,350,10,5,5,1
mach,1500,350,7,3,4,1
wingus,1500,350,7,4,3,1
looman,1500,350,7,5,2,1
not.brian,1500,350,5,3,2,1
lemon,1500,350,3,1,2,1
cud,1500,350,7,0,7,1
bobby,1500,350,7,4,3,1
tp_fosho,1500,350,3,1,2,1
kiw1,1500,350,11,9,2,1
mr.anderson,1500,350,6,4,2,1
carmo,1500,350,6,2,4,1
wiggin,1500,350,0,0,0,1
diltune,1500,350,3,1,2,1
nahr,1500,350,3,1,2,1
guile,1500,350,6,2,4,1
mr.e [rohr],1500,350,0,0,0,1
supercat meow,1500,350,7,5,2,1
barraca,1500,350,3,1,2,1
vice,1500,350,5,3,2,1
dr. poonanny,1500,350,4,2,2,1
slagnarok,1500,350,7,2,5,1
hyprid,1500,350,11,6,5,1
baconhands,1500,350,7,0,7,1
octavian,1500,350,3,1,2,1
reverse,1500,350,9,3,6,1
zephyr,1500,350,7,4,3,1
alox,1500,350,13,11,2,1
whichkraft,1500,350,3,1,2,1
galapagos,1500,350,7,2,5,1
randellion,1500,350,2,0,2,1
ralphanese,1500,350,3,1,2,1
free stratos,1500,350,7,0,7,1
charon,1500,350,0,0,0,1
tempest tim,1500,350,2,0,2,1
uma,1500,350,5,3,2,1
alexis,1500,350,4,0,4,1
phat$$,1500,350,0,0,0,1
frames,1500,350,2,0,2,1
mbk,1500,350,7,1,6,1
biss,1500,350,7,3,4,1
kataquax,1500,350,7,2,5,1
drifter,1500,350,6,2,4,1
mcducky potatoes,1500,350,7,3,4,1
dp,1500,350,7,1,6,1
d$,1500,350,6,3,3,1
vgmasta,1500,350,4,2,2,1
fabio,1500,350,5,3,2,1
silenceghost,1500,350,3,1,2,1
thatkawaiiguy,1500,350,3,1,2,1
bigvic340,1500,350,3,1,2,1
raisin,1500,350,6,4,2,1
fluffylemons,1500,350,0,0,0,1
brochill,1500,350,3,1,2,1
takeshi,1500,350,2,0,2,1
onyx,1500,350,3,1,2,1
lockdown,1500,350,7,3,4,1
level 100 potato,1500,350,6,4,2,1
kdbt,1500,350,3,1,2,1
unvalued,1500,350,0,0,0,1
hoorayforjay,1500,350,9,5,4,1
theauthor,1500,350,2,0,2,1
warnine,1500,350,3,1,2,1
bdr,1500,350,7,5,2,1
duffo,1500,350,3,1,2,1
birdperson,1499.83761393,159.238770089,7,3,4,1
indy,1499.75423268,195.577553421,4,2,2,1
dmw,1499.63053909,183.163163575,6,3,3,2
kale,1499.62580226,164.318244375,8,4,4,2
housewife,1499.59976525,164.636107147,8,4,4,2
d,1499.42137325,151.074846539,10,5,5,2
raggebe,1499.14511073,132.655068351,12,6,6,2
young love,1498.94665736,173.762063802,6,3,3,1
slang blade,1498.89238452,169.839090887,7,4,3,1
risky,1498.64491742,196.960435245,4,2,2,1
sputo,1498.59117391,191.5319627,5,3,2,1
rucksack,1498.55580594,159.413524331,8,4,4,2
captain black,1498.52534019,143.778739038,8,4,4,2
gtea,1498.52388756,159.290764264,8,4,4,2
splendid,1498.37718025,192.119426376,4,2,2,1
cocothunder,1498.22548497,157.971849305,8,4,4,2
burgerdon,1498.15858916,106.824302051,19,9,10,4
hawk,1498.0181785,137.592286843,12,6,6,3
kilo,1497.95250118,170.038350703,7,4,3,2
uchihascar,1497.9472003,197.495210641,4,2,2,1
rose,1497.7246228,156.41945465,8,4,4,2
bernal,1497.58956873,163.990855938,6,3,3,1
d-frog,1497.53552967,147.708435313,14,7,7,3
mindlessperson,1497.43568325,198.953787794,4,2,2,1
typh,1497.28171113,194.040083171,4,2,2,1
naztoise,1497.24537314,167.724656149,6,3,3,1
ambisinister,1497.10378487,154.833673733,8,4,4,2
memory,1497.00051312,175.799716822,6,3,3,1
mox,1496.83219128,198.149462207,10,5,5,2
mr.stitch,1496.77200558,208.908108207,3,1,2,1
soap,1496.66657853,190.86000202,4,2,2,1
pipes,1496.65861927,177.528871892,5,3,2,1
jcpwn,1496.51054835,201.176638174,4,2,2,1
@ashkon_,1496.19236773,160.773649146,7,3,4,2
bumble,1496.11487725,199.950735032,4,2,2,1
hypnotoad,1496.11487725,200.140691614,4,2,2,1
chimera,1496.11487725,199.998241092,4,2,2,1
seo,1496.11487725,199.903217683,4,2,2,1
dr eggman,1496.11487725,200.472682528,4,2,2,1
ikkitrix,1496.11487725,199.808149083,4,2,2,1
holo,1496.11487725,199.808149083,4,2,2,1
aquamelen,1496.11487725,200.472682528,4,2,2,1
tred,1495.9934823,115.565940126,15,7,8,2
jnukes4jesus,1495.15314654,196.864981859,4,2,2,1
):,1495.12182532,144.50348784,10,5,5,2
blake,1495.12106145,187.593592552,4,2,2,1
mewwy,1495.06769268,167.237035559,7,3,4,2
cornbread,1494.99085425,214.10005467,4,2,2,2
ginta,1494.9823504,135.736934082,11,5,6,4
mang0jr,1494.82145873,202.534859246,4,2,2,1
texas techer,1494.82145873,202.90975632,4,2,2,1
red lego,1494.82145873,202.300195773,4,2,2,1
doodle dork,1494.82145873,202.628648542,4,2,2,1
silent,1494.82145873,202.675526914,4,2,2,1
double rainbow,1494.82145873,202.675526914,4,2,2,1
etai,1494.82145873,202.675526914,4,2,2,1
tiedyeguy,1494.80364131,213.490359367,3,1,2,1
asl,1494.75971049,159.471451308,7,4,3,1
doepp,1494.68941762,193.595340505,5,3,2,1
rh1thmz,1494.43901415,207.193204792,3,1,2,1
khale,1494.39850073,148.311547978,11,6,5,2
j-bear,1494.32516709,197.103803804,10,4,6,2
i-dog,1494.32516709,197.103803804,4,2,2,1
lillbaskern,1494.04851377,133.163310173,12,6,6,2
dank,1493.98269302,116.217848251,17,8,9,4
fats,1493.67965516,164.091267704,8,4,4,2
yalungur,1493.52964083,129.75382873,15,7,8,3
exotonic,1493.52944387,197.168337705,4,2,2,1
jkk,1493.40087902,200.622649865,4,2,2,1
shroudedone,1493.33332414,161.495325352,6,3,3,1
smashdaddy,1493.32555929,179.974868637,11,6,5,2
gibs,1493.23314122,208.98829893,4,2,2,1
f0xx #009,1493.18140494,197.925221388,4,2,2,1
nack,1493.01249214,197.389368772,4,2,2,1
firebolt,1493.00498858,152.480160676,8,4,4,1
shake_zula,1492.91013641,190.571613932,4,2,2,1
grape,1492.83518978,192.03767858,4,2,2,1
tdude51,1492.80004857,158.661277379,8,4,4,2
aaronscaring,1492.78009366,188.381288564,4,2,2,1
nuggetz,1492.45785207,201.12072853,4,2,2,1
cdrc^,1492.45785207,201.12072853,4,2,2,1
barry allen,1492.40398794,206.927003491,4,2,2,2
habi,1492.35047943,193.072299363,4,2,2,1
mf mike,1492.33225691,183.441107079,4,2,2,1
super^nova,1492.30143405,209.486703966,3,1,2,1
bloodhank,1492.21966632,200.660044245,4,2,2,1
iorissbm,1492.21966632,201.227367315,4,2,2,1
tieske,1492.20411752,202.409959164,4,2,2,1
minymidge,1492.04159646,191.28446986,4,2,2,1
ramrow,1492.0099568,159.377940038,8,4,4,2
snail6,1491.84560103,171.333903225,6,3,3,1
craig,1491.83071322,200.548230206,11,4,7,2
nibbity,1491.62982488,187.095486051,4,2,2,1
pewter,1491.56194475,194.49484063,4,2,2,1
jove,1491.47597617,193.656307642,4,2,2,1
12yearsdungeon,1491.46084076,199.641335842,4,2,2,1
aray,1491.36906678,187.633561925,4,2,2,1
shakedrizzle,1491.16953662,190.878333171,4,2,2,1
inzane,1490.81267084,198.670212579,4,2,2,1
travkid,1490.76746424,191.564989152,4,2,2,1
l33t,1490.73121619,188.484158289,4,2,2,1
toez,1490.67241207,201.880077307,4,2,2,1
mars,1490.66687175,130.203983137,12,6,6,2
chillheids,1490.42168474,198.195219994,4,2,2,1
iron,1490.3766765,201.247748261,4,2,2,1
flippy,1490.28777899,118.843170992,24,12,12,4
trak,1490.15012472,203.004659372,5,2,3,1
idkidc,1490.12021793,193.679196936,4,2,2,1
tengu,1490.1115283,177.291665319,7,3,4,1
drewzey,1490.10059095,105.792198382,21,11,10,4
herm,1490.08094234,157.301358536,8,4,4,1
purpleburd,1490.01852234,191.238197716,4,2,2,1
booty bandit,1490.0115003,211.7653616,3,1,2,1
klemes,1489.85101445,195.637785905,4,2,2,1
mpk,1489.83245244,176.698823123,6,3,3,1
trapsloth,1489.52767854,155.716178895,9,4,5,2
the yak,1489.02695366,169.671801491,6,3,3,1
big red,1488.92461926,239.631942457,2,1,1,1
greed,1488.90648627,163.178403734,6,3,3,1
fancy,1488.87455595,207.367033517,3,1,2,1
slock,1488.79047753,163.998529128,7,3,4,2
kerp,1488.77856825,194.330911928,4,2,2,1
hibbityhoopla,1488.59574887,203.179035386,4,2,2,1
saucetin,1488.42593472,191.261493305,4,2,2,1
theperfectname,1488.29856954,155.475117746,8,4,4,2
masterdong,1488.19283082,161.997010159,14,6,8,3
uncle carbuncle,1488.08854597,201.95824575,5,2,3,1
martel,1488.06692725,245.373502124,3,1,2,1
trusty bag,1487.88277604,173.677930233,6,3,3,1
darkstorm,1487.88277604,173.677930233,6,3,3,1
heck,1487.64781491,140.074496098,11,5,6,3
mooseeatsbear,1487.50667433,194.160231851,10,6,4,2
james landino,1487.43533714,158.301185217,8,4,4,2
kaizon,1487.35684884,195.607143682,4,2,2,1
mattan,1487.25667058,188.108343526,4,2,2,1
#80pprr8,1487.24775507,194.691277776,5,2,3,1
$wank,1486.93707081,98.7222128833,24,11,13,5
ark,1486.84910671,133.854760228,15,7,8,2
gelp,1486.81540564,139.971529975,12,6,6,3
jcubez,1486.73924686,177.369750497,5,3,2,1
racer,1486.66126933,199.980977354,4,2,2,1
golondrin,1486.57100026,229.306304033,3,1,2,1
jahanni,1486.53701615,132.624670683,12,6,6,2
lars,1486.4618571,178.690439374,7,3,4,2
rumi,1486.39789289,183.920820505,4,2,2,1
contra,1486.19427474,159.745051625,9,5,4,2
yoder,1486.16928945,176.690312915,7,3,4,2
loading...,1486.05772087,197.463170867,4,2,2,1
man,1486.01918242,183.895804692,5,3,2,1
lightning,1485.89927646,158.33753147,12,6,6,2
epikfaal,1485.81193514,179.996897947,17,10,7,2
nihlus,1485.71039959,143.736492757,9,5,4,2
tarchwood,1485.64869855,134.595847903,17,9,8,3
blahguy,1485.47690377,101.979633212,23,11,12,4
princess bumble bee,1485.38591114,176.31200742,6,3,3,1
kfp,1485.38591114,176.742535799,6,3,3,1
passion,1485.21549177,145.355937462,10,5,5,2
mr._hui,1485.19748722,160.245752924,7,3,4,1
next,1485.09260666,212.931536352,3,1,2,1
blazingsparky,1485.00180401,187.139446635,4,2,2,1
the dude,1484.90921586,184.895320774,4,2,2,1
sparkbeat,1484.86728746,242.827948038,3,1,2,1
leaf,1484.31709649,117.902249191,25,13,12,5
hunter,1484.21374117,181.778227779,4,2,2,1
nayeem,1484.16962932,200.185284741,4,2,2,1
arias,1484.11849091,199.651730163,4,2,2,1
trash,1483.88315456,210.639941961,3,1,2,1
jemz,1483.82210761,182.469664501,4,2,2,1
hikenviken,1483.82143196,156.410451557,8,4,4,1
sephy,1483.80263129,199.296016191,4,2,2,1
gifflarn,1483.72628602,164.142721946,7,3,4,1
azuleez,1483.72628602,164.142721946,7,3,4,1
robm,1483.69957701,171.311308161,6,3,3,1
supermegawalrus,1483.44321543,192.746907301,4,2,2,1
shanondorf,1483.42519382,191.132634581,4,2,2,1
taichou,1483.15255562,188.606669239,4,2,2,1
slacks,1482.97240541,157.835915115,8,4,4,2
ace,1482.78712428,189.457958322,15,8,7,2
spamgeorgio,1482.77611635,172.202712702,7,3,4,2
reeves,1482.77228133,183.413335799,6,3,3,1
hung,1482.64851775,180.022922151,5,3,2,1
swissmiss,1482.64457195,189.996491368,4,2,2,1
grainless,1482.6257431,197.532209785,4,2,2,1
mega,1482.49356607,195.065330192,4,2,2,1
austine,1482.22151472,158.494821489,8,4,4,2
unoriginal,1482.12519969,98.1273385016,24,12,12,5
jupiter,1482.01211312,181.564207,5,3,2,1
gsp,1481.83895982,199.304394647,4,2,2,1
spaghett,1481.79779094,124.971885385,19,8,11,4
life,1481.67759151,100.785523016,22,10,12,4
batsox,1481.05883983,200.229217333,4,2,2,1
justin white,1481.05883983,200.229217333,4,2,2,1
blackknight,1481.05883983,200.750440781,4,2,2,1
neth,1481.05883983,200.561061709,4,2,2,1
namsang,1481.05883983,199.849291902,4,2,2,1
r-1,1481.05883983,200.086829836,4,2,2,1
osully,1481.05883983,200.229217333,4,2,2,1
dre,1481.05883983,200.086829836,4,2,2,1
turbo,1481.05883983,199.849291902,4,2,2,1
subsube,1481.05883983,200.466305083,4,2,2,1
nka,1480.83546839,191.630127541,4,2,2,1
nurk,1480.81313479,166.729928471,7,3,4,1
juice,1480.78414517,108.730588688,27,12,15,5
nuthingdude,1480.34711446,198.082056531,4,2,2,1
jsun,1480.34167238,159.119166328,8,4,4,2
aspen,1480.22699991,240.179174186,3,1,2,1
game,1480.20555932,146.120897484,8,4,4,2
kaese,1480.15649202,133.021582641,22,12,10,3
spruce lee,1479.99225882,187.006732853,5,2,3,1
stacked,1479.9157282,151.845681108,8,4,4,1
piggly,1479.84469231,202.07784824,4,2,2,1
gradymac,1479.67693616,191.852233898,4,2,2,1
void,1479.65796831,135.811045779,19,9,10,3
beeyee,1479.53997787,185.594017184,4,2,2,1
iroh,1479.24815751,214.922095694,3,1,2,1
dingding,1479.12127727,195.660321652,4,2,2,1
didact25,1478.90468616,143.680262915,10,5,5,2
mistasleepa,1478.85582378,188.940684253,4,2,2,1
grigliamos,1478.73342048,239.78048744,3,1,2,1
ben zed,1478.70156608,129.060937433,11,5,6,3
dabeazt,1478.56351638,194.420537061,4,2,2,1
biff$$$$,1478.53798328,163.8829562,8,4,4,2
taze,1478.43401261,212.810021114,3,1,2,1
just tyler,1478.3550832,188.249689962,4,2,2,1
the_cucumbuh,1478.16117638,207.756666297,4,2,2,1
kokingpin,1478.16117638,207.893800752,4,2,2,1
tm87,1478.16117638,207.298896261,4,2,2,1
airfair,1478.16117638,207.756666297,4,2,2,1
blade runner sucks,1478.16117638,207.893800752,4,2,2,1
sweattypad,1478.06172306,171.77315144,7,3,4,1
nasian,1478.01495748,238.57875333,3,1,2,1
sedimentary rock,1478.00927656,167.153375314,7,4,3,1
dirt,1477.93865931,160.989257731,7,3,4,2
kupo,1477.91268542,239.511396661,3,1,2,1
saval,1477.89034932,192.140438583,4,2,2,1
techboy,1477.81379833,199.785041287,4,2,2,1
rubica,1477.59413992,148.541132337,10,5,5,2
xlax,1477.50131244,156.309465948,8,4,4,2
jazzhands,1477.43989604,198.097970936,4,2,2,1
epengu,1477.39574482,192.062565818,4,2,2,1
rooster,1477.31003288,112.487873764,17,9,8,3
ryou,1477.2646676,153.748779607,8,4,4,1
rawk,1477.24013469,150.016756721,10,5,5,2
scarph,1477.13746395,189.673163743,4,2,2,1
interfere,1476.86053408,238.105783095,3,1,2,1
tron,1476.68858415,141.223010288,10,5,5,2
drew,1476.55219164,191.754526324,5,3,2,1
giggles the tapeworm,1476.53297395,195.528711865,4,2,2,1
w1ng,1476.48541222,194.925955208,4,2,2,1
noizeeh,1476.04717106,160.920176587,8,4,4,1
lo,1475.92520605,205.327503888,4,2,2,2
n7,1475.86762832,203.080303114,4,2,2,1
gt,1475.80684871,149.156207027,8,4,4,2
pbz,1475.79491243,157.478387102,7,3,4,1
lemon water,1475.58955093,187.427526445,4,2,2,1
hotboi,1475.54292759,197.534638155,4,2,2,1
mr. bean,1475.53084447,197.719999339,4,2,2,1
land28h,1475.53084447,197.190765856,4,2,2,1
foxy grandpa,1475.50777883,199.313387147,4,2,2,1
hobbes,1475.48971655,146.296182504,11,5,6,3
2shadez,1475.48306676,156.021020726,7,3,4,1
bodlack,1475.45759597,157.369432959,7,4,3,1
jerry jurr,1475.2363562,189.238905825,4,2,2,1
kb,1475.18327909,236.376749015,3,1,2,1
mr.h,1475.14769543,196.755710043,4,2,2,1
destruben,1475.07349669,159.39301896,7,3,4,1
tapiney,1474.95672796,148.79712626,9,4,5,2
koala,1474.55640575,118.482833459,17,8,9,4
kyo,1474.50651033,170.456539866,7,3,4,2
prison,1474.50261839,161.923846361,7,3,4,2
odb,1474.4620601,184.843530607,4,2,2,1
ten,1474.30305345,173.041814423,7,3,4,2
mini joel,1474.17605133,195.601149187,5,2,3,1
slapchopchamp,1474.06825889,191.56143244,4,2,2,1
russy,1474.06706516,179.379468203,4,2,2,1
rentalizer,1474.05192274,236.024853627,3,1,2,1
briscoe,1473.95683841,189.794203933,4,2,2,1
slob on my knob,1473.92344403,199.816477132,4,2,2,1
dboi,1473.76700411,195.193596883,4,2,2,1
80-d,1473.65999123,201.608847691,4,2,2,1
cardinal,1473.65999123,201.608847691,4,2,2,1
emperor,1473.52951934,116.231821352,19,8,11,3
littlespoon,1473.48768429,196.330227466,3,1,2,1
vyn,1473.43830665,162.32503791,8,4,4,2
regi,1473.24172577,158.656017468,7,3,4,2
kob,1473.23994516,196.803339387,4,2,2,1
gorilla,1473.17687011,206.758505476,4,2,2,2
picassu,1472.96334891,183.967416146,6,3,3,1
peanutz996,1472.96212644,196.444394583,5,2,3,1
kyza,1472.79438475,234.842457838,3,1,2,1
nipples,1472.5768752,142.618941423,11,5,6,3
discowinter,1472.5432569,182.669635052,7,3,4,2
sheep,1472.53785321,99.7824284121,34,17,17,7
autarck,1472.51630173,175.000769594,7,3,4,2
ikey,1472.50974788,171.039416186,6,3,3,1
#rekt,1472.45120576,184.4586408,5,3,2,1
dexteria,1472.43488902,191.895450866,4,2,2,1
yung_life,1472.33567784,184.210459575,4,2,2,1
chez,1472.32350326,195.822821154,4,2,2,1
gark,1472.20114137,191.962022023,4,2,2,1
iron_narwhal,1472.01107382,217.513511989,3,1,2,1
shade,1471.90564474,202.286914193,4,2,2,1
help,1471.90224148,243.896198195,6,2,4,2
bb,1471.7496482,195.698837498,4,2,2,1
brando,1471.5866826,188.997676832,4,2,2,1
dream,1471.54450037,197.15004058,4,2,2,1
sled,1471.43260335,197.850064839,4,2,2,1
ross,1471.36874977,182.344504712,7,3,4,2
quibsy,1471.36831093,207.145698492,4,2,2,1
wei,1471.30900993,201.558738913,4,2,2,1
spaceghost,1471.30002655,166.51220314,7,3,4,2
ludwig,1471.11810398,162.899755977,8,4,4,3
mrpoo,1470.65487894,139.816947183,11,5,6,2
severian,1470.60589565,140.310613346,9,5,4,2
scrandino,1470.50757452,175.524846491,7,3,4,2
sambuddy5,1470.40290675,155.46084348,8,4,4,2
curlyq,1470.39969498,215.120367949,3,1,2,1
burns,1470.25038592,176.89917127,6,3,3,2
doby,1470.23438882,159.054656088,7,3,4,1
aymen am,1470.05353718,174.246088886,7,3,4,2
sinon,1469.9916039,156.533551914,7,3,4,1
o,1469.96735782,207.060098095,9,4,5,2
kort,1469.90979238,160.606436011,8,4,4,2
villeeh,1469.89258338,195.757411888,4,2,2,1
anime,1469.83385342,154.108454977,7,3,4,2
dasboot,1469.78444904,193.449271486,4,2,2,1
mrsa,1469.71454763,163.204975017,7,3,4,2
the lizard king,1469.50402654,174.671837079,7,3,4,2
drinkingfood,1469.28939768,195.96235626,4,2,2,1
wassabi,1469.18389866,185.908202596,5,2,3,2
ez$,1468.77549612,206.441274944,4,2,2,1
moros,1468.69660435,149.446214925,8,4,4,1
rolin,1468.63118119,183.661314467,5,2,3,1
daga,1468.62232232,138.870577349,11,5,6,3
giraffescanfly,1468.59172914,232.228196065,3,1,2,1
scooby doo gucci jacuzzi,1468.50866861,159.388776449,8,4,4,1
grizzly,1468.4790959,170.801850059,7,3,4,2
charlie,1467.63426886,148.009468322,9,4,5,2
100 grand,1467.54208361,193.47134009,4,2,2,1
corasaur,1467.28723054,193.785750129,4,2,2,1
item,1467.19636001,173.511508802,7,3,4,2
modgy,1467.02891417,195.138848304,4,2,2,1
king,1466.77654811,208.070590171,10,5,5,2
dinowulf,1466.70660302,164.500477548,8,4,4,3
big koley,1466.68225426,206.407518003,4,2,2,1
peachboss,1466.67345977,206.676128543,3,1,2,1
jnasty,1466.54800965,201.363922528,5,2,3,2
dojo,1466.41208339,200.827015013,4,2,2,1
suplex city,1466.29907394,153.077270645,9,4,5,2
butt zone,1466.23841366,169.821960929,11,5,6,3
coxmccox,1466.04647812,160.195791027,7,4,3,2
eps,1465.82814972,233.167314869,3,1,2,1
kingpugster,1465.334216,191.987862511,4,2,2,1
arm,1464.98253071,184.199052432,4,2,2,1
yusuf,1464.93326585,206.643569859,4,2,2,1
[n],1464.92983378,233.374341541,6,2,4,2
cuppajoe,1464.72165935,209.231579116,4,2,2,1
angryhamburger,1464.72165935,209.231579116,4,2,2,1
sick_bastard,1464.72165935,208.777043037,4,2,2,1
cosman,1464.72165935,209.04988328,4,2,2,1
invis,1464.72165935,208.777043037,4,2,2,1
shel,1464.72165935,209.04988328,4,2,2,1
vertex,1464.72165935,209.231579116,4,2,2,1
discard,1464.72165935,208.367112806,4,2,2,1
camgirl,1464.72165935,208.822541167,4,2,2,1
watch,1464.72165935,208.777043037,4,2,2,1
schis,1464.6186115,187.286825287,5,2,3,1
legend of lando,1464.59392919,233.651344251,3,1,2,1
kevocb,1464.52239414,178.535329115,7,3,4,2
worth,1464.48550396,194.857447213,4,2,2,1
buns,1464.36222298,167.678897241,7,3,4,2
ezreal,1464.30068554,211.148417428,3,1,2,1
brr,1464.22582011,195.917727705,4,2,2,1
8oz,1464.05250705,105.165474524,20,9,11,4
dutch,1464.03116408,142.584530524,17,8,9,4
sweetdee,1463.86146079,187.963525683,5,2,3,2
acsl,1463.81923458,200.103254913,4,2,2,1
k-tel,1463.69104109,159.257051712,8,4,4,1
enjoy,1463.53083373,167.523255766,13,5,8,3
joey,1463.26826952,231.271332844,3,1,2,1
zane_gillgreen,1462.8800588,167.257006172,7,3,4,1
rockhawk,1462.57647347,163.232985092,6,3,3,1
me11oye11o,1462.57478969,230.930601719,3,1,2,1
smartfolk,1462.54081887,230.507078844,3,1,2,1
snappy sam,1462.50931886,228.779326263,3,1,2,1
daz,1462.1639363,196.996040811,4,2,2,1
jekku,1462.04137629,147.365660951,12,5,7,2
skeleton man,1462.01571417,228.919448233,3,1,2,1
chillmilk,1461.95669863,193.44723659,4,2,2,1
hex,1461.93468165,158.943610419,16,7,9,3
table,1461.93427962,200.188152596,4,2,2,1
lethalturtle,1461.93427962,200.472682528,4,2,2,1
intern,1461.78075324,163.360409319,8,4,4,1
seanye,1461.51262496,203.00337241,4,2,2,1
matty,1461.51262496,202.675526914,4,2,2,1
four,1461.51262496,202.675526914,4,2,2,1
gerb,1461.51262496,203.00337241,4,2,2,1
die go,1461.51262496,202.90975632,4,2,2,1
kuroda,1461.51262496,202.300195773,4,2,2,1
rottenyogurt,1461.51262496,202.534859246,4,2,2,1
lightningjg,1461.51262496,202.675526914,4,2,2,1
watrboy,1461.29397231,187.209659634,4,2,2,1
ddasd,1461.24525765,199.881379084,4,2,2,1
the k.i.d,1461.20228915,232.937389904,2,1,1,1
bund,1461.19235572,168.779285276,7,3,4,2
bokk,1461.16266023,164.829603321,7,3,4,1
cho,1460.98251602,159.050947675,9,4,5,2
dyce,1460.95273495,156.891115472,9,4,5,3
exit,1460.7722668,147.980968275,8,4,4,2
jp,1460.62665773,138.912125554,14,6,8,5
stone watcher,1460.58801265,195.76562742,4,2,2,1
travioli,1460.54518917,161.979984755,7,3,4,1
ph$,1460.51538874,208.903492735,3,1,2,1
sweetyjesus,1460.43279629,201.729977609,4,2,2,1
oven,1460.15459433,166.910701916,7,3,4,2
zurdo,1460.05805238,227.389268594,3,1,2,1
r2,1459.68767219,227.308813254,3,1,2,1
dr. drew the dragon,1459.59528537,199.888388346,4,2,2,1
plasmius,1459.56608087,140.829545847,11,5,6,2
fresh prince,1459.54515403,192.843834501,4,2,2,1
sebastian,1459.48348389,191.891592673,4,2,2,1
tjd,1459.41742768,229.348148877,3,1,2,1
ben kenobi,1459.1302487,198.315426277,4,2,2,1
pillowfights,1459.07957787,227.442127035,3,1,2,1
noxd,1458.98074046,209.948325272,4,2,2,1
buddy,1458.78177013,226.833595759,3,1,2,1
shotzo,1458.65807461,161.629454832,7,3,4,1
thunda,1458.48764451,228.773399384,3,1,2,1
pogo,1457.87181224,185.405251474,4,2,2,1
vrudssbm,1457.72539301,125.879626998,15,7,8,4
chinchilla,1457.58466342,231.925484739,8,4,4,2
stus,1457.18041668,198.774005888,4,2,2,1
scuttles,1457.04309494,148.276448881,7,3,4,1
weezy,1456.98272491,159.334957661,8,4,4,2
beer,1456.8954162,228.092229951,3,1,2,1
crip,1456.74750304,209.960320988,3,1,2,1
savagebeast,1456.58247283,226.603221513,3,1,2,1
gravity,1456.57283457,156.23011666,8,4,4,2
therandyscrub,1456.54239039,175.963260238,6,3,3,1
zookie,1456.44729154,169.780987063,6,2,4,1
fastnezy,1456.44729154,169.780987063,6,2,4,1
aaron g,1456.43815635,225.373314196,3,1,2,1
docx,1456.42133966,152.43166295,7,3,4,1
piramid,1456.32771689,196.653586238,4,2,2,1
bamg,1456.30804843,225.820145442,3,1,2,1
n,1456.30804843,225.820145442,3,1,2,1
rabbit,1456.22450241,145.122824406,9,4,5,2
cong,1455.9902507,182.457559913,7,3,4,2
boat,1455.98802091,164.598641667,16,7,9,4
yushin,1455.80660893,167.434093535,7,3,4,2
messiah,1455.57958564,228.171639162,3,1,2,1
mrhappy,1455.37582052,152.820878854,7,3,4,2
salad,1455.3214006,197.674168188,4,2,2,1
majorleagueoddish,1455.28990054,160.853048803,8,4,4,2
thatssoazen,1454.95256407,204.307479141,4,2,2,1
nost,1454.87394867,213.20218585,3,1,2,1
icactusdog,1454.71854769,216.550944041,3,1,2,1
jonny2x4,1454.71854769,216.550944041,3,1,2,1
boxer,1454.70965439,197.016607679,4,2,2,1
pied,1454.70193791,216.755234374,3,1,2,1
tsuinami,1454.64370821,192.772863432,12,4,8,3
ctn,1454.50985272,225.958696342,3,1,2,1
jerem,1454.43050841,168.854894042,6,2,4,1
doctor x,1454.33083357,225.228343043,3,1,2,1
theredsock,1454.31066684,137.994575686,11,5,6,2
sunshine,1454.30407832,121.422826141,21,9,12,4
rope,1454.2461847,167.204118195,7,3,4,1
celestial,1454.24039589,224.556605478,3,1,2,1
youtwo,1454.12964706,209.829843514,3,1,2,1
exjordanary,1454.06720078,191.589719121,4,2,2,1
rob gambino,1454.01940948,225.890166751,3,1,2,1
taiki,1453.95314042,159.996098755,7,3,4,1
kev,1453.83704639,157.638067218,9,4,5,2
twig,1453.79503416,157.512641149,16,7,9,3
ant,1453.76730133,138.44337839,9,4,5,2
the grime reaper,1453.54274447,156.841987317,9,4,5,2
grasshoppa,1453.5288155,156.865044061,9,4,5,2
gillionayre,1453.38324937,219.194172014,3,1,2,1
catzors,1453.35535032,166.284133449,7,3,4,1
milhous,1453.19750283,202.974539354,4,2,2,1
jlf,1453.10467971,161.634987537,8,4,4,1
jax,1453.04656613,167.966746317,7,3,4,2
gnarly,1452.98969611,206.382428743,4,2,2,1
nestirr,1452.98534714,193.352076605,4,2,2,1
jjstinky,1452.81829531,223.081201146,3,1,2,1
cfh,1452.80075636,189.402109198,5,2,3,2
loaf,1452.48124511,166.286998208,7,3,4,2
smitus,1452.44909879,197.550125491,4,2,2,1
berry,1452.35708549,166.935746139,7,3,4,2
banjo,1452.30483627,158.747285938,7,3,4,2
cpn,1452.16880386,212.512090862,3,1,2,1
s0nicb00m,1452.09576632,223.207711921,3,1,2,1
ccoftw,1452.08786968,168.422550386,7,3,4,2
dbsammy,1452.01496891,190.023377755,4,2,2,1
dueceswild21,1451.96895842,167.3922807,7,3,4,1
mr.ii,1451.89786709,189.75907251,5,2,3,2
coffeemug,1451.81721318,165.900862891,7,3,4,2
dalius,1451.74900151,223.246770147,3,1,2,1
dairgenerate,1451.427269,191.219660302,4,2,2,1
zaz,1451.35454996,224.587815738,3,1,2,1
delusion,1451.30491062,205.964550714,6,2,4,2
swigo,1451.21280016,206.282709733,3,1,2,1
saucy pirate,1451.02795259,157.780098552,8,4,4,2
captain love,1450.93457953,209.899903396,12,8,4,2
bozion,1450.89222117,222.995355048,3,1,2,1
cowbell,1450.58637959,193.369713458,4,2,2,1
abendrake,1450.57537328,223.887496255,3,1,2,1
savior,1450.45760867,167.143985323,7,3,4,2
viking,1450.29851073,174.045658589,6,3,3,1
empale,1450.22872651,162.303705189,7,3,4,2
p2,1450.14327296,159.442270802,7,3,4,2
bad graphics ghost,1450.1043678,207.97407022,3,1,2,1
rbag,1449.74749348,222.81654401,3,1,2,1
king robin,1449.627858,134.131363975,12,5,7,2
shoryu drew,1449.55988282,209.297511176,4,2,2,2
dyne,1449.48172001,133.13860404,19,9,10,3
sino,1449.1225404,186.939210675,5,2,3,1
burrito mobile,1449.12231875,191.307941531,4,2,2,1
zelpher,1448.95809349,154.171958154,9,4,5,2
steps,1448.82993624,169.044747652,7,3,4,1
boji,1448.78628546,223.919070622,3,1,2,1
b.man,1448.76142101,151.257247237,7,3,4,1
blitxen,1448.69783476,211.786886838,4,2,2,1
y.n.c.,1448.56796968,211.056026893,3,1,2,1
pup,1448.55873712,202.006818978,4,2,2,1
weis,1448.504803,173.349964204,7,3,4,2
kden,1448.43081969,209.845774969,3,1,2,1
freestylin,1448.35537302,164.142721946,7,3,4,1
glibbyglobby,1448.22175503,196.1151283,4,2,2,1
joelie polie olie,1448.17808264,178.238343106,7,3,4,2
13uck5h0t,1448.1251168,212.273752987,4,2,2,1
,1448.00329732,153.409957232,7,3,4,1
,1448.00329732,153.409957232,7,3,4,1
tucker,1447.63104757,179.441121248,6,2,4,1
wink,1447.56925192,222.116974852,3,1,2,1
teenagemutantgingerturtle,1447.51231841,202.841611946,4,2,2,1
td,1447.29409283,183.132147057,6,2,4,2
jayfro,1447.28846569,187.315126826,11,5,6,3
espi,1447.13162595,226.498319529,3,1,2,1
barca,1447.13162595,226.624113345,3,1,2,1
junpei,1447.102113,201.764808465,4,2,2,1
bounty,1446.98655326,221.455012032,3,1,2,1
squazzil,1446.96633129,167.229969351,7,3,4,2
josesanmansquito,1446.91478109,210.761867731,3,1,2,1
jwooff,1446.57879194,149.630200773,9,4,5,2
yung peenlong,1446.52993151,186.789544954,4,2,2,1
jakejam,1446.26009847,220.772174683,3,1,2,1
maus,1445.92646454,221.928331058,3,1,2,1
pilot,1445.71930928,91.7650060669,41,19,22,8
lost,1445.66909277,220.459104227,3,1,2,1
ken2,1445.4585114,194.100515599,4,2,2,1
argonaut1,1445.20142656,136.720499711,11,5,6,3
siegfried,1445.18901024,165.944842506,7,3,4,2
deku,1445.08904574,157.695480893,8,4,4,2
etone,1444.6394877,221.535418776,3,1,2,1
moonsloth,1444.15732312,212.392559135,3,1,2,1
nunatak,1444.11625246,221.023276786,3,1,2,1
kevin,1444.09884094,169.987945805,7,3,4,3
calvin,1443.91169505,121.387204751,33,15,18,7
selise,1443.81430199,188.511031193,4,2,2,1
hopscotch,1443.81161312,173.826438721,7,3,4,2
ezmoney,1443.7857758,191.443603016,4,2,2,1
caleb,1443.60174201,182.5598262,9,3,6,2
bapmoney,1443.56401511,172.462117279,14,8,6,2
wingie,1443.56401511,172.462117279,7,3,4,1
vegas,1443.48097723,172.697139402,7,3,4,2
b,1443.48097723,172.697139402,7,3,4,2
uvve,1443.39805749,172.546691293,7,3,4,2
raptormoses,1443.38073125,144.776191747,10,4,6,2
condor,1443.34836223,172.290935679,7,3,4,2
stylz,1443.25234093,223.159208867,3,1,2,1
toby,1443.25234093,223.159208867,3,1,2,1
joooop,1443.17301231,164.228871009,7,3,4,2
enterthekiwi,1443.1665085,173.169280928,7,3,4,2
lorenzo,1443.07038408,173.203682186,14,6,8,3
banana fiend,1442.97600525,172.145731733,7,3,4,2
wumbo,1442.78470596,167.284143918,7,3,4,2
linkedlex,1442.58820222,203.96079886,4,2,2,1
studebacher hoch,1442.58820222,203.96079886,4,2,2,1
bearsfan092,1442.53937761,141.685659356,18,9,9,4
tolerablezero,1442.36001859,173.432108556,7,3,4,2
dwreck,1442.36001859,173.432108556,7,3,4,2
kodiak,1442.30801425,220.229576499,3,1,2,1
gongong,1442.22349598,118.566466071,17,7,10,3
rowan,1442.0783958,201.77649922,3,1,2,1
toxic,1442.0773602,220.805155398,3,1,2,1
milk$,1441.9059897,200.725357513,4,2,2,1
rev,1441.73524478,148.686833912,10,4,6,2
hoverbootz,1441.68741283,220.876974144,3,1,2,1
nikhil,1441.67490694,195.672342602,4,2,2,1
red,1441.54628279,140.754462266,12,5,7,3
ciroc obama,1441.51802113,165.348914806,7,3,4,2
adust,1441.39490349,201.608758676,4,2,2,1
how2play,1441.37347455,187.271803266,5,2,3,1
jimmypop23,1441.23292785,186.167049775,4,2,2,1
pillars,1441.15405784,204.756556473,3,1,2,1
mucho,1441.10778631,215.033222207,3,1,2,1
ouro,1441.07322392,222.45741044,3,1,2,1
kamikazefuneral,1441.07322392,222.45741044,3,1,2,1
big cat,1441.0425132,153.100719628,6,2,4,1
jgin,1440.99662097,218.514295819,3,1,2,1
hrsalt,1440.90930997,221.634542427,3,1,2,1
yeroc,1440.89576243,109.183580592,23,11,12,5
vic vinegar,1440.61392304,206.508351083,4,2,2,1
skam,1440.58442026,154.305503363,7,3,4,1
72centimeters,1440.48193582,222.196002571,3,1,2,1
gaslight,1440.39577635,223.029709674,3,1,2,1
specialspaceboy,1440.39577635,223.029709674,3,1,2,1
graff,1440.25921277,203.858219157,4,2,2,1
bajur,1440.17412062,219.647136712,3,1,2,1
mechanicalmarine,1440.16531666,202.716543454,3,1,2,1
zachorony,1440.14901107,190.465634838,4,2,2,1
bird,1440.11565069,144.735624643,11,5,6,3
magebreaker,1440.02178611,223.049007943,3,1,2,1
hot toddy,1439.94432513,193.37154033,4,2,2,1
mochtroid,1439.77876738,213.540368862,3,1,2,1
sleeptalky,1439.68824423,217.869576839,3,1,2,1
king_purple,1439.68824423,217.869576839,3,1,2,1
brekke,1439.49458498,147.198229816,7,3,4,1
kelp,1439.36743551,164.267456738,7,3,4,2
kaptinkillem,1439.26339765,131.574260511,11,5,6,3
erk,1439.13228035,206.730991224,3,1,2,1
shmugs,1438.89504954,184.335595341,5,2,3,1
deoxiclean,1438.81308313,296.016022083,1,0,1,1
ham,1438.81268714,105.751708431,23,10,13,5
nickysea,1438.4062464,204.444520335,4,2,2,1
thekillerdude,1438.4058662,218.564551911,3,1,2,1
butt aldrin,1438.20951073,218.522587668,3,1,2,1
danny doritos,1438.17113799,200.405972394,4,2,2,1
mr. thunder,1438.15723576,219.772123039,3,1,2,1
rs,1438.14297692,218.985977585,3,1,2,1
phazon,1438.02402356,167.12564003,7,3,4,2
medic,1437.91732882,204.557824123,3,1,2,1
maritlage227,1437.87863437,219.206285813,3,1,2,1
skate,1437.7727291,109.99262586,21,9,12,5
popkey,1437.76973003,214.425669012,3,1,2,1
metlwing,1437.7502428,207.170680822,4,2,2,1
taggo,1437.32697788,134.18072379,12,5,7,2
buttercup,1437.30687603,154.134353943,10,4,6,3
oko,1437.30170911,219.814897535,3,1,2,1
bdoc,1437.22442902,146.980783009,10,4,6,2
sag,1437.17684482,209.04988328,4,2,2,1
markovic,1437.17684482,208.686017019,4,2,2,1
chimpus,1437.17684482,208.367112806,4,2,2,1
knitl0rd,1437.17684482,208.913507699,4,2,2,1
1bm,1437.17684482,209.231579116,4,2,2,1
osh,1437.17684482,208.73153499,4,2,2,1
osubrandon,1437.16003968,217.880197111,3,1,2,1
nbs,1437.11068426,170.944340842,6,3,3,1
captain flowers,1437.04501391,217.197631464,3,1,2,1
luish,1437.04501391,217.197631464,3,1,2,1
raccoon wizard,1436.89079137,217.976954217,3,1,2,1
dr.g,1436.58098673,219.069690523,3,1,2,1
bobalu,1436.32763238,205.620235006,4,2,2,1
zodz,1436.27973993,179.275719966,5,2,3,1
henry,1436.20841583,199.784204272,4,2,2,1
notkris,1436.1749598,216.496658229,3,1,2,1
khan,1436.06478122,138.544760022,12,5,7,4
scav,1436.02708104,169.568663428,7,3,4,2
deedaa,1435.91634282,220.000396978,3,1,2,1
garm,1435.85699062,218.561821076,3,1,2,1
miwa,1435.63730313,218.101899439,3,1,2,1
mo,1435.41981636,145.811619081,14,5,9,2
frank goldman,1435.30651143,221.050278443,3,1,2,1
no love,1435.30651143,221.050278443,8,4,4,2
n1caps,1435.30651143,221.050278443,3,1,2,1
tyleor,1435.30651143,221.050278443,3,1,2,1
pokenutz,1435.30651143,221.050278443,3,1,2,1
spacewaste,1435.30651143,221.222118242,3,1,2,1
lago,1435.30591658,168.526975923,6,2,4,1
rasen,1435.23604023,139.114356184,9,4,5,2
i3njamin,1434.92582989,198.488560606,4,2,2,1
notsocrazy,1434.81630474,143.004692121,10,4,6,2
willy will,1434.44354852,219.569494704,3,1,2,1
king cobra,1434.18715384,212.615945811,3,1,2,1
spikeuvm,1434.02273445,165.152404993,6,2,4,1
tlo,1433.98485333,170.609405627,8,3,5,2
torch,1433.80577637,169.747069755,7,3,4,2
kity,1433.49359997,243.436728836,6,2,4,2
spoo,1433.46618008,167.630692799,7,3,4,2
dr3am,1433.30298832,167.853411601,6,2,4,1
n3on,1433.27116928,206.628780727,3,1,2,1
dreams,1433.20954711,168.231894747,7,3,4,2
pureevil,1433.15840458,191.823558793,17,10,7,2
ｈｉｔｏｒｉ,1433.12894408,220.106548892,3,1,2,1
| bre4d,1433.10267226,219.558934962,3,1,2,1
whip,1432.9548417,219.484141207,3,1,2,1
fehrar,1432.92470258,216.05389769,3,1,2,1
coupkey,1432.89930753,238.788799006,3,1,2,1
yang,1432.89895417,217.029692587,3,1,2,1
vien,1432.88152951,162.205250363,7,3,4,2
808,1432.8733145,215.965566915,3,1,2,1
coni,1432.36834728,177.108809202,5,2,3,1
herman,1432.32519831,204.706092232,3,1,2,1
dreekas,1431.99683932,216.861190774,3,1,2,1
sandbag,1431.99683932,216.510452551,3,1,2,1
dlos,1431.99683932,217.167622043,9,5,4,2
judas,1431.99683932,216.861190774,3,1,2,1
musichael,1431.99683932,217.167622043,3,1,2,1
gbaby6,1431.89170579,216.51412502,3,1,2,1
suds,1431.82724256,163.304399321,7,3,4,1
navi,1431.68724281,214.223936835,3,1,2,1
staples,1431.60844729,223.768038062,3,1,2,1
legend,1431.60393017,146.530732705,21,13,8,4
smatty,1431.5747992,193.827755886,4,2,2,1
neon,1431.38872709,206.109618251,3,1,2,1
dank joel,1431.36231414,186.84276108,5,2,3,1
hoxton,1431.11882095,229.807311592,3,1,2,1
general heinz,1430.78830006,193.915271571,4,2,2,1
slifer,1430.51586073,200.824486666,4,2,2,1
lostsock,1430.50663553,208.526271103,3,1,2,1
peen,1430.37699121,239.157867517,2,1,1,1
maestro,1430.37520755,204.761501245,3,1,2,1
evan,1430.33656661,149.253035132,16,6,10,4
johnnycamine,1430.1929934,215.771499689,3,1,2,1
el duderino,1430.08102513,169.301856213,10,5,5,3
murkywaters,1430.07815204,156.111594353,8,4,4,2
shyguy,1430.02989172,217.445588681,3,1,2,1
flatline,1429.96422853,164.86834013,7,3,4,1
medical chicken,1429.94207314,216.326714579,3,1,2,1
walrus,1429.93623135,144.346732381,12,5,7,3
ajax,1429.90166539,199.60334851,5,2,3,2
bananime,1429.8813885,210.874155977,3,1,2,1
blubcakes,1429.85175985,216.334253561,3,1,2,1
halqery,1429.7756579,199.46788501,5,2,3,2
quiteballin,1429.7756579,199.46788501,5,2,3,2
tri,1429.60798842,214.960071001,3,1,2,1
shchoo,1429.58237845,208.845208518,4,2,2,1
qz,1429.56984109,187.587404101,10,5,5,3
elost,1429.51787577,218.751015881,3,1,2,1
anjel,1429.42808407,187.803820377,8,3,5,3
rylo ken,1429.38542093,244.314459542,6,2,4,2
blue,1429.25749974,128.552277675,16,7,9,4
ghost,1429.11212308,134.150178196,13,5,8,3
npc,1429.05043516,199.701654069,4,2,2,1
arsenals,1429.00371187,197.964130228,4,2,2,1
edd,1428.74597837,164.36957217,7,3,4,1
northballz,1428.26861801,208.778446311,3,1,2,1
annii,1428.26264642,217.627478034,3,1,2,1
toast,1428.26264642,218.324802062,3,1,2,1
notechskill,1428.20672906,169.40073568,7,3,4,2
candy,1428.18304792,148.909143465,11,4,7,2
bread,1428.11906493,139.700524543,12,5,7,4
tfs,1428.10124673,204.45845703,3,1,2,1
dtwizzledante,1428.05132212,205.035453369,4,2,2,1
teardispenser,1427.97116808,218.825425388,3,1,2,1
quantum,1427.97116808,219.432374085,3,1,2,1
qwop,1427.97116808,219.432374085,3,1,2,1
grant,1427.97116808,219.432374085,3,1,2,1
tianten,1427.97116808,218.825425388,3,1,2,1
knack,1427.97116808,218.825425388,3,1,2,1
sunflowergirls,1427.97116808,219.302455062,3,1,2,1
zebkeet,1427.97116808,219.432374085,3,1,2,1
easy,1427.97116808,219.432374085,3,1,2,1
shep,1427.9376711,214.257645147,3,1,2,1
hei,1427.89008271,194.243070151,5,2,3,1
bootyblast,1427.89008271,194.633939234,5,2,3,1
cactuar,1427.89008271,194.731533917,5,2,3,1
halogen,1427.89008271,194.633939234,5,2,3,1
crypto,1427.89008271,194.633939234,5,2,3,1
stels,1427.89008271,194.633939234,12,4,8,2
ralph,1427.89008271,194.731533917,5,2,3,1
poli,1427.89008271,194.633939234,5,2,3,1
modestmajor,1427.89008271,194.633939234,9,2,7,2
samura1man,1427.89008271,194.633939234,5,2,3,1
tobbeh99,1427.89008271,194.633939234,5,2,3,1
oni,1427.89008271,194.633939234,12,4,8,2
olga,1427.89008271,194.633939234,5,2,3,1
krisspear,1427.89008271,194.633939234,5,2,3,1
gorull,1427.89008271,194.633939234,5,2,3,1
dino,1427.89008271,194.633939234,5,2,3,1
di leva,1427.89008271,194.633939234,5,2,3,1
comfort,1427.89008271,193.557149963,5,2,3,1
moat,1427.89008271,193.949401396,5,2,3,1
evbgr_bird,1427.89008271,194.243070151,5,2,3,1
tengil,1427.89008271,194.633939234,5,2,3,1
cross~up,1427.89008271,194.633939234,5,2,3,1
fries,1427.89008271,194.633939234,5,2,3,1
matge,1427.89008271,194.633939234,5,2,3,1
lunar,1427.88227863,161.067883397,7,3,4,2
moosewad,1427.88088199,137.197299534,12,5,7,3
c42p,1427.69857828,171.303958756,7,3,4,2
laugh,1427.6246597,204.472331984,3,1,2,1
altamira,1427.58605229,226.624113345,3,1,2,1
corgisploot,1427.58605229,226.624113345,3,1,2,1
bduke,1427.10098452,149.41658376,11,5,6,3
jimmy rustler,1426.92135342,176.537541808,7,3,4,2
lōs,1426.58417979,214.742442791,3,1,2,1
aghi,1426.5023188,195.08378688,4,2,2,1
woley,1425.98965014,206.258695266,3,1,2,1
raoul,1425.81688046,196.753517319,16,9,7,2
the wash,1425.56516956,216.267272519,3,1,2,1
satch,1425.36408769,218.202805539,3,1,2,1
jordova,1425.14572408,167.557688262,8,3,5,2
jeffsphere,1425.0971828,214.676543049,3,1,2,1
xurk,1425.03217277,130.796788485,12,5,7,2
imperatorchris,1424.93642591,201.702082857,4,2,2,1
morphikkhan,1424.89280572,217.784877561,3,1,2,1
jackedpuffguy,1424.82156168,190.859930246,6,2,4,1
cooran,1424.76354403,142.144349697,10,4,6,2
sute,1424.74363789,217.076512359,3,1,2,1
mattatari,1424.40039211,165.442987665,7,3,4,2
frobey,1424.39098169,154.877769271,12,4,8,4
led free,1424.3796458,206.27820793,4,2,2,1
verthm,1424.29113914,207.545539859,3,1,2,1
wisifox,1424.29113914,207.545539859,3,1,2,1
ferey,1424.26167263,198.389892403,4,2,2,1
mochi,1423.86890292,216.281576423,3,1,2,1
chililtf,1423.77097427,213.846181052,3,1,2,1
mojoe,1423.70142113,143.996266143,12,6,6,3
grape ape,1423.69737878,222.763095215,3,1,2,1
mj,1423.06089944,214.341284857,3,1,2,1
drunkunicron,1423.02184642,175.333467819,6,2,4,1
trebejo99,1423.02184642,175.333467819,6,2,4,1
other guy,1422.9097128,207.273139633,3,1,2,1
dr. rainbow bear,1422.87692992,217.117901079,3,1,2,1
amilk,1422.80293632,213.182342216,3,1,2,1
paul the beast,1422.80293632,213.182342216,3,1,2,1
barron,1422.62333881,212.944079105,3,1,2,1
benjahls,1422.50512526,283.207888661,1,0,1,1
flotsam,1421.4769957,214.122971652,3,1,2,1
messi,1421.38297752,141.871571063,11,5,6,2
wolff,1421.2916384,215.977968908,3,1,2,1
x3zinja12,1421.22950327,213.932087769,3,1,2,1
njm,1421.1305766,172.199556333,6,2,4,1
dirty dan,1421.12848197,187.788642005,6,2,4,1
homie,1421.10805245,216.322823279,3,1,2,1
lkan,1421.10805245,216.761536882,3,1,2,1
kid anarkist,1420.85127321,297.023923203,9,2,7,2
aspro,1420.61157306,255.644034739,10,3,7,2
little bucket,1420.49729322,208.367534491,3,1,2,1
check,1420.44857932,216.963715742,3,1,2,1
gucci swag gubu,1420.40373672,213.134280561,3,1,2,1
stego,1420.37427991,215.104395096,3,1,2,1
starcutter,1420.24445447,214.439523032,3,1,2,1
memes,1420.15647698,212.644928682,9,2,7,2
vigge,1419.7751941,137.52348137,13,5,8,3
jack,1419.76661398,133.472999187,12,5,7,2
ka'zar,1419.73799086,197.352478674,4,2,2,1
amdrew,1419.7099102,146.68292139,10,4,6,3
by15,1419.56228548,206.917957308,3,1,2,1
billy,1419.50726402,212.224455795,3,1,2,1
squire,1419.40524648,199.948737889,3,1,2,1
detrumi,1419.3214627,155.410080293,10,4,6,2
scudss,1419.17185515,217.182986608,3,1,2,1
obsidian,1419.16797222,167.987000321,7,3,4,2
herbmaster%,1419.09007017,218.095877329,3,1,2,1
horato,1418.91875871,214.71101494,3,1,2,1
durgh,1418.86245025,186.83184636,4,2,2,1
kidney thief,1418.72157424,214.547783576,3,1,2,1
emento,1418.72157424,214.547783576,11,6,5,2
hiyro,1418.48957001,217.174966004,3,1,2,1
root,1418.39514868,217.775407008,3,1,2,1
poofies,1418.39514868,217.426143547,3,1,2,1
t0nka,1418.39514868,217.469832155,3,1,2,1
akito,1418.39514868,217.120077141,3,1,2,1
professor x,1418.39514868,217.120077141,3,1,2,1
fakes,1418.39514868,217.949828854,3,1,2,1
ranger,1418.39514868,217.949828854,10,4,6,2
raichunite,1418.39514868,217.469832155,3,1,2,1
smackiavelli,1418.39514868,217.469832155,3,1,2,1
concosta,1418.39514868,217.513511989,3,1,2,1
agahnim,1418.39514868,217.469832155,3,1,2,1
raw input,1418.39514868,217.120077141,3,1,2,1
icebit,1418.39514868,217.120077141,3,1,2,1
cravate,1418.39514868,217.469832155,3,1,2,1
av_ultima,1418.39514868,217.513511989,3,1,2,1
krakhead,1418.39514868,217.469832155,3,1,2,1
ro,1418.39514868,217.120077141,3,1,2,1
tanner,1418.39514868,217.644498891,3,1,2,1
mattdemers,1418.39514868,217.949828854,3,1,2,1
brawlwasbetter,1418.39514868,217.120077141,3,1,2,1
american brav0,1418.39514868,217.557183052,3,1,2,1
kodak,1418.39514868,217.469832155,3,1,2,1
jinra1,1418.32759575,213.16442019,3,1,2,1
rowsa,1418.29104928,182.639507823,6,2,4,2
eli,1418.13674501,161.080021184,7,3,4,2
borz,1418.06182282,191.727710898,10,4,6,3
fiercewolf,1418.05518328,214.716177133,3,1,2,1
theroyalwe,1418.00827174,230.842313238,3,1,2,1
boomyx,1417.98389423,281.320449484,1,0,1,1
panda,1417.94228794,162.932989512,7,3,4,2
egg,1417.79506288,164.277549989,9,3,6,3
knææ,1417.46965668,154.534293755,7,3,4,1
bootstrings,1417.34688633,216.565485088,3,1,2,1
lay,1417.34333084,162.449235229,7,3,4,1
yon,1416.67432338,216.480633382,3,1,2,1
edav,1416.64974862,206.045055665,4,2,2,1
pilzlotta,1416.55521886,215.974035493,3,1,2,1
mr.bones,1416.48886908,214.718789797,3,1,2,1
linus,1416.06861184,145.485384039,10,4,6,3
lady c,1415.99035121,190.7844807,6,2,4,2
aysel,1415.90122526,200.475807861,4,2,2,1
miamikey,1415.89560373,200.293364544,3,1,2,1
ccucumber,1415.86900709,206.638746143,3,1,2,1
kdep,1415.66814817,214.993968046,3,1,2,1
fyore,1415.53048743,212.999425734,3,1,2,1
windy,1415.52222858,215.469575141,3,1,2,1
huckleberry dog,1415.44392983,202.258551029,3,1,2,1
barry,1415.10952609,159.059706766,8,3,5,1
hubes,1415.09325299,152.882429201,7,3,4,1
yungpurp,1415.09313567,209.916623918,3,1,2,1
papyrus,1414.99918032,214.781571441,3,1,2,1
burman,1414.84279007,150.284051696,10,4,6,2
silent e,1414.79807043,202.368865342,4,2,2,1
pushin,1414.70115199,217.590905712,3,1,2,1
solithic,1414.62658003,185.7625787,5,2,3,1
burnin taco,1414.61783211,216.155757186,3,1,2,1
ceilingpanda,1414.46469889,173.185015838,6,2,4,1
cazqu33n,1414.46469889,173.185015838,6,2,4,1
ajefk12555,1414.28559742,220.452173804,3,1,2,1
brett,1414.15704357,213.475426386,3,1,2,1
kipz,1414.055929,210.42464546,3,1,2,1
krax,1413.96062983,142.396430661,11,4,7,2
dusk,1413.8675971,281.857795094,8,0,8,2
mapletoothpick,1413.86439248,215.595164785,3,1,2,1
woody woo,1413.8492715,215.75270297,3,1,2,1
pook,1413.78140577,213.631302375,3,1,2,1
powerfulgoku,1413.76124607,208.987791105,3,1,2,1
k-c,1413.62750534,204.095300419,3,1,2,1
liberz,1413.4330293,191.531820696,12,6,6,2
quist,1413.25777884,136.462048568,10,4,6,2
mac,1413.25727775,216.081085324,3,1,2,1
prilo,1413.24281986,138.60298894,10,4,6,2
psythr,1412.9813408,221.340290203,3,1,2,1
wiggles,1412.95052392,213.228984183,3,1,2,1
g3,1412.91339152,159.558426778,7,3,4,1
ce,1412.79087958,203.715160542,5,2,3,2
arol,1412.7544859,191.61696173,6,2,4,2
blynde,1412.6257386,213.851949286,3,1,2,1
haru,1412.1516573,208.540269803,4,2,2,1
skanadron,1412.14026598,214.722548202,3,1,2,1
dynamov,1412.14026598,214.722548202,3,1,2,1
shrub,1412.14026598,215.385172903,3,1,2,1
bome,1412.14026598,214.722548202,3,1,2,1
seth love,1412.14026598,215.561528818,3,1,2,1
twinkletoes,1412.10269377,198.995655166,4,2,2,1
sleepy gary,1412.00123656,214.314693376,3,1,2,1
ceeds,1411.60795869,212.720653692,3,1,2,1
abobo,1411.34981717,211.586184613,3,1,2,1
nj,1411.34981717,211.586184613,3,1,2,1
salt,1411.18395022,101.183412375,26,10,16,5
mambo,1411.15488416,215.137588937,3,1,2,1
chrono,1411.15488416,215.137588937,3,1,2,1
vi,1411.02773898,142.665300812,11,4,7,3
sd_justin,1410.69131546,204.961815035,3,1,2,1
blues clues,1410.47580481,174.348176336,6,2,4,2
tj combo,1410.3377585,213.363200622,3,1,2,1
bblz,1410.28383275,181.867756209,6,2,4,1
derpydtw,1410.25868171,215.80160706,3,1,2,1
chobos,1410.08633409,185.049742916,5,2,3,1
goaty,1410.08311909,214.499250121,3,1,2,1
savage,1409.96398712,149.190584852,17,7,10,3
cloak n swagger,1409.75782099,214.557364547,3,1,2,1
$pud,1409.72977393,149.215605802,10,4,6,3
grepstar,1409.5458244,159.641364001,7,3,4,1
shydude,1409.2341564,205.763829301,3,1,2,1
lanz,1408.82952616,214.166302404,3,1,2,1
tkbreezy,1408.73748265,212.027588187,3,1,2,1
zimmer,1408.30062451,218.469343953,3,1,2,1
jesusgoestoprom,1408.11123889,211.547578686,3,1,2,1
dpw,1407.81361927,206.289974675,3,1,2,1
captn mason,1407.72341576,174.824378862,6,2,4,1
bron,1407.50745863,212.153295057,3,1,2,1
scruffy,1407.40662946,198.112044242,4,2,2,1
bayanati,1407.28041568,211.306708598,3,1,2,1
stealthypanda,1407.21962858,179.916231552,6,2,4,1
pem,1407.12674902,222.0109444,3,1,2,1
boy,1407.06624429,124.540435734,15,6,9,3
puddingpop,1406.85145119,149.538840055,10,4,6,2
deliciousoctorok,1406.79512489,138.157836867,11,5,6,2
ero,1406.66888355,212.51822936,3,1,2,1
bhop,1406.65513665,212.136822123,3,1,2,1
vplatypus,1406.59827439,204.482431234,3,1,2,1
squeegee,1406.20008752,223.89154664,3,1,2,1
pest killa,1406.1940691,205.797230147,4,1,3,1
onepunchman,1406.12260702,174.426628193,8,3,5,2
infamous,1405.98467823,215.635735347,3,1,2,1
ruslinjimmies,1405.97857726,271.736089228,1,0,1,1
bah-la-kay,1405.94908506,198.477952339,3,1,2,1
prioritized,1405.76879169,195.231995375,4,2,2,1
rky!!!,1405.60307499,180.33724172,5,2,3,1
krell,1405.52057832,212.950575507,3,1,2,1
mercury,1405.50311622,134.629946153,12,4,8,3
rocknturtle,1405.50177134,216.594809183,3,1,2,1
yinja,1405.50177134,216.989196424,3,1,2,1
aphrobeesiac,1405.50177134,216.155757186,3,1,2,1
elfie,1405.50177134,216.989196424,3,1,2,1
thedementedcube,1405.50177134,216.682512827,3,1,2,1
pikmon,1405.50177134,216.726351339,3,1,2,1
keams,1405.50177134,216.375394546,3,1,2,1
gameover,1405.50177134,216.550944041,3,1,2,1
cardoso,1405.50177134,216.814001773,3,1,2,1
belome,1405.50177134,216.155757186,3,1,2,1
amoroy,1405.50177134,216.989196424,3,1,2,1
paradox,1405.50177134,216.594809183,3,1,2,1
bwunt,1405.50177134,216.375394546,3,1,2,1
tko,1405.50177134,216.155757186,3,1,2,1
anewbus,1405.50177134,216.682512827,3,1,2,1
my dad makes me play this,1405.50177134,216.375394546,3,1,2,1
otachi,1405.50177134,216.507070011,3,1,2,1
climax,1405.50177134,216.550944041,3,1,2,1
misfit,1405.50177134,216.550944041,3,1,2,1
jp3,1405.50177134,216.814001773,3,1,2,1
vavv,1405.35001993,211.94374038,3,1,2,1
perma,1404.78388698,212.034621706,3,1,2,1
ron,1404.77817174,180.089192711,6,2,4,2
proc,1404.48077034,143.67218692,11,4,7,2
guerrilla,1404.2787111,171.406145375,6,2,4,2
clutchreacts,1404.16681131,203.69478324,4,1,3,1
ted greene,1404.02667305,218.887670006,3,1,2,1
oleyy,1403.97589106,263.7859055,5,1,4,2
alamo,1403.97126609,203.310934197,3,1,2,1
chrispcream,1403.89882978,273.30955805,1,0,1,1
reign,1403.85593164,215.644108523,3,1,2,1
bupo,1403.40051626,222.553982218,3,1,2,1
mudkipslaps,1403.01511717,225.007751197,3,1,2,1
b17,1402.90057152,215.472170392,3,1,2,1
xu,1402.81868904,233.365711494,3,1,2,2
ander,1402.49390922,178.92276163,6,2,4,1
sheepnado,1402.47769627,202.816091635,4,2,2,1
trepp,1402.09185184,209.027082267,4,2,2,1
remark,1401.71237209,182.435782264,6,2,4,2
fadversity,1401.64166351,191.925093408,3,1,2,1
pgd,1401.62512314,140.970048297,9,3,6,2
a duck,1401.42178323,248.056423197,7,3,4,2
stdemon,1401.08686469,211.06730856,3,1,2,1
ash,1401.06702615,184.423815496,6,2,4,2
whitegrizzly,1401.03336195,219.637349541,3,1,2,1
jebailey,1401.01369933,216.085493497,3,1,2,1
putpasswordhere,1400.98182478,172.43289007,7,3,4,2
atrioc,1400.96019139,185.044730699,6,2,4,2
sityec,1400.70166608,186.742508451,6,2,4,2
leering,1400.69639756,179.515830419,6,2,4,1
jad,1400.655076,214.882046489,3,1,2,1
airfire,1400.65260968,214.296958434,3,1,2,1
preme,1400.65260968,214.695566778,3,1,2,1
3flip,1400.65260968,214.518498956,3,1,2,1
elliot,1400.17309213,128.809261226,16,6,10,4
fmax,1400.16218631,228.733389073,3,1,2,1
hotrod,1400.16218631,228.733389073,3,1,2,1
pilling,1400.16218631,228.733389073,3,1,2,1
goku,1400.16218631,228.067891814,3,1,2,1
cinnabon,1400.16218631,227.734413905,3,1,2,1
pray,1400.16218631,228.151185131,3,1,2,1
castaway,1400.16218631,228.525629365,3,1,2,1
lmnts,1400.16218631,227.734413905,3,1,2,1
mrluggyogirl,1400.16218631,228.525629365,3,1,2,1
harmless,1400.16218631,228.733389073,3,1,2,1
viray,1400.16218631,228.733389073,3,1,2,1
horse marth,1400.16218631,228.733389073,3,1,2,1
jisskhalifa,1400.16218631,228.733389073,3,1,2,1
badwolf,1400.16218631,228.109542274,3,1,2,1
blondie,1400.16218631,228.525629365,3,1,2,1
fzzr,1400.16218631,228.733389073,3,1,2,1
derpy,1400.16218631,228.23444805,3,1,2,1
bamkek,1400.16218631,228.067891814,3,1,2,1
frostmagma,1400.16218631,227.942894771,3,1,2,1
bangboy2000,1400.16218631,228.733389073,3,1,2,1
thea,1400.16218631,228.733389073,3,1,2,1
whitefiction,1400.16218631,228.733389073,3,1,2,1
jamnt0ast,1400.16218631,228.733389073,3,1,2,1
smackledorf007,1400.16218631,228.733389073,3,1,2,1
mrl3gume,1400.16218631,228.359285506,3,1,2,1
frankypaul,1400.16218631,228.733389073,3,1,2,1
mcdonski,1400.16218631,227.734413905,3,1,2,1
somekid,1400.16218631,228.733389073,3,1,2,1
witness,1400.16218631,228.733389073,3,1,2,1
thetruetides,1400.16218631,227.942894771,3,1,2,1
cate!,1400.16218631,228.067891814,3,1,2,1
kickitsmooth,1400.16218631,228.733389073,3,1,2,1
cam,1400.16218631,227.734413905,3,1,2,1
confusion,1400.16218631,227.942894771,3,1,2,1
vans,1400.16218631,228.733389073,3,1,2,1
micah,1400.16218631,227.734413905,3,1,2,1
lvl3,1400.16218631,228.109542274,3,1,2,1
hnic,1400.16218631,228.276068121,3,1,2,1
hno3,1400.16218631,228.733389073,3,1,2,1
yung_stalin,1400.16218631,228.733389073,3,1,2,1
bricks,1400.16218631,228.525629365,3,1,2,1
stick,1400.16218631,228.733389073,3,1,2,1
voltaire,1400.16218631,228.733389073,3,1,2,1
+ultra,1400.16218631,227.734413905,3,1,2,1
gambit,1400.16218631,228.109542274,3,1,2,1
pkp,1400.16218631,228.733389073,3,1,2,1
riot,1400.16218631,228.359285506,3,1,2,1
phoenixzero,1400.16218631,228.733389073,3,1,2,1
seandabomb,1400.16218631,228.109542274,3,1,2,1
thatoneperuvian,1400.16218631,228.733389073,3,1,2,1
kellz,1400.16218631,227.942894771,3,1,2,1
shnarples,1400.16218631,228.733389073,3,1,2,1
broc,1400.16218631,228.359285506,3,1,2,1
telic,1400.16218631,228.733389073,3,1,2,1
cheesedog,1400.16218631,227.734413905,3,1,2,1
blazed chumpi,1400.16218631,228.733389073,3,1,2,1
damen,1400.16218631,228.733389073,3,1,2,1
pickl,1400.16218631,228.359285506,3,1,2,1
pretzl,1400.16218631,228.733389073,3,1,2,1
eridaan,1400.16218631,228.733389073,3,1,2,1
maui howy,1400.16218631,228.23444805,3,1,2,1
coma,1400.16218631,228.733389073,3,1,2,1
stitch,1400.16218631,228.733389073,3,1,2,1
c4d,1400.16218631,228.733389073,3,1,2,1
kaytoh,1400.16218631,228.067891814,3,1,2,1
dd,1400.16218631,228.733389073,3,1,2,1
magnet,1400.16218631,228.733389073,3,1,2,1
marcftl,1400.16218631,228.733389073,3,1,2,1
onin,1400.16218631,228.109542274,3,1,2,1
magicwan,1400.16218631,228.359285506,3,1,2,1
guccipivotmaster4000,1400.16218631,228.359285506,3,1,2,1
the oiler,1400.16218631,227.942894771,3,1,2,1
roi,1400.16218631,228.359285506,3,1,2,1
sweaters,1400.16218631,228.23444805,3,1,2,1
most defs,1400.16218631,228.733389073,3,1,2,1
purple pain,1400.16218631,228.026233747,3,1,2,1
mr baninawi,1400.16218631,228.733389073,3,1,2,1
cavelemon,1400.16218631,228.109542274,3,1,2,1
taptap,1400.16218631,228.733389073,3,1,2,1
spinr,1400.16218631,228.733389073,3,1,2,1
steak,1400.16218631,228.109542274,3,1,2,1
macbeth,1400.16218631,228.026233747,3,1,2,1
ludicity,1400.16218631,228.733389073,3,1,2,1
kelpoorganic,1400.16218631,228.733389073,3,1,2,1
fr1so,1400.16218631,228.026233747,3,1,2,1
jeezus,1400.16218631,228.733389073,3,1,2,1
busy p,1400.16218631,228.067891814,3,1,2,1
ctfunction,1400.16218631,227.734413905,3,1,2,1
redpilledangel,1400.16218631,228.733389073,3,1,2,1
pikabob,1400.16218631,228.733389073,3,1,2,1
jirachinick,1400.16218631,228.733389073,3,1,2,1
jerbear,1400.16218631,228.733389073,3,1,2,1
blackmoneycris,1400.16218631,228.733389073,3,1,2,1
waddledude,1400.16218631,228.109542274,3,1,2,1
sorbet,1400.16218631,228.733389073,3,1,2,1
moniker,1400.16218631,228.359285506,3,1,2,1
yourfaceson,1400.16218631,228.067891814,3,1,2,1
mimorox,1400.16218631,228.733389073,3,1,2,1
keagsbsmashin,1400.16218631,228.359285506,3,1,2,1
arbitrarychief,1400.16218631,228.733389073,3,1,2,1
brokenlawngnome,1400.16218631,228.23444805,3,1,2,1
easton,1400.16218631,228.733389073,3,1,2,1
the derrit,1400.16218631,228.733389073,3,1,2,1
emb,1400.16218631,228.525629365,6,2,4,2
rick rosser,1400.16218631,228.733389073,3,1,2,1
debra!,1400.16218631,228.067891814,3,1,2,1
razz,1400.16218631,228.067891814,3,1,2,1
captain lio,1400.16218631,228.733389073,3,1,2,1
pinky,1400.16218631,228.733389073,3,1,2,1
dude,1400.16218631,228.359285506,10,4,6,2
lightlybaked,1400.16218631,228.733389073,3,1,2,1
ms. hester,1400.16218631,228.733389073,3,1,2,1
carrot lord,1400.16218631,228.525629365,3,1,2,1
crustl0rd,1400.16218631,227.942894771,3,1,2,1
necro joe,1400.16218631,227.942894771,3,1,2,1
klear,1400.16218631,228.067891814,3,1,2,1
spectroid,1400.16218631,227.942894771,3,1,2,1
kuroshi,1400.16218631,227.734413905,3,1,2,1
sage,1400.16218631,228.733389073,3,1,2,1
lucky_hamburger,1400.16218631,228.109542274,3,1,2,1
bagels,1400.16218631,228.733389073,3,1,2,1
guacho,1400.16218631,228.733389073,3,1,2,1
jerome the gnome,1400.16218631,228.733389073,3,1,2,1
gig,1400.16218631,228.359285506,3,1,2,1
sampai,1400.16218631,228.733389073,5,1,4,2
homebad,1400.16218631,228.733389073,3,1,2,1
isaac_gs,1400.16218631,227.734413905,3,1,2,1
malkasaur,1400.16218631,228.940960242,3,1,2,2
sensazn,1400.16218631,228.525629365,3,1,2,1
madgood,1400.16218631,228.733389073,3,1,2,1
mcdonl,1400.16218631,228.359285506,3,1,2,1
hatbeanie,1400.16218631,228.733389073,3,1,2,1
odin,1400.16218631,228.525629365,3,1,2,1
echonce,1400.16218631,227.734413905,3,1,2,1
ike,1400.16218631,228.733389073,3,1,2,1
higglypuff,1400.16218631,228.733389073,3,1,2,1
bow,1400.16218631,228.067891814,3,1,2,1
supermanchunky,1400.16218631,228.067891814,3,1,2,1
clubs,1400.16218631,228.733389073,3,1,2,1
u01,1400.16218631,227.942894771,3,1,2,1
nabi,1400.16218631,228.359285506,3,1,2,1
whiskey milk,1400.16218631,228.733389073,3,1,2,1
kushmaster,1400.16218631,228.733389073,3,1,2,1
la bomba,1400.16218631,228.733389073,3,1,2,1
zomb,1400.16218631,228.733389073,3,1,2,1
pancho,1400.16218631,228.733389073,3,1,2,1
koon,1400.16218631,228.733389073,3,1,2,1
trig,1400.16218631,228.733389073,3,1,2,1
wransky,1400.16218631,228.359285506,10,4,6,2
grape jelly,1400.16218631,228.067891814,3,1,2,1
boobs,1400.16218631,228.026233747,3,1,2,1
highwalker,1400.16218631,228.23444805,3,1,2,1
turnup_xd,1400.16218631,227.942894771,3,1,2,1
wangz,1400.16218631,228.733389073,3,1,2,1
naminker,1400.16218631,228.733389073,3,1,2,1
franknstein,1400.16218631,228.733389073,3,1,2,1
kush wizard,1400.16218631,228.525629365,3,1,2,1
scrapg,1400.16218631,228.525629365,3,1,2,1
farthbog,1400.16218631,228.067891814,3,1,2,1
dispo,1400.16218631,227.734413905,3,1,2,1
coupon,1400.16218631,227.942894771,3,1,2,1
og asi,1400.16218631,228.733389073,3,1,2,1
ritalin-and-steak,1400.16218631,227.942894771,3,1,2,1
crawfish,1400.16218631,228.525629365,3,1,2,1
cola,1400.16218631,228.733389073,3,1,2,1
butterjones,1400.16218631,228.276068121,3,1,2,1
urbanlime,1400.16218631,228.733389073,3,1,2,1
bassmanbran,1400.16218631,228.733389073,3,1,2,1
ytyg echo,1400.16218631,228.109542274,3,1,2,1
del,1400.16218631,228.733389073,3,1,2,1
arcus,1400.16218631,228.733389073,3,1,2,1
shurfyne,1400.16218631,228.067891814,3,1,2,1
sean,1400.16218631,228.067891814,3,1,2,1
surf,1400.16218631,228.109542274,3,1,2,1
kidracula,1400.16218631,228.359285506,3,1,2,1
karn1vore,1400.16218631,228.067891814,3,1,2,1
kiki,1400.16218631,228.733389073,3,1,2,1
cremepuff,1400.16218631,228.276068121,3,1,2,1
captaindirtybird,1400.16218631,227.942894771,3,1,2,1
dach,1400.16218631,228.525629365,3,1,2,1
darelis,1400.16218631,228.733389073,3,1,2,1
lojo,1400.16218631,228.23444805,3,1,2,1
clubhs,1400.16218631,228.733389073,3,1,2,1
twto,1400.16218631,228.359285506,3,1,2,1
quak,1400.16218631,228.067891814,3,1,2,1
jusbeatbox,1400.16218631,228.733389073,3,1,2,1
bombadil,1400.16218631,227.734413905,3,1,2,1
edwin...,1400.16218631,228.733389073,3,1,2,1
space,1400.16218631,228.733389073,3,1,2,1
doctor moseley,1400.16218631,228.276068121,3,1,2,1
brassypolecat,1400.16218631,228.109542274,3,1,2,1
treble,1400.16218631,228.733389073,3,1,2,1
sen,1400.16218631,227.734413905,3,1,2,1
azzy,1400.16218631,228.733389073,3,1,2,1
kiwi,1400.16218631,228.23444805,3,1,2,1
boyne,1400.16218631,227.942894771,3,1,2,1
the p-diddler,1400.16218631,228.151185131,3,1,2,1
tittyboi,1400.16218631,228.733389073,3,1,2,1
ol' dirty smashtard,1400.16218631,228.733389073,3,1,2,1
julio98,1400.16218631,228.067891814,3,1,2,1
jfm,1400.16218631,228.067891814,3,1,2,1
burgher earl,1400.16218631,228.151185131,3,1,2,1
arisingshadow,1400.16218631,228.525629365,3,1,2,1
toastkitten,1400.16218631,228.733389073,3,1,2,1
slaw,1400.16218631,228.733389073,3,1,2,1
pope,1400.16218631,228.276068121,3,1,2,1
lvl 20 magikarp,1400.16218631,228.733389073,3,1,2,1
wonk,1400.16218631,228.733389073,3,1,2,1
flashboy,1400.16218631,228.733389073,3,1,2,1
gnast,1400.16218631,228.733389073,3,1,2,1
adpextwindong,1400.16218631,229.728020225,3,1,2,2
fatal,1400.16218631,228.733389073,3,1,2,1
iceluigi,1400.16218631,228.109542274,3,1,2,1
srocky,1400.16218631,228.067891814,3,1,2,1
allday napper,1400.16218631,228.733389073,3,1,2,1
trebert,1400.16218631,228.733389073,3,1,2,1
cubot64,1400.16218631,228.067891814,3,1,2,1
pt2,1400.16218631,228.067891814,3,1,2,1
stoopdapoop,1400.16218631,228.733389073,3,1,2,1
von,1400.16218631,228.525629365,3,1,2,1
gil,1400.16218631,227.734413905,3,1,2,1
supernuggit,1400.16218631,228.733389073,3,1,2,1
jewellery,1400.16218631,228.359285506,3,1,2,1
crust,1400.16218631,227.942894771,3,1,2,1
emperorbutt,1400.16218631,228.067891814,3,1,2,1
sir,1400.16218631,228.733389073,3,1,2,1
diamond,1400.16218631,228.733389073,3,1,2,1
house,1400.16218631,228.23444805,3,1,2,1
knee 'em liam,1400.16218631,227.942894771,3,1,2,1
boba,1400.16218631,228.733389073,3,1,2,1
seb,1400.16218631,228.359285506,3,1,2,1
mrbitter,1400.16218631,228.733389073,3,1,2,1
bcrypt,1400.16218631,228.359285506,3,1,2,1
goonknight,1400.16218631,228.733389073,3,1,2,1
seel,1400.16218631,228.026233747,3,1,2,1
dabes,1400.16218631,228.733389073,3,1,2,1
matsson,1400.16218631,228.733389073,3,1,2,1
brontë,1400.16218631,228.733389073,3,1,2,1
jorbic,1400.16218631,227.942894771,3,1,2,1
noob,1400.16218631,228.276068121,6,2,4,2
firearrow,1400.16218631,228.733389073,3,1,2,1
ready set goats!,1400.16218631,228.359285506,3,1,2,1
geekliftus,1400.16218631,228.733389073,3,1,2,1
meyerzzzz,1400.16218631,228.525629365,3,1,2,1
ruru,1400.16218631,228.525629365,3,1,2,1
paolothedon,1400.16218631,228.151185131,3,1,2,1
v2o,1400.16218631,228.733389073,3,1,2,1
rx,1400.16218631,228.733389073,3,1,2,1
sev,1400.16218631,227.942894771,3,1,2,1
acholight,1400.16218631,228.359285506,3,1,2,1
hahaae,1400.16218631,228.23444805,3,1,2,1
bubba,1400.16218631,227.734413905,3,1,2,1
achaoticnordi,1400.16218631,228.067891814,3,1,2,1
michaelmichaelmotorcycle,1400.16218631,228.733389073,3,1,2,1
relaxalax,1400.16218631,228.359285506,3,1,2,1
djsnowcone,1400.16218631,228.276068121,3,1,2,1
l81,1400.16218631,228.23444805,3,1,2,1
solid dong,1400.16218631,228.067891814,3,1,2,1
beto,1400.16218631,228.525629365,3,1,2,1
yansnow,1400.16218631,228.359285506,3,1,2,1
gooz,1400.16218631,227.942894771,3,1,2,1
meatcoffee,1400.16218631,228.733389073,3,1,2,1
hotdogsafari,1400.16218631,228.067891814,3,1,2,1
3hits,1400.16218631,228.733389073,3,1,2,1
moku,1400.16218631,228.067891814,3,1,2,1
keebler,1400.16218631,228.733389073,3,1,2,1
scrooge,1400.16218631,228.733389073,3,1,2,1
rngeesus,1400.16218631,228.733389073,3,1,2,1
aaronn,1400.16218631,227.734413905,3,1,2,1
nostalgickitty,1400.16218631,228.359285506,3,1,2,1
javqa,1400.16218631,228.359285506,9,2,7,2
vorde,1400.16218631,228.359285506,3,1,2,1
rickdb3,1400.16218631,228.067891814,3,1,2,1
ryan,1400.16218631,227.942894771,3,1,2,1
maresch,1400.16218631,228.359285506,3,1,2,1
stayqrispy,1400.16218631,228.733389073,3,1,2,1
winky,1400.16218631,228.733389073,3,1,2,1
legoman,1400.16218631,228.525629365,3,1,2,1
snacks,1400.16218631,228.733389073,3,1,2,1
noro,1400.16218631,228.733389073,3,1,2,1
maki,1400.16218631,228.067891814,3,1,2,1
hella ugly,1400.16218631,228.733389073,3,1,2,1
straight,1400.16218631,228.733389073,3,1,2,1
d_lidz,1400.16218631,227.942894771,3,1,2,1
slade,1400.16218631,228.733389073,3,1,2,1
funk,1400.16218631,228.525629365,3,1,2,1
pph,1400.16218631,228.067891814,3,1,2,1
hitboxninja,1400.16218631,228.733389073,3,1,2,1
kitsune,1400.16218631,228.733389073,3,1,2,1
rabittz,1400.16218631,228.067891814,3,1,2,1
blue jay,1400.16218631,228.733389073,3,1,2,1
cheung,1400.16218631,228.359285506,3,1,2,1
bants,1400.16218631,228.525629365,3,1,2,1
vapid,1400.16218631,228.733389073,3,1,2,1
stami,1400.16218631,228.733389073,3,1,2,1
k•maru,1400.16218631,228.733389073,3,1,2,1
scooch,1400.16218631,228.359285506,3,1,2,1
cat_tree,1400.16218631,228.525629365,3,1,2,1
the chief,1400.16218631,228.733389073,3,1,2,1
mamabenji,1400.16218631,228.733389073,3,1,2,1
doghaus,1400.16218631,227.942894771,3,1,2,1
boriater,1400.16218631,228.067891814,3,1,2,1
lucas,1400.16218631,228.733389073,3,1,2,1
the maltese falco,1400.16218631,228.067891814,3,1,2,1
wooks,1400.16218631,228.276068121,3,1,2,1
winda,1400.16218631,228.276068121,3,1,2,1
branflakes,1400.16218631,228.733389073,3,1,2,1
disafter,1400.16218631,228.400882828,3,1,2,1
harvey_birdman,1400.16218631,228.067891814,3,1,2,1
cosmit,1400.16218631,228.733389073,3,1,2,1
dutes,1400.16218631,228.067891814,3,1,2,1
magnetic salt,1400.16218631,228.733389073,3,1,2,1
uncleph1l,1400.16218631,228.067891814,3,1,2,1
hoov,1400.16218631,227.942894771,3,1,2,1
glgwawa,1400.16218631,228.067891814,3,1,2,1
trock,1400.16218631,228.733389073,3,1,2,1
mattymoo,1400.16218631,228.733389073,3,1,2,1
pochilin,1400.16218631,228.525629365,3,1,2,1
decency,1400.16218631,228.067891814,3,1,2,1
zeria,1400.16218631,228.525629365,3,1,2,1
kelbek,1400.16218631,228.067891814,3,1,2,1
metro,1400.16218631,228.733389073,3,1,2,1
ssb4 sucks,1400.16218631,228.733389073,3,1,2,1
katahri,1400.16218631,228.359285506,10,4,6,2
stringbean,1400.16218631,228.23444805,3,1,2,1
gemigumi,1400.16218631,228.359285506,9,3,6,2
irishwristwatch,1400.16218631,228.525629365,3,1,2,1
bdn,1400.16218631,228.733389073,3,1,2,1
the postal tilt,1400.16218631,227.942894771,3,1,2,1
hamr boss,1400.16218631,228.067891814,3,1,2,1
mova,1400.16218631,228.733389073,3,1,2,1
smurph,1400.16218631,228.525629365,3,1,2,1
loring,1400.16218631,228.733389073,3,1,2,1
abadango,1400.16218631,228.733389073,3,1,2,1
artron,1400.16218631,228.525629365,3,1,2,1
tenemos,1400.16218631,228.276068121,3,1,2,1
gucci,1400.16218631,228.067891814,3,1,2,1
boscotty,1400.16218631,228.733389073,3,1,2,1
skwiggs,1400.16218631,228.109542274,3,1,2,1
tauntz,1400.16218631,228.733389073,3,1,2,1
marri,1400.16218631,228.109542274,3,1,2,1
brotherly,1400.16218631,228.109542274,3,1,2,1
biggily oggily boogly,1400.16218631,228.276068121,3,1,2,1
gamma,1400.16218631,228.359285506,3,1,2,1
umi,1400.16218631,228.359285506,3,1,2,1
rickter_scale,1400.16218631,228.525629365,3,1,2,1
tigurz,1400.16218631,228.525629365,3,1,2,1
kered13,1400.16218631,228.733389073,3,1,2,1
icecream,1400.16218631,228.733389073,3,1,2,1
fluff,1400.16218631,227.734413905,3,1,2,1
dox,1400.16218631,228.733389073,3,1,2,1
krodomon,1400.16218631,228.109542274,3,1,2,1
anti care,1400.16218631,228.026233747,3,1,2,1
schmang,1400.16218631,227.734413905,3,1,2,1
caelan,1400.16218631,228.359285506,3,1,2,1
kat in the sac,1400.16218631,228.733389073,3,1,2,1
gutwrencherttd,1400.16218631,228.733389073,3,1,2,1
yamasaki,1400.16218631,227.734413905,3,1,2,1
chevaca,1400.16218631,228.733389073,3,1,2,1
nokit,1400.16218631,228.067891814,3,1,2,1
poodledeedoop,1400.16218631,228.067891814,3,1,2,1
drlight,1400.16218631,228.733389073,3,1,2,1
bat,1400.16218631,228.733389073,3,1,2,1
octobear,1400.16218631,228.733389073,3,1,2,1
neverlucky,1400.16218631,228.733389073,3,1,2,1
bphan,1400.16218631,228.733389073,3,1,2,1
nukidin,1400.16218631,228.026233747,3,1,2,1
tvfish15,1400.16218631,228.359285506,3,1,2,1
moon over my-hammy,1400.16218631,227.942894771,3,1,2,1
stoneyb,1400.16218631,228.23444805,3,1,2,1
shitty hungrybox,1400.16218631,227.734413905,3,1,2,1
ej39,1400.16218631,228.733389073,3,1,2,1
woodstock,1400.16218631,228.733389073,3,1,2,1
trippy,1400.16218631,228.733389073,3,1,2,1
becx,1400.16218631,228.026233747,3,1,2,1
kl3an,1400.16218631,228.733389073,3,1,2,1
glee,1400.16218631,228.733389073,3,1,2,1
skaterjayy,1400.16218631,228.733389073,3,1,2,1
mojo joe,1400.16218631,228.733389073,3,1,2,1
ogjanks,1400.16218631,228.151185131,3,1,2,1
winslo,1400.16218631,228.733389073,3,1,2,1
burnaby,1400.16218631,228.359285506,9,3,6,2
connoreno,1400.16218631,228.733389073,3,1,2,1
randy,1400.16218631,228.733389073,8,4,4,2
juniorbug,1400.16218631,228.276068121,3,1,2,1
qwillinallthefish,1400.16218631,227.942894771,3,1,2,1
hobbz,1400.16218631,228.733389073,3,1,2,1
ogs gosu,1400.16218631,228.525629365,3,1,2,1
too many cooks,1400.16218631,228.733389073,3,1,2,1
cashew,1400.16218631,228.067891814,3,1,2,1
nerrawx,1400.16218631,228.067891814,3,1,2,1
oppai,1400.16218631,228.733389073,3,1,2,1
scraggus,1400.16218631,228.067891814,3,1,2,1
volk,1400.16218631,228.525629365,3,1,2,1
gilby,1400.16218631,228.151185131,3,1,2,1
yoloyoshi,1400.16218631,228.151185131,3,1,2,1
coveredinbees,1400.16218631,228.733389073,3,1,2,1
spicythug,1400.16218631,228.733389073,3,1,2,1
starelf,1400.16218631,228.733389073,3,1,2,1
lopsided,1400.16218631,228.359285506,3,1,2,1
rymo,1400.16218631,228.733389073,3,1,2,1
objection,1400.16218631,228.359285506,3,1,2,1
nyck,1400.16218631,228.067891814,3,1,2,1
timbo,1400.16218631,228.733389073,3,1,2,1
mfdom,1400.16218631,228.276068121,3,1,2,1
haimatox,1400.16218631,228.067891814,3,1,2,1
f-ric,1400.16218631,228.276068121,3,1,2,1
mel'kaven,1400.16218631,228.733389073,3,1,2,1
saladin,1400.16218631,228.733389073,3,1,2,1
milkwaffles,1400.16218631,228.733389073,3,1,2,1
redfern,1400.16218631,228.733389073,3,1,2,1
lskipl,1400.16218631,227.734413905,3,1,2,1
anne frank,1400.16218631,228.733389073,3,1,2,1
whiz kid,1400.16218631,228.733389073,3,1,2,1
reen,1400.16218631,228.276068121,3,1,2,1
thewildjandro,1400.16218631,228.733389073,3,1,2,1
aully,1400.16218631,228.359285506,3,1,2,1
cheegor,1400.16218631,228.733389073,3,1,2,1
organic,1400.16218631,228.525629365,3,1,2,1
drstyles,1400.16218631,228.733389073,3,1,2,1
bonobono,1400.16218631,228.109542274,3,1,2,1
cilan,1400.16218631,228.151185131,3,1,2,1
obgyn,1400.16218631,228.067891814,3,1,2,1
chuluu,1400.16218631,228.733389073,3,1,2,1
tape,1400.16218631,228.525629365,3,1,2,1
therealjdawgz,1400.16218631,228.067891814,3,1,2,1
ausuri,1400.16218631,228.733389073,3,1,2,1
jaw,1400.16218631,228.359285506,3,1,2,1
drumrollpls,1400.16218631,228.359285506,3,1,2,1
hayd,1400.16218631,228.359285506,3,1,2,1
crispy bacon,1400.16218631,227.734413905,3,1,2,1
me,1400.16218631,228.733389073,3,1,2,1
heeb,1400.16218631,228.733389073,3,1,2,1
bbng,1400.16218631,228.733389073,3,1,2,1
koggy,1400.16218631,228.733389073,3,1,2,1
pistols,1400.16218631,228.525629365,3,1,2,1
keg,1400.16218631,228.067891814,3,1,2,1
primal,1400.16218631,228.733389073,3,1,2,1
na+,1400.16218631,228.733389073,3,1,2,1
hodor,1400.16218631,228.525629365,3,1,2,1
c j,1400.16218631,228.733389073,3,1,2,1
astro,1400.16218631,227.942894771,3,1,2,1
abra,1400.16218631,227.734413905,3,1,2,1
pocket,1400.16218631,228.359285506,3,1,2,1
birdup,1400.16218631,228.525629365,3,1,2,1
moonman,1400.16218631,228.733389073,3,1,2,1
sjw,1400.16218631,228.733389073,3,1,2,1
javelin,1400.16218631,228.733389073,3,1,2,1
chrisinajar,1400.16218631,228.733389073,3,1,2,1
fierce,1400.16218631,228.733389073,3,1,2,1
daniel-san,1400.16218631,228.067891814,3,1,2,1
krisp,1400.16218631,228.359285506,9,4,5,2
trickster,1400.16218631,228.359285506,3,1,2,1
mushroomcap,1400.16218631,228.359285506,3,1,2,1
naythin,1400.16218631,227.942894771,3,1,2,1
darkdragoon,1400.16218631,228.733389073,3,1,2,1
rick_thefox,1400.16218631,228.733389073,3,1,2,1
leather daddy,1400.16218631,228.359285506,3,1,2,1
qualp,1400.16218631,227.734413905,3,1,2,1
blahcookies,1400.16218631,227.734413905,3,1,2,1
kwang,1400.16218631,228.733389073,3,1,2,1
chicago ben,1400.16218631,228.733389073,3,1,2,1
sd rick,1400.16218631,228.067891814,3,1,2,1
$,1400.16218631,227.734413905,3,1,2,1
khornestalk,1400.16218631,228.733389073,3,1,2,1
kruel,1400.16218631,228.109542274,3,1,2,1
just kevin,1400.16218631,228.067891814,3,1,2,1
g1j,1400.16218631,228.733389073,3,1,2,1
toonlink159,1400.16218631,227.734413905,3,1,2,1
magmios,1400.16218631,228.276068121,3,1,2,1
wu2king,1400.16218631,228.525629365,3,1,2,1
shpiders,1400.16218631,228.067891814,3,1,2,1
sureeal,1400.16218631,228.067891814,3,1,2,1
thyrfa,1400.16218631,228.067891814,3,1,2,1
drug,1400.16218631,228.525629365,3,1,2,1
chu12ch,1400.16218631,228.733389073,3,1,2,1
meso,1400.16218631,228.23444805,3,1,2,1
rottenboyz,1400.16218631,228.733389073,3,1,2,1
waifu,1400.16218631,228.733389073,6,2,4,2
dhir,1400.16218631,228.733389073,9,3,6,2
boarder,1400.16218631,227.734413905,3,1,2,1
keefer,1400.16218631,228.733389073,3,1,2,1
bombsoldier,1400.16218631,228.067891814,3,1,2,1
tipc,1400.16218631,228.733389073,3,1,2,1
harrisonfjord,1400.16218631,228.733389073,3,1,2,1
gmar,1400.16218631,228.109542274,3,1,2,1
ocks_rock,1400.16218631,228.733389073,3,1,2,1
cb,1400.16218631,227.734413905,3,1,2,1
jr1501,1400.16218631,228.733389073,3,1,2,1
deskpop,1400.16218631,228.733389073,3,1,2,1
met,1400.16218631,228.026233747,3,1,2,1
masha,1400.16218631,228.733389073,3,1,2,1
reece637,1400.16218631,228.23444805,3,1,2,1
bad,1400.16218631,228.525629365,3,1,2,1
peridot,1400.16218631,228.026233747,3,1,2,1
kid stingray,1400.16218631,228.733389073,3,1,2,1
link,1400.16218631,228.067891814,3,1,2,1
lardarius,1400.16218631,228.733389073,3,1,2,1
knapsack,1400.16218631,227.942894771,3,1,2,1
just watch,1400.16218631,228.525629365,3,1,2,1
shwang,1400.16218631,228.733389073,3,1,2,1
@@,1400.16218631,228.733389073,3,1,2,1
vvvvv,1400.16218631,228.067891814,3,1,2,1
2spoopy,1400.16218631,227.942894771,3,1,2,1
sn3aky,1400.16218631,228.359285506,3,1,2,1
yuxminato,1400.16218631,228.733389073,3,1,2,1
snake,1400.16218631,227.734413905,3,1,2,1
pastor,1400.16218631,228.733389073,3,1,2,1
peak,1400.16218631,228.067891814,3,1,2,1
rish,1400.16218631,228.525629365,3,1,2,1
jack frost,1400.16218631,228.151185131,3,1,2,1
plr0,1400.16218631,228.733389073,3,1,2,1
hdbryan,1400.16218631,228.733389073,3,1,2,1
accelzero,1400.16218631,228.733389073,3,1,2,1
ec_joey,1400.16218631,227.734413905,3,1,2,1
mdma,1400.16218631,227.734413905,3,1,2,1
the ram,1400.16218631,227.942894771,3,1,2,1
kwaniza,1400.16218631,228.733389073,3,1,2,1
daddybiggums,1400.16218631,228.733389073,3,1,2,1
mental djent,1400.16218631,228.733389073,3,1,2,1
sparky,1400.16218631,228.733389073,3,1,2,1
shy,1400.16218631,228.359285506,3,1,2,1
nana saves popo,1400.16218631,228.733389073,3,1,2,1
bigredanimebike,1400.16218631,228.067891814,3,1,2,1
ir,1400.16218631,228.359285506,10,4,6,2
reckon,1400.16218631,228.276068121,3,1,2,1
mantistoboggan,1400.16218631,228.733389073,3,1,2,1
bennyboy98,1400.16218631,228.067891814,3,1,2,1
kit,1400.16218631,228.109542274,3,1,2,1
tafy,1400.16218631,228.733389073,3,1,2,1
d'comboz,1400.16218631,228.733389073,3,1,2,1
blackout,1400.16218631,227.734413905,3,1,2,1
cyxy,1400.16218631,228.525629365,3,1,2,1
pbrake,1400.16218631,228.23444805,3,1,2,1
air,1400.16218631,227.734413905,3,1,2,1
judzuu,1400.16218631,228.359285506,3,1,2,1
gario,1400.16218631,228.733389073,3,1,2,1
attacking zack,1400.16218631,228.359285506,3,1,2,1
zychotic,1400.16218631,228.276068121,3,1,2,1
sleeh,1400.16218631,228.733389073,3,1,2,1
wasian,1400.16218631,228.733389073,3,1,2,1
fractal,1400.16218631,227.734413905,3,1,2,1
nutsack,1400.16218631,228.525629365,3,1,2,1
zopher,1400.16218631,228.733389073,3,1,2,1
snowstorm,1400.16218631,228.733389073,3,1,2,1
hatesauce,1400.16218631,228.733389073,3,1,2,1
bratic,1400.16218631,228.359285506,9,4,5,2
little shocker,1400.16218631,228.733389073,3,1,2,1
juniro,1400.16218631,228.733389073,3,1,2,1
umarth,1400.16218631,228.733389073,3,1,2,1
sleepy time,1400.16218631,228.733389073,3,1,2,1
pharaoh,1400.16218631,228.109542274,3,1,2,1
chikin,1400.16218631,228.151185131,3,1,2,1
zega,1400.16218631,228.276068121,3,1,2,1
claus,1400.16218631,228.276068121,3,1,2,1
koebeldwill,1400.16218631,228.359285506,3,1,2,1
duke tresnor,1400.16218631,228.733389073,3,1,2,1
nanz,1400.16218631,228.733389073,3,1,2,1
mom's spaghetti,1400.16218631,228.733389073,3,1,2,1
papay,1400.16218631,228.359285506,3,1,2,1
no hablo,1400.16218631,228.733389073,3,1,2,1
boosy,1400.16218631,228.733389073,3,1,2,1
caden,1400.16218631,228.525629365,3,1,2,1
melvin,1400.16218631,228.067891814,3,1,2,1
heisenberg,1400.16218631,228.733389073,3,1,2,1
prohybrid,1400.16218631,228.359285506,3,1,2,1
tri-volt,1400.16218631,228.067891814,3,1,2,1
u guy,1400.16218631,228.733389073,3,1,2,1
wombätt,1400.16218631,228.067891814,3,1,2,1
taroube,1400.16218631,227.734413905,3,1,2,1
raz,1400.16218631,228.276068121,3,1,2,1
darklucario,1400.16218631,228.733389073,3,1,2,1
tvdonk,1400.16218631,228.733389073,3,1,2,1
tidi,1400.16218631,228.23444805,3,1,2,1
kingbowser,1400.16218631,228.733389073,3,1,2,1
sergio,1400.16218631,228.733389073,3,1,2,1
halaa,1400.16218631,228.359285506,3,1,2,1
akbiggs,1400.16218631,228.359285506,3,1,2,1
big d squirrels,1400.16218631,228.733389073,3,1,2,1
the don,1400.16218631,228.733389073,3,1,2,1
vaxellon,1400.16218631,228.733389073,3,1,2,1
professor cube,1400.16218631,228.276068121,3,1,2,1
xephyer,1400.16218631,228.026233747,3,1,2,1
kittenlover,1400.16218631,228.733389073,3,1,2,1
trasech,1400.16218631,227.942894771,3,1,2,1
griffin,1400.16218631,228.733389073,3,1,2,1
megamega,1400.16218631,228.067891814,3,1,2,1
dre peng,1400.16218631,228.733389073,3,1,2,1
shysta,1400.16218631,227.942894771,3,1,2,1
senpai,1400.16218631,228.525629365,3,1,2,1
bash,1400.16218631,228.733389073,3,1,2,1
mulkster,1400.16218631,228.525629365,3,1,2,1
drew2king,1400.16218631,228.733389073,3,1,2,1
dis,1400.16218631,228.067891814,3,1,2,1
dani,1400.16218631,228.026233747,3,1,2,1
kepp,1400.16218631,228.733389073,3,1,2,1
smyd,1400.16218631,228.733389073,3,1,2,1
tblow,1400.16218631,228.733389073,3,1,2,1
asterisk,1400.16218631,228.733389073,3,1,2,1
bluj,1400.16218631,228.067891814,3,1,2,1
wazzupo1,1400.16218631,227.734413905,3,1,2,1
theycallmechris,1400.16218631,228.359285506,3,1,2,1
pecan3141,1400.16218631,228.067891814,3,1,2,1
master jay,1400.16218631,228.525629365,3,1,2,1
jarido,1400.16218631,228.359285506,3,1,2,1
inu,1400.16218631,227.942894771,3,1,2,1
conch,1400.16218631,228.525629365,3,1,2,1
sweat,1400.16218631,228.067891814,3,1,2,1
0fun,1400.16218631,227.734413905,3,1,2,1
un0,1400.16218631,227.942894771,3,1,2,1
mcnuggets,1400.16218631,227.734413905,3,1,2,1
swankeaboo,1399.90108022,211.656338675,3,1,2,1
lealmobile,1399.86083813,205.936394886,4,2,2,1
ubik,1399.74463999,207.463344732,4,2,2,1
cogzilla,1399.3103446,212.250206559,3,1,2,1
brentos,1399.06108368,215.716152319,3,1,2,2
nickpeaches,1398.96925295,187.905556698,5,2,3,2
leonidas,1398.84253144,210.288885491,3,1,2,1
soulster,1398.46879743,175.98531857,6,2,4,2
kfc manager,1398.39658,215.238408291,3,1,2,1
heketzu,1398.18329707,189.618723797,5,2,3,1
middleman,1397.88419947,202.182556155,3,1,2,1
waltz,1397.743364,208.753231479,3,1,2,1
gouf,1397.63973149,267.023378463,1,0,1,1
amishcatfish,1397.62498587,194.470241434,12,4,8,2
torp,1397.4970178,180.714267752,5,2,3,1
cemith,1397.35376458,213.897437104,3,1,2,1
cosmic,1396.86391199,179.328448254,6,2,4,2
low expectations,1396.7081431,185.945355926,5,2,3,2
ung jedi,1396.54828634,166.92052526,6,2,4,1
mob,1396.2934459,176.783240858,6,2,4,1
rizner,1396.07846263,130.622173137,13,5,8,4
calebtemple,1395.97683119,206.183837639,4,1,3,1
flarebear,1395.90975822,207.338357341,3,1,2,1
lorek,1395.74102019,175.016044982,5,2,3,1
delay,1395.73915242,204.035430905,3,1,2,1
oak,1395.61038034,138.103444507,13,5,8,3
mean as custard,1395.6082469,210.321715109,3,1,2,1
gojv,1395.52808999,167.201106425,6,2,4,1
gildo,1395.41708534,166.509720624,7,4,3,1
dj_not_nice,1395.05356539,213.338171752,3,1,2,1
dru_p,1394.75529005,183.738338,6,2,4,2
hollow,1394.40101056,198.495256094,3,1,2,1
alchemist,1394.39641485,135.814846752,14,5,9,3
toe,1394.39540507,147.736232889,10,4,6,3
bbbd,1394.37790421,216.545513973,3,1,2,1
joshtinj,1394.36813453,214.696093714,3,1,2,1
douhboi,1394.23062173,165.591953323,6,2,4,1
word,1394.1507197,170.825799472,7,3,4,2
moachies,1393.73282692,173.684035043,6,2,4,1
bell,1393.54681216,207.040565759,3,1,2,1
pvtches,1393.54681216,206.719123136,3,1,2,1
lag,1393.54681216,206.4892149,3,1,2,1
paladin,1393.511536,171.912103627,6,2,4,2
nocturne,1393.17058263,167.896941996,6,2,4,1
bricklee,1392.98338936,212.673343731,3,1,2,1
italian n1nja,1392.9394107,209.984305699,3,1,2,1
nelsquik,1392.92527455,169.723268914,7,3,4,2
lelize,1392.8984577,177.847427042,6,2,4,1
loke,1392.8984577,177.847427042,6,2,4,1
prodigy,1392.8712747,214.662984086,3,1,2,1
zuul,1392.79816144,142.564681432,10,4,6,2
mercify,1392.78780389,267.260032267,1,0,1,1
honeybaked,1392.57211618,203.073154094,3,1,2,1
viceroy,1392.44073586,178.216461218,6,2,4,2
iko,1392.39017835,232.605528935,3,1,2,2
s&s,1392.37897709,215.698296603,3,1,2,1
dogface,1392.29865739,213.44239799,3,1,2,1
imcv,1391.96125731,203.288856833,3,1,2,1
pichu main,1391.88403999,150.194983441,12,4,8,2
waga,1391.74316396,207.619327779,3,1,2,1
dont panic,1391.59352945,214.705025829,3,1,2,1
knoll,1391.58522771,204.66974302,3,1,2,1
zwei,1391.11467348,212.890345899,3,1,2,1
jungle,1391.03748712,176.404426623,7,2,5,2
djit,1390.95094323,218.120078772,3,1,2,1
jaws,1390.6136381,216.139308035,3,1,2,1
macdslover,1390.44002704,203.73167445,3,1,2,1
joeco,1390.10047881,212.47285933,3,1,2,1
mlpjoey,1390.07289685,271.465468879,1,0,1,1
spamus,1390.00803936,172.689088253,7,3,4,2
haus,1389.91982945,275.239671686,13,8,5,2
havoc,1389.8697421,209.785300007,3,1,2,1
luu,1389.85927264,215.782298464,3,1,2,1
zebra,1389.67826887,172.783596129,6,2,4,2
wepeel,1389.6050351,128.943911616,13,5,8,3
m7,1389.37869078,219.196145337,3,1,2,1
scotch,1389.30579943,213.131724603,3,1,2,1
blackg,1389.25577916,175.42298407,6,2,4,1
bakinshake,1389.17740389,203.228855725,3,1,2,1
jr,1389.15868829,160.195028839,8,3,5,2
firewater,1388.9235041,158.848519022,7,3,4,2
derrick,1388.61880639,217.283091784,3,1,2,1
captwheatroll,1388.57075789,202.426941744,3,1,2,1
ælj,1388.45852442,157.581788857,7,3,4,1
gustavus adolphus,1388.45852442,157.581788857,7,3,4,1
todd,1388.44662761,272.697296857,1,0,1,1
fang,1388.37960932,171.35116209,6,2,4,2
the albino buffalo,1388.27995521,215.910122251,3,1,2,1
schvein,1388.2609525,174.276514895,6,2,4,1
otak_,1388.22549363,133.290160211,21,7,14,4
awesomebee,1387.89243743,169.517429916,6,2,4,1
wwjd,1387.76848826,217.154021035,3,1,2,1
sweets,1387.67844215,209.35148289,3,1,2,1
nodge,1387.67844215,209.35148289,3,1,2,1
generic,1387.54068302,126.656031743,17,6,11,4
nhale,1387.53169898,216.904993174,3,1,2,1
melo,1387.53169898,217.080114391,3,1,2,1
peacenox,1387.53169898,216.510452551,3,1,2,1
squirrlz,1387.53169898,217.34253165,3,1,2,1
koder,1387.53169898,216.510452551,3,1,2,1
well dressed jem,1387.53169898,216.904993174,3,1,2,1
hyperslurpie,1387.53169898,217.34253165,3,1,2,1
bigshot,1387.53169898,217.036347334,3,1,2,1
pre,1387.53169898,216.904993174,3,1,2,1
slenda man,1387.53169898,216.861190774,3,1,2,1
leavescat,1387.53169898,216.861190774,3,1,2,1
icy mcpicy,1387.53169898,216.904993174,3,1,2,1
sadfish,1387.53169898,216.861190774,3,1,2,1
ractor,1387.53169898,216.904993174,3,1,2,1
willson,1387.53169898,216.510452551,3,1,2,1
wasted,1387.53169898,216.729730457,3,1,2,1
vitaminc,1387.53169898,217.34253165,3,1,2,1
plautus,1387.53169898,216.729730457,3,1,2,1
sad,1387.53169898,216.904993174,3,1,2,1
tomce,1387.53169898,217.167622043,3,1,2,1
20xx,1387.53169898,216.861190774,3,1,2,1
schiller,1387.53169898,216.861190774,3,1,2,1
applefrorm,1387.53169898,216.861190774,3,1,2,1
mrweclaw8,1387.53169898,217.080114391,3,1,2,1
noldorian,1387.05523756,198.253764614,3,1,2,1
oathlivion,1386.92835363,176.635004198,6,2,4,1
bhox,1386.64807218,213.782705018,3,1,2,1
geoscyl,1386.44824116,203.68308209,3,1,2,1
hyphy,1386.35122153,212.764238029,3,1,2,1
captain casual,1385.80274584,185.284389615,6,2,4,2
chedie,1385.6254449,214.157595302,3,1,2,1
fnm,1385.58489445,215.045036053,3,1,2,1
jmyl,1385.55110905,164.385261577,6,2,4,1
the candyman!!!,1385.53328235,199.567510871,3,1,2,1
storm,1385.24825605,155.630960028,9,3,6,2
dan sam,1385.16830199,211.32739572,3,1,2,1
bopolev,1385.12945207,210.978248863,3,1,2,1
link2213,1385.02792246,148.444913612,9,3,6,3
rh0mbus,1384.44713455,181.342200814,6,2,4,2
roshi,1383.76560274,128.297805447,13,5,8,3
jmlee337,1383.47754747,156.926717647,8,3,5,3
paprika,1383.47082952,204.283335604,3,1,2,1
bantler,1383.40096044,287.022273511,1,0,1,1
greensmith,1383.39632682,220.574793683,3,1,2,1
damfam,1383.25057153,175.359344936,6,2,4,1
ship,1383.21775257,126.143785907,22,11,11,4
uleksite,1383.05692679,189.553011368,6,2,4,2
keiththegeek,1382.98281914,203.92359069,3,1,2,1
rocket,1382.98246708,167.943327063,6,2,4,1
merlin,1382.65986332,187.261829358,5,2,3,1
nimbus,1382.41154323,131.501349616,17,7,10,4
juan andres rodriguez,1382.21449014,173.684035043,6,2,4,1
korvus,1382.10896173,210.476496842,3,1,2,1
lax,1382.0468575,177.888074882,6,2,4,2
renz gaming,1381.83467606,200.756125686,4,1,3,1
two,1381.74904048,191.040685518,4,1,3,1
zo9ine,1381.53120272,209.899947256,3,1,2,1
portals,1381.45531068,144.427158216,11,4,7,2
crispy t.,1381.22608462,199.169503822,3,1,2,1
notparis,1380.84636375,202.131602963,3,1,2,1
kzoo,1380.73094588,210.399609607,3,1,2,1
7bananananananans,1380.49794151,138.033981377,11,4,7,2
wombat,1380.47800844,140.962234125,12,6,6,4
spook,1380.41218258,209.690945875,3,1,2,1
floyd,1380.41218258,209.690945875,3,1,2,1
pang,1380.17622414,164.142721946,7,2,5,1
aquashard,1380.1494158,216.746321049,3,1,2,1
vintage,1380.07151647,208.494042169,3,1,2,1
purplepanda,1379.88209939,171.333903225,6,2,4,1
king magikarp,1379.82572667,215.705563822,3,1,2,1
apollo [thomas],1379.69927892,226.247330461,3,1,2,1
dessro,1379.4999599,210.521560242,3,1,2,1
lotus,1378.99803328,147.895947357,18,7,11,4
tw!nk,1378.9258958,175.212398251,6,2,4,2
burnt wood,1378.84410737,195.435615763,3,1,2,1
long daddy green,1378.44794146,159.330050772,6,2,4,1
breachin,1378.27585798,154.305597931,8,3,5,2
datnero,1378.10341993,176.768745122,6,2,4,2
vu,1378.04607549,176.033096293,6,2,4,2
pilgor,1377.98942608,216.154621399,3,1,2,1
undefined,1377.92687643,208.193898356,3,1,2,1
chillycity,1377.77570283,217.096013898,3,1,2,1
hhhhhhhhhhhhhhh,1377.59660389,168.885234347,6,2,4,1
doc brown,1377.58830661,188.687871772,9,3,6,3
jules,1377.36899883,146.069077832,26,12,14,4
gingerjesus,1377.22472634,260.92068129,5,1,4,2
fakesnakejake,1377.10381768,191.838391281,6,2,4,2
yung,1377.08305677,192.07000136,6,2,4,2
jabberwock,1376.99995987,191.461583701,8,2,6,3
rok,1376.93423075,200.05233661,3,1,2,1
master sergeon,1376.73522208,222.334556397,3,1,2,1
hiben75,1376.59065628,205.553566919,3,1,2,1
perfect light,1376.39239134,228.761167906,3,1,2,2
blank,1375.86698601,142.631606455,11,4,7,3
lemon zest,1375.70220834,209.729140034,3,1,2,1
pil0t,1375.63260422,226.498319529,3,1,2,1
kidwiththeface,1375.63260422,226.624113345,3,1,2,1
yogothewizard,1375.63260422,226.288507772,3,1,2,1
yeniths,1375.58944752,184.649102962,13,7,6,2
tusk,1375.56012205,152.235773795,9,3,6,2
kaenzune,1375.49260562,169.498710564,5,2,3,1
roro,1375.4528985,213.317689874,3,1,2,1
erki,1375.07180153,137.056157459,12,4,8,2
skullkid,1374.92375646,159.40966897,8,3,5,3
cel,1374.84542498,199.549349561,4,1,3,1
pepi,1374.59824944,165.672606878,6,2,4,1
bashnland,1374.55035024,269.74615452,1,0,1,1
leo,1374.25199368,191.978259206,4,1,3,2
tedgar,1374.21958599,228.719419506,3,1,2,1
adamantoise,1374.11242976,166.729928471,7,2,5,1
stonehaus,1374.01218049,166.039720501,6,2,4,1
chilly,1373.97540713,207.50475461,3,1,2,1
papapaint,1373.94311681,182.533498201,6,2,4,2
gibby,1373.89866738,194.470241434,5,2,3,1
jpg,1373.60816265,205.48919847,6,2,4,2
echo,1373.3652607,182.111394518,6,2,4,1
thereal,1373.3652607,182.111394518,6,2,4,1
wisaac,1373.3652607,181.431970759,6,2,4,1
hasme,1373.3652607,182.528244426,6,2,4,1
silo,1373.3652607,182.163552923,6,2,4,1
hacksugar,1373.3652607,182.528244426,6,2,4,1
it's cha boi,1373.3652607,182.528244426,6,2,4,1
roland,1373.3652607,182.111394518,6,2,4,1
satco,1373.3652607,182.528244426,6,2,4,1
sprak,1373.3652607,182.528244426,6,2,4,1
long0uw,1373.3652607,182.528244426,6,2,4,1
frozenpizza,1373.3652607,182.111394518,6,2,4,1
oolongt,1373.3652607,182.528244426,13,7,6,2
iceberg,1373.3652607,182.111394518,6,2,4,1
dazy,1373.3652607,182.528244426,6,2,4,1
legendary link player,1373.3652607,182.528244426,6,2,4,1
klexi,1373.3652607,182.528244426,6,2,4,1
wojo42,1373.3652607,182.111394518,6,2,4,1
viper,1373.3652607,182.632308241,6,2,4,1
rd,1373.3652607,182.528244426,13,6,7,2
skrull,1373.3652607,182.528244426,13,5,8,2
northstar,1373.3652607,182.528244426,6,2,4,1
seal,1373.3652607,182.111394518,6,2,4,1
moosie,1373.3652607,182.528244426,6,2,4,1
mellis,1373.3652607,182.528244426,6,2,4,1
peeko,1373.3652607,182.111394518,6,2,4,1
pandoz,1373.3652607,182.528244426,6,2,4,1
anutim,1373.3652607,182.528244426,6,2,4,1
alfster,1373.3652607,182.111394518,6,2,4,1
zach,1373.32315697,179.179347576,6,2,4,2
ralph cecil,1373.2304511,197.546437582,3,1,2,1
sensai,1373.2048125,204.680302283,3,1,2,1
zalost,1373.19797689,181.969760496,6,2,4,2
tninja,1373.16423602,159.054656088,7,2,5,1
trouts,1373.15617821,182.780869851,6,2,4,2
dew,1373.15617821,182.780869851,6,2,4,2
okay,1372.94731827,182.669304947,6,2,4,2
cr,1372.94731827,182.669304947,6,2,4,2
ashy larry,1372.8469343,211.326957937,3,1,2,1
regi$ philbin,1372.81940247,265.247251897,1,0,1,1
kwote,1372.73228866,221.737296902,3,1,2,1
donnie cash,1372.69697961,183.106726061,6,2,4,2
surge,1372.57193008,183.195363218,8,2,6,3
goldenboy,1372.48616695,184.066327604,6,2,4,2
alex,1372.4537726,184.1725101,6,2,4,2
lyter,1372.4020296,184.341986914,6,2,4,2
dauvid,1372.26069949,170.488616286,6,2,4,1
lastpo,1372.25919277,206.342333985,3,1,2,1
zer0cool,1371.68611642,216.280112482,3,1,2,1
king harkinian,1371.66482455,172.217024613,6,2,4,2
lank,1371.636791,195.708717388,4,2,2,1
mocha,1371.49543244,180.453695931,6,2,4,2
novamatt,1371.02316376,223.173856527,3,1,2,1
opiatre,1370.75388633,218.382584504,3,1,2,1
lordtogs,1370.50185804,176.022014695,6,2,4,1
spills,1370.43176142,144.928366389,9,3,6,2
treeze,1370.31688727,216.156505406,3,1,2,1
supermrjmt,1370.28883582,146.264055304,9,3,6,2
dime,1370.18157028,140.858984087,12,4,8,3
white cinnamon,1370.14840853,177.291665319,7,2,5,1
liaem,1370.02553832,216.49509013,4,1,3,2
lysid,1370.02553832,216.49509013,4,1,3,2
fern,1370.01953798,131.437958365,19,7,12,4
ikeatm,1369.9306278,217.539260452,3,1,2,1
nitsua,1369.66874454,267.030642475,1,0,1,1
sylveon,1369.66347185,154.691120843,9,3,6,2
kong,1369.56516488,218.281183934,4,1,3,2
yoda,1369.02933575,176.297745831,6,2,4,2
basedontruestory,1368.8791857,165.254851721,6,2,4,1
vann allen,1368.87127584,223.709902561,3,1,2,1
sp1nda,1368.49562579,204.897393394,3,1,2,1
slip,1368.48474049,218.295004781,3,1,2,1
redrum,1368.39233452,129.743751795,12,4,8,2
delarock,1368.23467145,161.196641456,9,3,6,3
per hammar,1368.03921352,174.177169612,5,1,4,1
miami thunder,1367.82333257,203.244983952,3,1,2,1
littleboylarry,1367.81651625,216.760844714,3,1,2,1
fuck this lame ass game,1367.81651625,215.92652408,3,1,2,1
fatbomba,1367.78146686,165.074626135,6,2,4,1
kushwaii,1367.38025354,277.074553275,10,5,5,2
wallstreet,1367.27693904,208.618164402,3,1,2,1
romulus,1366.87674251,171.10201218,6,2,4,1
aesthetic,1366.83555822,174.271540488,5,1,4,1
withputit,1366.75698258,176.31200742,6,2,4,1
stoked,1366.6935386,169.487660435,6,2,4,2
botepipapopote,1366.06898489,171.479533187,5,1,4,1
some moose,1366.00524207,210.996255722,3,1,2,1
duk,1365.88616036,173.081381291,6,2,4,2
papa no johns,1365.7595574,175.081555021,6,2,4,1
songbird,1365.40065094,178.754574747,6,2,4,2
honk,1365.36944407,216.623709757,3,1,2,1
rich,1364.88435384,121.104117304,17,6,11,3
eros,1364.78598926,171.77315144,7,2,5,1
not that good,1364.77390224,200.403031946,3,1,2,1
monopenisguy,1364.72948906,205.737885118,15,7,8,2
kenpachi,1364.66293925,143.713814482,18,8,10,3
crossfire,1364.60493065,227.621395214,3,1,2,1
mkultra,1364.3036636,177.322978938,6,2,4,2
unkn0wnkami,1364.14171662,212.872398322,3,1,2,1
nubpai,1364.08138753,217.795609516,3,1,2,1
muffin,1363.99930826,166.907298485,9,3,6,2
sianvar,1363.79473309,263.777571732,1,0,1,1
lukatic,1363.71174304,168.912103833,6,2,4,1
pseudo seras,1363.71174304,168.912103833,6,2,4,1
starkiller,1363.67216686,162.756947592,8,3,5,2
oats,1363.39529303,169.201554677,7,3,4,2
barcode,1363.20036748,213.201456239,3,1,2,1
pursuit,1363.04550446,218.133833012,3,1,2,1
elicik,1362.99850867,218.199714334,3,1,2,1
mustard,1362.700415,157.12868766,6,2,4,2
hufsa,1362.25336206,174.577394493,6,2,4,1
mrsalezz,1361.88036516,214.691351248,3,1,2,1
awol,1361.76798264,219.983102337,3,1,2,1
narutogod666,1361.76798264,220.285190863,3,1,2,1
by9,1361.76798264,219.983102337,3,1,2,1
3d,1361.76798264,220.155775108,3,1,2,1
skrai,1361.76798264,219.853508759,3,1,2,1
saphire121,1361.76798264,220.026283234,3,1,2,1
nik,1361.76798264,220.457627025,3,1,2,1
fancy feast,1361.76798264,220.457627025,3,1,2,1
schoolboyj,1361.76798264,220.069455658,3,1,2,1
hayden f baby,1361.76798264,220.457627025,3,1,2,1
pness,1361.76798264,220.026283234,3,1,2,1
gonzales,1361.76798264,219.983102337,3,1,2,1
basilikus,1361.76798264,220.457627025,3,1,2,1
sassy,1361.76798264,219.637349541,3,1,2,1
astronut,1361.76798264,220.026283234,3,1,2,1
ozley,1361.76798264,220.026283234,3,1,2,1
lurogmz,1361.76798264,219.983102337,3,1,2,1
intrances,1361.76798264,219.983102337,3,1,2,1
carpet,1361.76798264,219.983102337,3,1,2,1
cod,1361.76798264,220.026283234,3,1,2,1
axiom,1361.76798264,220.285190863,3,1,2,1
jagz,1361.44270608,250.206514859,7,3,4,2
sausage948,1361.43272331,161.417192328,9,3,6,2
link strife,1361.01040325,151.257247237,7,2,5,1
sadu,1360.95733658,210.272033075,3,1,2,1
truski,1360.9345691,171.039416186,6,2,4,1
bluue,1360.83338847,219.370017756,3,1,2,1
izze,1360.62488063,171.321756768,7,2,5,1
jbuzzybee,1360.52363333,130.68200102,12,4,8,2
zero fox given,1360.40035149,215.263559706,3,1,2,1
theroy734,1360.37312171,212.759157858,3,1,2,1
the ta,1359.89384378,205.771117485,3,1,2,1
blackbomber,1359.65361281,232.822472815,3,1,2,1
akaboshi,1359.45225451,216.16321256,3,1,2,1
soggy,1359.40037823,220.558774728,3,1,2,1
kamek,1359.17180992,187.595148871,6,2,4,2
altr0n,1358.80347389,219.223658762,3,1,2,1
walby,1358.75312466,207.50225507,4,1,3,2
lars_beleren,1358.60106748,209.96676378,4,2,2,1
voa,1358.35212367,227.675086466,3,1,2,1
spencert,1358.35212367,227.883621609,3,1,2,1
fice,1358.35212367,227.883621609,3,1,2,1
trust,1358.35212367,228.674320809,3,1,2,2
sickboy supreme,1358.35212367,228.258504765,3,1,2,1
noodl-d,1358.35212367,227.841929849,3,1,2,1
warhaxs,1358.35212367,227.841929849,3,1,2,1
meeko,1358.35212367,227.841929849,3,1,2,1
-philip coast philip-,1358.35212367,227.466360145,3,1,2,1
abc,1358.35212367,227.675086466,3,1,2,1
eastrock,1358.35212367,228.258504765,3,1,2,1
boptimus,1358.35212367,227.80023046,3,1,2,1
sevag,1358.35212367,227.675086466,3,1,2,1
xanthus,1358.35212367,228.258504765,3,1,2,1
dannyd,1358.35212367,227.80023046,3,1,2,1
butterysmooth,1358.35212367,228.091966096,3,1,2,1
korobeniki,1358.35212367,228.258504765,3,1,2,1
i fucking hate this game,1358.35212367,228.258504765,3,1,2,1
bombproof,1358.22654963,181.713270732,6,2,4,2
queen,1358.18173039,136.743223239,10,3,7,2
mr.pvblo,1357.80814563,209.309191497,3,1,2,1
2 trainz,1357.60859461,151.463341804,9,3,6,2
adct,1356.93409696,203.207725127,4,2,2,1
poopydungman,1356.77729439,176.514307638,5,2,3,1
king armando,1356.71193983,187.561739946,5,1,4,1
abszol,1356.66509183,201.133283425,3,1,2,1
sauce,1356.42145672,131.759975274,15,5,10,3
metanoia,1356.40938026,147.198229816,7,2,5,1
dolphin,1356.3943755,219.561801355,3,1,2,1
psydoc,1356.3943755,219.561801355,3,1,2,1
raidos,1356.35415617,156.638035676,8,2,6,2
locksmith,1356.08703056,226.498319529,3,1,2,1
jtk,1356.08703056,226.498319529,3,1,2,1
not thor,1356.08703056,226.624113345,3,1,2,1
jackzilla,1356.08703056,226.288507772,3,1,2,1
glasper,1356.08703056,226.414418157,3,1,2,1
snice,1356.08703056,226.707937112,3,1,2,1
teriwaki,1355.9293421,212.45672277,3,1,2,1
hentai69,1355.5280911,203.478188299,3,1,2,1
dvid,1355.50135176,167.257006172,7,2,5,1
big l,1355.41836912,267.634584276,1,0,1,1
some kind of cadwallader,1355.41836912,267.918403065,1,0,1,1
sackofwine,1355.41836912,267.882942161,7,2,5,2
bobbyxm,1355.26786036,262.817024391,1,0,1,1
trevor,1355.23796836,175.734995377,13,5,8,3
duck chris,1355.23382166,173.042665322,6,2,4,2
hazystalebread,1355.04236711,152.961860226,10,3,7,4
oless,1355.03369879,174.456481824,5,1,4,1
moment,1354.64954541,201.799597739,3,1,2,1
radeon,1354.59822084,232.060831146,2,0,2,1
tailz,1354.56857283,122.861442259,14,5,9,2
jankz,1354.56588835,214.019277089,10,3,7,3
ktpt,1354.55341466,229.811672005,2,0,2,1
skin ticket,1354.43505711,220.822881035,3,1,2,1
yam$,1354.3843489,177.62054724,6,2,4,2
ciex,1354.15326463,207.281091435,4,1,3,1
s.o.s.,1353.79175303,187.889527603,4,1,3,1
buckskinbay,1353.69239695,196.466246247,3,1,2,1
milo,1353.59072737,134.369669099,12,4,8,4
asscastle,1353.39838222,209.744207506,3,1,2,1
bandito,1353.2883006,200.99117731,4,1,3,1
tourist,1353.23654267,226.073711606,3,1,2,1
shenanigans,1353.07491323,171.191942724,6,2,4,2
dw,1353.06359132,139.093632712,11,4,7,2
rome,1352.60931885,186.025908746,6,2,4,2
kre,1352.14962077,186.445415572,5,1,4,1
rico,1351.9919277,135.067478214,11,4,7,3
dabs,1351.85666471,128.435545724,17,6,11,2
smurf,1351.68147241,137.133309057,10,4,6,3
savage lionfish,1351.60542892,176.189712101,6,2,4,1
magellan,1351.60542892,176.189712101,6,2,4,1
jakemchale,1351.50976681,215.744866964,3,1,2,1
irv,1351.49921445,265.591243417,1,0,1,1
booty,1351.37609335,214.332593043,3,1,2,1
clock,1350.94199623,179.136595561,5,1,4,2
bez,1350.82254021,128.094955752,23,6,17,3
ryebread,1350.62523071,215.292680481,3,1,2,1
jab,1350.57327829,141.518533577,13,4,9,4
dan,1350.28460555,229.256858647,3,1,2,1
sylvx,1349.82018384,178.372558102,6,2,4,2
joe,1349.80645887,214.53206623,3,1,2,1
eevee,1349.76111294,216.28008972,3,1,2,1
sdmage,1349.76111294,216.675049808,3,1,2,1
jonksy,1349.59548149,178.38545632,6,2,4,1
null,1349.4987996,207.053536784,3,1,2,2
cyberabbit ,1349.24601138,154.305503363,7,2,5,1
frizz,1349.24337272,220.359691608,3,1,2,1
maw,1349.20511273,133.239697575,13,5,8,2
brando550,1349.17779487,216.482783877,3,1,2,1
smeagle,1349.16811395,198.488682321,4,1,3,1
k$o,1349.080447,175.472818462,6,2,4,2
stepdad,1348.70024781,216.441416365,3,1,2,1
chibi,1348.45031088,177.064477952,6,2,4,2
weedle_v,1347.22641962,166.284133449,7,2,5,1
wff,1346.86640787,181.976483214,6,2,4,1
pumpkinleaf,1346.86640787,181.976483214,6,2,4,1
stripes,1346.79442387,202.042096289,4,1,3,1
anto,1346.67289203,152.94333224,9,3,6,2
big papi,1346.23424439,138.75773315,10,3,7,2
amaru,1346.05143571,218.661463706,3,1,2,1
young will,1345.73003104,162.953089861,10,4,6,4
i-mad,1345.72794207,228.428033954,3,1,2,1
youngjiddle,1345.44458866,227.898922993,3,1,2,1
cyborg,1345.43354153,230.423275791,3,1,2,1
mahatma,1345.32967136,191.521826879,4,1,3,1
marth vader,1345.29218869,220.664213507,3,1,2,1
bambi,1345.20763145,162.538408204,10,3,7,2
mortecael,1344.9837088,228.212912841,3,1,2,1
shug,1344.95095772,154.911356494,9,3,6,3
ram,1344.83250041,180.659449267,4,1,3,1
rush,1344.74561713,152.11285006,12,3,9,3
gizmodro,1344.67146746,171.288635749,6,2,4,2
sparkbrain,1344.46805162,185.006925653,5,1,4,1
x3n0,1342.92540519,182.693148975,5,1,4,1
magicalarmanjan,1342.92540519,182.693148975,5,1,4,1
froll3,1342.62765394,185.554497437,4,1,3,1
yandi,1342.48032907,253.248646625,1,0,1,1
dimarx,1341.70566442,226.867781627,2,0,2,1
hoyt,1340.78177824,216.156505406,3,1,2,1
ruckus,1340.69127753,265.135823755,1,0,1,1
samo,1340.6451148,266.092602156,1,0,1,1
t2,1340.23396962,170.875126301,6,2,4,2
wille1923,1340.15189171,175.509680184,5,1,4,1
g0mega,1339.97643575,222.798764795,3,1,2,1
amz,1339.70551415,176.653947425,6,2,4,1
88,1339.5828169,231.280136284,2,0,2,1
sususuueeeeloooo!!!!,1339.42141313,174.398652953,5,1,4,1
snover,1338.68458714,192.195380114,5,1,4,2
triz,1338.67174156,172.942111234,6,2,4,1
clusterfuckhead,1338.52759262,156.39471978,7,2,5,1
speedboi,1338.16448829,255.960017249,1,0,1,1
seto,1337.81680084,174.519181595,5,2,3,1
stoozyfloozy,1337.78799739,291.047670779,1,0,1,1
dewster,1337.78799739,290.524950161,1,0,1,1
sadcock,1337.78799739,290.786427926,1,0,1,1
mcatorri,1337.78799739,290.786427926,1,0,1,1
rezo,1337.78799739,290.426835306,1,0,1,1
mattjew,1337.78799739,290.786427926,1,0,1,1
vianny,1337.78799739,290.884421491,1,0,1,1
nimblebejack,1337.78799739,290.786427926,1,0,1,1
maytag,1337.78799739,290.524950161,1,0,1,1
lava,1337.78799739,290.524950161,1,0,1,1
datmawson,1337.78799739,290.753756065,1,0,1,1
bruff,1337.78799739,290.655718447,1,0,1,1
rollinsky,1337.78799739,290.884421491,1,0,1,1
yena,1337.78799739,290.524950161,1,0,1,1
lime,1337.78799739,290.786427926,1,0,1,1
jd,1337.78799739,290.786427926,1,0,1,1
garnet,1337.78799739,290.55764775,1,0,1,1
edward,1337.78799739,290.524950161,1,0,1,1
gummynerd01,1337.78799739,290.786427926,1,0,1,1
garrettxvx,1337.78799739,290.655718447,1,0,1,1
the rod,1337.78799739,290.786427926,1,0,1,1
xyzp,1337.78799739,290.884421491,1,0,1,1
angel,1337.78799739,290.884421491,1,0,1,1
pawl,1337.78799739,290.786427926,1,0,1,1
quiche,1337.78799739,290.524950161,1,0,1,1
mewtroid,1337.78799739,290.426835306,1,0,1,1
slinkman,1337.78799739,290.55764775,1,0,1,1
berg,1337.78799739,290.263236849,1,0,1,1
mister krabbs,1337.78799739,290.786427926,1,0,1,1
bootyflute,1337.78799739,290.655718447,1,0,1,1
emperor ivan,1337.78799739,291.047670779,1,0,1,1
quentendo,1337.78799739,290.426835306,1,0,1,1
paxinchristo,1337.78799739,291.047670779,1,0,1,1
ryden hope,1337.78799739,290.524950161,1,0,1,1
mindchanger,1337.78799739,291.047670779,1,0,1,1
volmarrk,1337.78799739,290.524950161,1,0,1,1
nate,1337.78799739,290.524950161,1,0,1,1
clam,1337.78799739,290.753756065,1,0,1,1
smash bro virgin,1337.78799739,290.786427926,1,0,1,1
zukon,1337.78799739,290.753756065,1,0,1,1
spt,1337.78799739,290.55764775,1,0,1,1
rollock,1337.78799739,291.047670779,1,0,1,1
gomer,1337.78799739,291.047670779,1,0,1,1
suff,1337.78799739,290.884421491,1,0,1,1
yung young,1337.78799739,291.047670779,1,0,1,1
nostromo,1337.78799739,290.884421491,1,0,1,1
sloth_behr,1337.78799739,290.786427926,1,0,1,1
colt,1337.78799739,290.753756065,1,0,1,1
naxx,1337.78799739,290.786427926,1,0,1,1
bchan,1337.78799739,290.426835306,1,0,1,1
em,1337.78799739,291.047670779,1,0,1,1
rattigan,1337.78799739,291.047670779,1,0,1,1
mokkori,1337.78799739,291.047670779,1,0,1,1
bluevii,1337.78799739,290.786427926,1,0,1,1
no_johns,1337.78799739,290.786427926,1,0,1,1
paid2spade,1337.78799739,290.786427926,1,0,1,1
thunder mlee,1337.78799739,290.753756065,8,3,5,2
cjscaduto,1337.78799739,291.047670779,1,0,1,1
joat,1337.78799739,290.426835306,1,0,1,1
mostlyred,1337.78799739,290.524950161,1,0,1,1
melvenorc12,1337.78799739,291.047670779,1,0,1,1
showmeyobobs,1337.78799739,290.786427926,1,0,1,1
icey,1337.78799739,290.786427926,1,0,1,1
falcouser,1337.78799739,290.426835306,1,0,1,1
fehrain,1337.78799739,290.786427926,1,0,1,1
king james,1337.78799739,290.426835306,1,0,1,1
dxovid,1337.78799739,290.786427926,1,0,1,1
vdx,1337.78799739,290.524950161,1,0,1,1
altex,1337.78799739,290.884421491,1,0,1,1
rashidajones,1337.78799739,290.55764775,1,0,1,1
dopamine,1337.78799739,290.524950161,1,0,1,1
geostigma,1337.78799739,290.786427926,1,0,1,1
swåç,1337.78799739,290.524950161,1,0,1,1
adobro,1337.78799739,291.047670779,1,0,1,1
novice,1337.78799739,290.786427926,1,0,1,1
getnikkdon,1337.78799739,290.884421491,1,0,1,1
cc,1337.78799739,291.047670779,1,0,1,1
ethicks,1337.78799739,290.263236849,1,0,1,1
flan,1337.78799739,291.047670779,1,0,1,1
misting,1337.78799739,290.688401327,1,0,1,1
whiskeytits,1337.78799739,291.047670779,1,0,1,1
no blanket,1337.78799739,291.047670779,1,0,1,1
sinbaddie,1337.78799739,290.786427926,1,0,1,1
ubll black mage,1337.78799739,290.753756065,1,0,1,1
improlifics,1337.78799739,290.786427926,1,0,1,1
holdenmyd,1337.78799739,290.786427926,1,0,1,1
jujubeen,1337.78799739,290.426835306,1,0,1,1
soulless,1337.78799739,290.524950161,1,0,1,1
matx,1337.78799739,291.047670779,1,0,1,1
limen,1337.78799739,290.524950161,1,0,1,1
quada,1337.78799739,291.047670779,1,0,1,1
s@nt,1337.78799739,291.047670779,1,0,1,1
ilovesmok,1337.78799739,290.786427926,1,0,1,1
natural,1337.78799739,290.786427926,1,0,1,1
greyarsenic,1337.78799739,290.786427926,1,0,1,1
etc,1337.78799739,291.047670779,1,0,1,1
crawshaw,1337.78799739,290.426835306,1,0,1,1
tangent,1337.78799739,290.426835306,1,0,1,1
yo-yo,1337.78799739,290.263236849,1,0,1,1
bt$,1337.78799739,290.426835306,1,0,1,1
bayes,1337.78799739,291.047670779,1,0,1,1
grigri,1337.78799739,290.263236849,1,0,1,1
flow,1337.78799739,291.047670779,1,0,1,1
thewizard,1337.78799739,290.884421491,1,0,1,1
jstyles,1337.78799739,290.786427926,1,0,1,1
wheatley,1337.78799739,290.426835306,1,0,1,1
dannar,1337.78799739,290.263236849,1,0,1,1
5'10,1337.78799739,290.426835306,1,0,1,1
banj0,1337.78799739,290.786427926,1,0,1,1
burst,1337.78799739,290.786427926,1,0,1,1
yeah~ok,1337.78799739,290.884421491,1,0,1,1
actualgarbage,1337.78799739,290.524950161,1,0,1,1
odon,1337.78799739,290.55764775,1,0,1,1
brizzy,1337.78799739,290.753756065,9,5,4,2
tetrash0t,1337.78799739,290.263236849,1,0,1,1
tomoliver,1337.78799739,290.786427926,1,0,1,1
jkcc,1337.78799739,290.753756065,1,0,1,1
nanas,1337.78799739,290.524950161,1,0,1,1
swoop,1337.78799739,291.047670779,1,0,1,1
big tone,1337.78799739,291.047670779,1,0,1,1
this guy fox,1337.78799739,290.786427926,1,0,1,1
zolomon,1337.78799739,290.55764775,1,0,1,1
vander,1337.78799739,290.426835306,1,0,1,1
winter,1337.78799739,291.047670779,1,0,1,1
bob sura,1337.78799739,291.047670779,1,0,1,1
connoramo,1337.78799739,290.524950161,1,0,1,1
harkules,1337.78799739,290.426835306,1,0,1,1
schmeckles,1337.78799739,290.786427926,1,0,1,1
paulaver,1337.78799739,290.786427926,1,0,1,1
roller,1337.78799739,290.753756065,1,0,1,1
jibca,1337.78799739,291.047670779,1,0,1,1
bd,1337.78799739,290.786427926,1,0,1,1
khoid,1337.78799739,291.047670779,1,0,1,1
glenn coco,1337.78799739,290.786427926,1,0,1,1
bonestorm,1337.78799739,290.524950161,1,0,1,1
scooter,1337.78799739,291.047670779,1,0,1,1
holy,1337.78799739,290.786427926,1,0,1,1
oceslio,1337.78799739,290.786427926,1,0,1,1
pyrel,1337.78799739,290.786427926,1,0,1,1
cupcake pirate,1337.78799739,290.524950161,1,0,1,1
flics,1337.78799739,290.524950161,1,0,1,1
mootumog,1337.78799739,290.753756065,1,0,1,1
spicky,1337.78799739,290.524950161,1,0,1,1
snow flake,1337.78799739,290.426835306,1,0,1,1
elrondel,1337.78799739,290.786427926,1,0,1,1
rng,1337.78799739,290.786427926,1,0,1,1
norbu,1337.78799739,290.524950161,1,0,1,1
frostybroshake,1337.78799739,290.55764775,1,0,1,1
midnight,1337.78799739,290.55764775,1,0,1,1
amne,1337.78799739,290.426835306,1,0,1,1
kid manager,1337.78799739,290.426835306,1,0,1,1
kreylekz,1337.78799739,291.047670779,1,0,1,1
ironflame,1337.78799739,291.047670779,1,0,1,1
brayll,1337.78799739,290.786427926,1,0,1,1
locke robster,1337.78799739,290.884421491,1,0,1,1
zaffhead,1337.78799739,290.786427926,1,0,1,1
juiceee,1337.78799739,290.55764775,1,0,1,1
metalheadgx,1337.78799739,290.884421491,1,0,1,1
idlebot,1337.78799739,290.786427926,1,0,1,1
ecogamer,1337.78799739,290.786427926,1,0,1,1
the rake,1337.78799739,290.426835306,1,0,1,1
colbydude,1337.78799739,290.263236849,1,0,1,1
waffle,1337.78799739,290.524950161,1,0,1,1
portalboy,1337.78799739,290.786427926,1,0,1,1
broseidon,1337.78799739,290.688401327,1,0,1,1
rabid glitter,1337.78799739,291.047670779,1,0,1,1
kakpu,1337.78799739,290.492248891,1,0,1,1
oni shin,1337.78799739,290.492248891,1,0,1,1
chauster,1337.78799739,290.786427926,1,0,1,1
gutes,1337.78799739,290.524950161,1,0,1,1
midorima,1337.78799739,290.786427926,1,0,1,1
meghna,1337.78799739,291.047670779,1,0,1,1
tkthoughts,1337.78799739,290.753756065,1,0,1,1
i.c. wiener,1337.78799739,291.047670779,1,0,1,1
killjoy,1337.78799739,290.786427926,1,0,1,1
studkip,1337.78799739,290.786427926,1,0,1,1
shelby,1337.78799739,290.786427926,1,0,1,1
tadeo,1337.78799739,290.786427926,1,0,1,1
blackmagic754,1337.78799739,291.047670779,1,0,1,1
albexican,1337.78799739,290.55764775,1,0,1,1
salsaranch,1337.78799739,290.786427926,1,0,1,1
kashi,1337.78799739,290.884421491,1,0,1,1
theworstmaker,1337.78799739,290.786427926,1,0,1,1
urbok,1337.78799739,290.884421491,1,0,1,1
kevinw0w,1337.78799739,290.786427926,1,0,1,1
j-train,1337.78799739,290.786427926,1,0,1,1
noflexzone,1337.78799739,291.047670779,1,0,1,1
you'repizza,1337.78799739,291.047670779,1,0,1,1
mirub,1337.78799739,290.786427926,1,0,1,1
peachtea,1337.78799739,290.786427926,1,0,1,1
gab,1337.78799739,291.047670779,1,0,1,1
teeeckskay,1337.78799739,290.786427926,1,0,1,1
afterlife,1337.78799739,290.426835306,1,0,1,1
sailor mercury,1337.78799739,290.524950161,1,0,1,1
enjoiful,1337.78799739,291.047670779,1,0,1,1
hzawa,1337.78799739,290.786427926,1,0,1,1
pg-13,1337.78799739,290.786427926,1,0,1,1
shubs,1337.78799739,290.524950161,1,0,1,1
johnknight1,1337.78799739,291.047670779,1,0,1,1
bearjew,1337.78799739,290.786427926,1,0,1,1
needlenips,1337.78799739,290.786427926,1,0,1,1
park,1337.78799739,290.786427926,1,0,1,1
crux do,1337.78799739,290.786427926,1,0,1,1
beekeeper bill,1337.78799739,290.786427926,1,0,1,1
bonzibuddy,1337.78799739,290.786427926,1,0,1,1
ehro,1337.78799739,290.524950161,1,0,1,1
moju,1337.78799739,290.55764775,1,0,1,1
archangel wizard,1337.78799739,290.786427926,1,0,1,1
p33k,1337.78799739,290.786427926,1,0,1,1
karby,1337.78799739,290.786427926,1,0,1,1
tvomusic,1337.78799739,290.55764775,1,0,1,1
benzzyzx,1337.78799739,290.55764775,1,0,1,1
tj.wombo,1337.78799739,290.786427926,1,0,1,1
anocturnalwar,1337.78799739,290.786427926,1,0,1,1
zeemz,1337.78799739,290.786427926,1,0,1,1
atx carlos,1337.78799739,290.786427926,1,0,1,1
bruslwip,1337.78799739,290.786427926,1,0,1,1
rinzler,1337.78799739,290.786427926,1,0,1,1
sid,1337.78799739,290.524950161,1,0,1,1
veloc,1337.78799739,290.426835306,1,0,1,1
hinglemccringleberry,1337.78799739,290.753756065,1,0,1,1
tomb,1337.78799739,290.263236849,1,0,1,1
eddwardo,1337.78799739,290.426835306,1,0,1,1
ren,1337.78799739,290.426835306,1,0,1,1
insufficient heat,1337.78799739,291.047670779,1,0,1,1
mcwaffles,1337.78799739,290.263236849,1,0,1,1
ivanooz,1337.78799739,290.786427926,1,0,1,1
gustavocantuf,1337.78799739,290.786427926,1,0,1,1
young_list,1337.78799739,291.047670779,1,0,1,1
svante,1337.78799739,290.786427926,1,0,1,1
tk,1337.78799739,290.55764775,1,0,1,1
hypn0tiq,1337.78799739,290.426835306,1,0,1,1
j-ro,1337.78799739,290.786427926,1,0,1,1
grackle sniper,1337.78799739,290.786427926,1,0,1,1
kounotori,1337.78799739,290.426835306,1,0,1,1
pollaentuboca,1337.78799739,290.786427926,1,0,1,1
b33f,1337.78799739,290.55764775,1,0,1,1
jakulo,1337.78799739,290.786427926,1,0,1,1
derpfish,1337.78799739,290.655718447,1,0,1,1
creamboy advanced,1337.78799739,290.524950161,1,0,1,1
mucho man randy passion,1337.78799739,291.047670779,1,0,1,1
hail.hades,1337.78799739,290.786427926,1,0,1,1
lukie,1337.78799739,290.688401327,1,0,1,1
original ginger,1337.78799739,290.884421491,1,0,1,1
toxic sock,1337.78799739,290.786427926,1,0,1,1
catan,1337.78799739,290.524950161,1,0,1,1
octoale,1337.78799739,290.786427926,1,0,1,1
conair,1337.78799739,291.047670779,1,0,1,1
renegade hexer,1337.78799739,291.047670779,1,0,1,1
murphy,1337.78799739,290.655718447,1,0,1,1
ango,1337.78799739,291.047670779,1,0,1,1
tingsing,1337.78799739,290.884421491,1,0,1,1
sexyalexy,1337.78799739,290.55764775,1,0,1,1
lyric,1337.61597968,140.290307344,17,7,10,5
p-watts,1337.50168252,221.415251137,3,1,2,1
woogieboogie,1337.4980586,149.758814526,10,3,7,5
lodestar,1337.2240469,235.641144717,3,1,2,2
dogs_johnson,1337.21904421,173.13319867,6,2,4,2
monk,1337.17483412,178.084751152,6,2,4,2
fatefiend,1337.14704724,209.297511176,4,1,3,2
leather,1336.47721458,177.669704877,5,2,3,1
toucan,1336.21048242,178.65372131,6,2,4,2
justice,1335.98852442,184.721828717,5,1,4,1
soul,1335.81170058,141.906914807,9,3,6,2
jaaj,1335.73644544,258.919921532,1,0,1,1
sluggo,1335.65681698,232.634752209,3,1,2,1
segfault,1335.12710804,177.538854575,6,2,4,2
bombchu,1335.11032527,214.616880254,3,1,2,1
bunz,1334.52116727,212.96835709,3,1,2,1
samson,1334.46099888,232.307828773,9,4,5,2
esmod,1334.38247491,271.598695277,2,0,2,1
elaktomte,1334.22986926,162.014400107,7,2,5,1
caveman?,1333.56438248,170.780069464,5,1,4,1
gm,1333.35019101,198.408118922,3,1,2,1
hyperbole,1332.88737202,229.445642898,2,0,2,1
fick,1332.55421913,225.177308381,3,1,2,1
meguca,1332.52360595,209.20976259,4,1,3,1
flarecinder,1332.52360595,209.20976259,4,1,3,1
sunny,1332.52360595,209.663360564,4,1,3,1
icahandlarn,1332.52360595,209.572719511,4,1,3,1
shais young,1332.52360595,209.572719511,11,4,7,2
toasty,1332.52360595,209.436684378,10,4,6,2
zelms,1332.52360595,209.572719511,4,1,3,1
tanwad,1332.05400685,209.72756591,4,1,3,2
fjt,1331.94333078,212.653535739,3,1,2,1
swing,1331.92674743,219.677423252,3,1,2,1
robo,1331.84844679,182.883221657,6,2,4,2
wine,1331.76254025,210.526202392,4,1,3,2
professor compressor,1331.73288907,153.148594662,11,3,8,2
vidya_james,1331.72039184,210.183967812,4,1,3,2
daniels,1331.71934575,210.16075661,4,1,3,2
tjockisbulle,1331.64701982,203.004659372,5,1,4,1
xhinthink,1331.64701982,203.004659372,5,1,4,1
paragon,1331.61506304,210.750609336,4,1,3,2
treechen,1331.61506304,210.750609336,4,1,3,2
raalts,1331.56791285,154.345746512,9,3,6,3
badger,1331.5308434,210.878654013,4,1,3,2
#pppp9lr8,1331.21753629,201.95824575,5,1,4,1
zalz,1331.21753629,201.95824575,5,1,4,1
n-boss,1331.14277437,214.274767541,3,1,2,1
smashyoface,1330.56802213,259.671460319,1,0,1,1
gunfer,1330.51878899,267.032368669,1,0,1,1
kavorca,1329.74250976,187.286825287,5,1,4,1
sedrader,1329.7031898,214.13885352,4,1,3,2
dice,1329.69400819,182.566156549,7,2,5,2
bunnyblast,1329.08040868,176.881573776,7,2,5,3
tehenderer,1329.03591245,205.139414208,3,1,2,1
platinumrx,1328.86544917,254.630910482,1,0,1,1
lolex,1328.83151886,156.845692966,16,6,10,3
nap,1328.41684045,180.971519424,6,2,4,2
stackdolla$,1328.37958244,254.77781971,2,0,2,1
cube,1328.35346403,141.594586346,11,3,8,3
dio,1328.11556793,151.360782216,10,3,7,3
tay tay swizzle,1328.05487988,180.986473396,6,2,4,2
shazaad,1327.80084374,215.92652408,3,1,2,1
jcxp,1327.62409232,268.589165175,1,0,1,1
i use tap jump,1327.62409232,268.306055931,1,0,1,1
kid a,1327.62409232,268.306055931,1,0,1,1
money man,1327.62409232,268.341460921,1,0,1,1
jsmirk,1327.62409232,268.341460921,1,0,1,1
mistertizye,1327.62409232,268.022647643,1,0,1,1
morning,1327.18243687,167.117877865,7,2,5,1
jlo,1326.9060544,300.250798523,9,5,4,2
zeny,1326.9060544,300.124210976,10,3,7,2
noon,1326.9060544,300.250798523,5,1,4,2
iffy,1326.9060544,300.250798523,7,3,4,2
badbones,1326.83174618,241.094774526,8,4,4,2
bumsqueeze,1326.82876375,257.806105821,1,0,1,1
radbot,1326.1672844,233.325846555,3,1,2,1
buttpounder420,1326.06755175,251.221282207,2,0,2,1
blizzy nuggs,1326.06496867,217.562996815,3,1,2,1
quasi,1325.88588239,151.61152431,10,3,7,2
sirencresselia,1325.74388418,224.096048063,2,0,2,1
egal,1325.53596456,188.686163509,4,1,3,1
pooodge,1325.52397065,227.80023046,3,1,2,1
ocni,1325.52397065,227.466360145,3,1,2,1
chagnon,1325.52397065,227.466360145,3,1,2,1
yung god,1325.52397065,227.466360145,3,1,2,1
buzzbuzz,1325.52397065,228.258504765,3,1,2,1
harvest,1325.52397065,228.091966096,10,4,6,2
tamn son!,1325.52397065,227.80023046,3,1,2,1
boh,1325.52397065,227.841929849,3,1,2,1
pika,1325.52397065,228.258504765,3,1,2,1
lejoy,1325.52397065,227.841929849,3,1,2,1
danson,1325.52397065,228.091966096,3,1,2,1
psycho,1325.52397065,227.466360145,3,1,2,1
kuroisekai,1325.52397065,227.841929849,3,1,2,1
duff,1325.52397065,227.675086466,3,1,2,1
lickney,1325.22527704,249.626978472,2,0,2,1
zave,1325.07980071,224.358046712,2,0,2,1
c2,1325.0548803,183.000619171,6,2,4,2
nich,1324.98977875,215.997414509,3,1,2,1
magaroni,1324.91240963,171.978236092,6,2,4,1
curls,1324.85428597,179.027015788,6,2,4,2
soberd,1324.81406695,192.848750167,4,1,3,1
hawkboy1080yt,1324.62412512,209.38753929,4,1,3,2
quest,1324.49400953,194.074848047,6,2,4,2
wiz biz,1324.16964391,169.111733828,6,2,4,1
sevan,1324.16666091,223.202775362,2,0,2,1
jabloinks,1324.05097662,224.124491658,2,0,2,1
joshers,1324.05097662,224.124491658,2,0,2,1
j.tmbr,1324.00317444,191.585804663,5,1,4,1
yor742,1323.50854241,225.631169077,2,0,2,1
larsson,1323.18606751,167.90265498,6,2,4,1
#28898l88,1323.097089,195.518060915,4,1,3,1
gold,1322.8748588,160.790297823,8,2,6,2
big spoon,1322.51001779,166.081064338,6,1,5,1
mariosmasher,1322.49482325,189.560439771,5,1,4,1
gfd,1322.12073446,169.117266764,6,1,5,1
general gengar,1322.02625532,246.887679462,2,0,2,1
jhomas,1321.94761933,226.997222613,3,1,2,1
kido,1321.81169087,246.336011334,2,0,2,1
landry!,1321.57712199,162.319348379,8,2,6,2
chainz,1321.24900898,218.716199207,3,1,2,1
lawngarms,1321.24900898,218.716199207,3,1,2,1
smeedot,1320.08354932,216.675049808,3,1,2,1
uke,1319.64359192,200.59573318,5,2,3,1
hammern,1319.64220524,172.871591856,7,2,5,1
gasai,1319.56791517,247.436098769,2,0,2,1
zabu,1319.37890251,222.971467464,3,1,2,1
the trashman,1319.37890251,222.971467464,3,1,2,1
matthewgu4,1319.15312039,267.053903572,1,0,1,1
2uq22c9u,1318.95652863,192.636342428,5,1,4,1
rahma noodles,1318.95300678,160.118817823,6,2,4,1
d.j.r.,1318.88417384,217.32009579,3,1,2,1
gustavo,1318.1206744,166.648851158,8,2,6,2
yogi,1317.78871898,145.315742235,11,3,8,2
the best,1317.60840155,208.591238966,4,1,3,1
cyb3r,1315.99863584,227.601606932,3,1,2,1
benji,1315.88289213,239.810071328,2,0,2,1
rocksam,1315.8685177,188.692334777,5,1,4,1
squidman808,1315.74489188,175.960008362,5,1,4,2
voice,1315.40478913,170.551731545,7,2,5,3
necky,1315.22504674,159.558426778,7,2,5,1
maxi,1315.21087915,175.563718398,6,2,4,2
vipereyezd,1314.97265926,246.523301112,2,0,2,1
leahboo,1314.53669502,148.527097353,13,3,10,5
i am an owl,1314.50325594,188.289946656,5,1,4,2
porter,1314.39027886,246.345853583,2,0,2,1
providerofsouls,1314.28848931,215.736364361,3,1,2,1
veps,1313.95116917,157.474571035,12,3,9,2
hijo,1313.90966734,192.029537622,4,1,3,1
zinja,1313.71951235,221.551299978,3,1,2,1
lex,1313.60255245,190.647180781,5,1,4,2
moonunit,1313.31954826,255.230268495,1,0,1,1
mr. h,1313.31954826,255.230268495,1,0,1,1
ch14,1313.06085847,228.966607252,3,1,2,1
majersk21,1313.06085847,228.966607252,3,1,2,1
commish,1312.95597788,238.901728517,2,0,2,1
arcana_force,1312.93612292,240.418559849,2,0,2,1
moko,1312.80103681,213.31997608,3,1,2,1
biggusher,1312.77854703,241.506038783,2,0,2,1
tac,1312.5627487,239.697323503,2,0,2,1
havana club,1312.21382842,239.228692427,2,0,2,1
cool blue™,1312.14210917,193.539090228,4,1,3,1
suck,1311.57467861,216.253441824,3,1,2,1
palaver,1311.1975942,237.282114388,2,0,2,1
dole,1311.15887866,253.052155584,2,0,2,1
raxcity,1311.12187978,182.940471091,6,2,4,2
rattmogers,1310.77102519,244.881965523,2,0,2,1
daifuku,1309.73425722,263.039037656,1,0,1,1
saborx,1309.69260898,243.45434438,2,0,2,1
spankers,1309.69260898,243.45434438,2,0,2,1
ahkiat09,1309.50001621,187.023618684,5,1,4,1
pkjoey,1309.48177703,239.746432644,2,0,2,1
musigh,1309.3904448,165.978753419,8,2,6,2
sigmar,1309.38059862,165.376653495,7,2,5,1
thurmiz,1309.32715077,236.866657017,2,0,2,1
pk don,1309.2120989,244.727808991,2,0,2,1
gumby,1309.20806835,240.089300901,2,0,2,1
king boolean,1309.04434296,173.797455976,8,2,6,3
yamin4,1308.91257645,242.684880101,2,0,2,1
harambe,1308.78428601,208.214295587,3,1,2,1
ox,1308.61841625,153.44791828,10,3,7,3
aztec2step,1308.34476459,186.66100166,11,2,9,3
jembosa,1308.29210244,230.339446459,2,0,2,1
ultimat3spaz,1307.98260338,187.271803266,12,2,10,2
dfish,1307.29206019,243.908455748,2,0,2,1
evab,1307.24935549,215.289744662,3,1,2,1
sulgimme,1306.99644399,191.747535535,4,1,3,1
white_bread_ed,1306.67181732,235.194324116,2,0,2,1
drill,1306.63480553,220.951723107,2,0,2,1
joe deveer,1306.40635787,239.264582346,2,0,2,1
sudofox,1306.38018205,240.286222861,2,0,2,1
dreamsicle,1305.89543831,237.150070601,2,0,2,1
tr-8r,1305.54201977,238.044496413,2,0,2,1
cope,1305.0431787,187.625111629,5,1,4,1
hest,1305.0431787,188.029738376,5,1,4,1
striferz,1305.0431787,187.625111629,5,1,4,1
veso,1305.0431787,187.625111629,5,1,4,1
thesneakiestbeaver,1304.71228454,240.976115046,2,0,2,1
killajive,1304.66956359,240.266720941,2,0,2,1
spann,1304.50608657,194.921085502,5,1,4,2
kevinwut,1304.47835578,238.989201934,2,0,2,1
l-gambino,1304.44912865,189.974154643,5,1,4,1
dom,1304.38376973,200.399264192,5,1,4,2
spiritranger99,1304.10133144,225.004201777,3,1,2,1
ruslinjimmies_rj,1304.10133144,225.004201777,3,1,2,1
bleh27,1304.03770512,215.595725109,3,1,2,1
c mill$,1303.71660565,156.366404633,8,2,6,2
r0x,1303.54913444,174.098677332,5,1,4,1
mysterion,1303.43760801,191.795789135,5,1,4,2
#20g9ry2gp,1303.03374297,185.01484542,5,1,4,1
olives,1302.95563959,172.467981671,5,1,4,1
cmac1211,1302.94748506,183.643935475,5,1,4,1
psych,1302.82945109,239.464262802,2,0,2,1
rushhour,1302.07300035,241.885199517,2,0,2,1
wterka,1302.07300035,241.885199517,2,0,2,1
kegypt,1301.75941935,218.306850397,3,1,2,1
red blaze,1301.71932164,154.822943641,9,2,7,2
exaltedoreo,1301.67064234,237.965378782,2,0,2,1
maxsimon123,1301.60963509,164.573674892,10,3,7,2
enqwers,1301.28944391,232.634752209,3,1,2,1
phoenix,1301.24940989,131.420152681,24,8,16,5
contrabass,1301.23603818,237.013720031,2,0,2,1
arcin,1301.08666104,219.567401953,2,0,2,1
elliotxspeedruns,1301.08666104,219.567401953,2,0,2,1
gothoesinareacodes,1300.8224331,177.331248809,6,2,4,2
napi,1300.80470279,183.94466982,5,1,4,1
grublord,1300.66426193,241.734121639,2,0,2,1
sloth-behr,1300.66426193,241.616194748,2,0,2,1
l3ggy,1300.66426193,241.183302831,2,0,2,1
slyfincleton,1300.66426193,241.183302831,2,0,2,1
derilink,1300.66426193,241.301441282,2,0,2,1
hunterlittle,1300.66426193,241.458869302,2,0,2,1
geodude,1300.66426193,241.734121639,2,0,2,1
somethingugly,1300.66426193,241.734121639,5,1,4,2
rod,1300.57121533,231.908055949,2,0,2,1
doubledorf,1299.77057721,210.543018461,4,1,3,2
hiro,1299.76417825,239.061352079,3,1,2,2
sonic,1299.67394696,237.575355492,2,0,2,1
emerald,1299.62280715,222.923113533,3,1,2,1
heads,1299.5922433,226.447930561,2,0,2,1
joker2012,1299.30260064,232.512387167,2,0,2,1
slyben,1299.29408578,233.122283662,2,0,2,1
shum,1299.29408578,233.122283662,2,0,2,1
turkish delight,1299.22595111,223.612074583,2,0,2,1
captain planet,1299.0184199,263.131982781,1,0,1,1
tecnus,1299.0184199,263.131982781,1,0,1,1
redribb0n,1298.56487246,240.29365226,2,0,2,1
gems,1298.00422259,186.84276108,5,1,4,1
kidney,1297.85487084,206.288654333,5,1,4,2
pablopicasso,1297.68935375,232.674074712,2,0,2,1
nards,1297.66161239,245.044786992,2,0,2,1
hyper,1297.39883199,234.833372039,2,0,2,1
negrodomus,1297.29715166,215.895457191,3,1,2,1
tuukkatime,1297.08165294,238.845233207,2,0,2,1
queuess,1297.06791807,179.660624049,8,2,6,3
depressed eagle,1296.71203315,160.490866736,10,2,8,4
doonee,1296.66745025,235.912948502,2,0,2,1
giggitoxin,1296.65161776,237.026179264,2,0,2,1
set!,1296.45542574,237.757068514,2,0,2,1
jeodude,1296.35993838,269.702257709,1,0,1,1
jstar,1296.35310919,203.595014463,5,1,4,2
stonewill,1296.35215309,203.672233289,5,1,4,2
juicé,1296.25098704,234.986513178,2,0,2,1
meteora,1296.21348281,187.417262639,5,1,4,1
gyoska,1295.52211839,242.091967388,2,0,2,1
nvy,1295.44906182,217.922678273,3,1,2,1
blacksite,1295.26711781,202.801345924,5,1,4,2
delta,1294.91562551,164.947831158,8,2,6,2
tashigi,1294.69149503,188.324920878,5,1,4,2
beaver,1294.6452039,238.384549248,2,0,2,1
yogi backair,1294.1081899,215.912186547,2,0,2,1
fez2,1293.57189154,232.78384864,2,0,2,1
guru,1293.56615445,172.031902497,7,2,5,2
yep,1293.34536642,218.576554638,2,0,2,1
st0rmetom,1293.29743793,221.599941957,2,0,2,1
raiden1,1293.18455785,157.581788857,7,2,5,1
japlorp,1293.12094044,237.401977919,2,0,2,1
majorleagueturtle,1292.91284833,179.61156644,5,1,4,2
seraph,1292.80874719,233.260992581,2,0,2,1
helm,1292.54129475,235.713285812,2,0,2,1
c4,1292.41747097,219.786225909,3,1,2,1
overly minus,1292.40180252,238.88329154,2,0,2,1
nope,1292.30972395,233.898369528,2,0,2,1
blueeco,1292.30425763,201.993710644,5,1,4,2
flwns,1292.17967533,202.497606403,5,1,4,2
barry seanders,1291.96249167,214.947945923,3,1,2,1
kjrfox,1291.58801883,226.073711606,3,1,2,1
rugaru,1291.46247114,234.069931331,2,0,2,1
ooookillem,1291.40702584,238.696834994,2,0,2,1
woofpack,1291.24011258,181.746161788,5,1,4,2
flawlesskills,1291.15446767,239.274879261,2,0,2,1
uguize,1291.15446767,239.1954595,2,0,2,1
chirka,1291.15446767,239.592295046,2,0,2,1
shakey,1291.15446767,239.592295046,2,0,2,1
joff,1291.15446767,239.35427267,2,0,2,1
skreww l00se,1291.15446767,238.996794634,2,0,2,1
nuts4nuts4nuts,1291.15446767,239.314579258,2,0,2,1
slugimus,1291.10299034,234.185009152,2,0,2,1
jonk,1290.9316498,228.109000594,2,0,2,1
els3y,1290.86059334,237.378325439,2,0,2,1
ds,1290.78046179,157.531605623,7,2,5,1
insector,1290.28316814,179.880457404,5,1,4,1
flat nat,1290.26803716,234.225965729,2,0,2,1
takeover,1290.20819596,172.735141016,8,2,6,4
voodoo man,1290.02876337,173.080931752,6,2,4,2
hurricane,1289.97792593,238.144609396,2,0,2,1
nacl,1289.73422479,201.137098873,5,1,4,2
veghard,1289.68678336,169.117266764,6,1,5,1
veggietalesdeluxe,1289.62896641,233.021125944,2,0,2,1
beanpaste,1289.61161185,237.636630997,2,0,2,1
curiousplaces,1289.26681316,251.44830814,2,0,2,1
a$ce,1289.26681316,251.599387253,2,0,2,1
theeagle3805,1289.26681316,251.599387253,2,0,2,1
shanazz,1289.26681316,251.486086427,2,0,2,1
nessnger,1289.26681316,251.486086427,2,0,2,1
oddyesy,1289.26681316,251.599387253,2,0,2,1
bao the wyld,1289.26681316,251.410524176,2,0,2,1
raiguy,1289.26681316,251.410524176,2,0,2,1
delfino,1289.26681316,251.599387253,2,0,2,1
wigglywuigimain ,1288.72315248,219.682481557,3,1,2,1
jag älskar avatar123,1288.36337604,201.504644738,3,0,3,1
doujin logic,1288.30066678,151.773533412,11,3,8,4
weavle,1288.09758662,203.315495311,5,1,4,3
maxthunder,1288.02032094,167.065112824,6,1,5,1
wik,1287.44423867,175.577111971,5,1,4,1
otter,1287.4182808,233.983597467,2,0,2,1
zytral,1287.33533336,233.831430236,2,0,2,1
fija,1287.29507695,235.622462861,2,0,2,1
aedrenaline,1287.24754214,201.430472565,5,1,4,2
derg,1286.98219734,236.5739729,2,0,2,1
swing first,1286.98219734,236.413292041,2,0,2,1
hambi,1286.98219734,235.809763695,2,0,2,1
flaze,1286.9563748,232.163660135,2,0,2,1
caff3in3fr33,1286.9563748,232.163660135,2,0,2,1
marionette,1286.94993981,163.985979986,8,2,6,2
kliner,1286.62048162,239.424564725,2,0,2,1
linkguy23,1286.57933533,233.622912526,2,0,2,1
sped,1286.56990518,187.028856742,5,1,4,1
nuggyjones,1286.5047971,239.476158591,2,0,2,1
omni_,1286.22493323,231.719772783,3,1,2,1
stoc,1286.18345334,177.422052999,6,2,4,2
a-v-ill,1285.62807959,186.248991823,5,1,4,2
kaiser,1285.49524486,160.640370928,9,2,7,2
hsy,1285.37695621,235.349755063,2,0,2,1
mr. beet,1285.37695621,235.349755063,2,0,2,1
iintrigue,1285.36597675,248.449922003,2,0,2,1
fishguts,1285.30691703,232.328859446,2,0,2,1
boozki,1285.11995292,239.392674938,2,0,2,1
therapture_,1285.08787643,167.572421236,11,3,8,4
maven,1285.04708917,191.037099354,4,1,3,1
jamz,1284.99994262,220.629114934,2,0,2,1
lolimacat,1284.95481892,230.977275377,2,0,2,1
sdking,1284.93984443,252.538421517,2,0,2,1
jettset,1284.80077303,274.337750112,1,0,1,1
longlegs,1284.80077303,274.060579319,1,0,1,1
double hl,1284.80077303,274.580045044,1,0,1,1
backwards god,1284.80077303,274.337750112,1,0,1,1
jclone,1284.80077303,274.580045044,1,0,1,1
the chef,1284.80014793,223.598692608,2,0,2,1
yopedd,1284.72711848,234.475866278,2,0,2,1
shabman productions,1284.69881792,268.13740015,9,5,4,2
gree,1284.57907663,238.472057846,2,0,2,1
yardo,1284.52741596,209.071362039,3,0,3,1
allpain,1284.35810813,194.858549107,5,1,4,2
baumwolle8,1284.22464729,237.929178928,2,0,2,1
jisu,1283.99801394,156.756077583,8,2,6,3
ddhs,1283.99063925,181.867756209,6,1,5,1
axel,1283.9873334,227.575261674,3,1,2,1
krakennrv-,1283.78581075,179.927504849,5,1,4,1
rbm,1283.67024814,194.633939234,5,1,4,1
kivo,1283.67024814,194.633939234,5,1,4,1
nashi,1283.67024814,194.633939234,5,1,4,1
glockodile,1283.67024814,194.633939234,5,1,4,1
venitas,1283.67024814,194.633939234,5,1,4,1
dan soup,1283.67024814,194.633939234,12,1,11,2
koopa,1283.67024814,194.633939234,5,1,4,1
pink flamingo,1283.67024814,194.633939234,5,1,4,1
hensdaddy,1283.67024814,194.243070151,5,1,4,1
nefe,1283.67024814,194.633939234,5,1,4,1
2ddj,1283.67024814,194.633939234,12,2,10,2
endofstory,1283.67024814,194.633939234,12,6,6,2
bach,1283.67024814,194.633939234,7,1,6,2
patsheezy,1283.67024814,194.633939234,12,5,7,2
vedbod,1283.67024814,194.633939234,5,1,4,1
swish,1283.67024814,194.633939234,12,3,9,2
butrs,1283.67024814,194.243070151,5,1,4,1
jebu,1283.67024814,194.633939234,5,1,4,1
karvaperse666,1283.67024814,194.633939234,5,1,4,1
gunn,1283.67024814,194.633939234,5,1,4,1
jacobarf,1283.67024814,194.633939234,5,1,4,1
recneps,1283.64569204,179.916231552,6,1,5,1
l3375,1283.23757638,228.805623732,2,0,2,1
vonquack,1283.04152694,161.175053818,7,1,6,1
itchyanscratchy,1282.83278082,237.760042229,2,0,2,1
zee,1282.81863598,186.171253541,12,5,7,2
typicalswattie,1282.63041477,226.15255489,3,1,2,1
josamabinladen,1282.59650391,235.278299563,2,0,2,1
snape,1282.32112806,230.275317814,2,0,2,1
bouyer,1282.30651868,229.758115723,3,1,2,1
danku,1282.30319396,188.444037798,5,1,4,2
yukadon64,1282.27223985,171.424093192,6,2,4,1
qedem,1282.14181359,230.816586065,2,0,2,1
groove crusader,1282.0566733,195.245070422,5,1,4,2
kobra,1282.04201988,199.488817188,5,1,4,2
ooze,1281.99361591,195.831173179,5,1,4,2
sap,1281.8360817,195.717501857,5,1,4,2
beltbuckle,1281.8360817,195.717501857,5,1,4,2
cool guy,1281.8360817,195.717501857,5,1,4,2
alesana,1281.66846204,238.762411527,2,0,2,1
fizix,1281.6472464,196.114418536,5,1,4,2
real,1281.61579565,196.140117286,5,1,4,2
beerz4yearz,1281.54735828,193.855339201,5,1,4,2
angabur,1281.397798,232.523201121,2,0,2,1
the problem,1281.39581451,196.319772197,5,1,4,2
isbjørn,1281.14673436,144.334506769,12,3,9,2
herr råbob,1280.87843033,178.92276163,6,1,5,1
canary,1280.78911407,177.421908486,6,1,5,1
black knight,1280.66033383,186.391188903,5,1,4,2
bass,1280.12353632,237.890568559,2,0,2,1
scrub lyfe,1280.11451828,242.59325615,2,0,2,1
dangerous dude,1280.10319194,159.39301896,7,1,6,1
godzillaking,1279.75630026,215.084612376,2,0,2,1
bambooo,1279.71711936,226.294158162,2,0,2,1
jay,1279.54181354,174.336860311,15,7,8,4
dbat,1279.2193526,225.036836433,2,0,2,1
taro,1278.92110396,230.512742647,2,0,2,1
the,1278.76763122,203.566063572,5,1,4,2
double a battery,1278.74342961,203.472280146,5,1,4,2
choochoo,1278.74342961,203.472280146,5,1,4,2
cool master,1278.69980095,203.069330165,5,1,4,2
baltimarth,1278.69980095,203.069330165,5,1,4,2
seanzy,1278.69980095,203.069330165,5,1,4,2
loveswater,1278.66580897,202.42168101,5,1,4,2
alpha,1278.64514459,236.461316929,2,0,2,1
patsj,1278.62494017,159.238770089,7,1,6,1
cap,1278.39752307,147.721527743,9,2,7,2
peter,1277.97954914,226.545749106,2,0,2,1
polisen,1277.35623174,176.742535799,6,1,5,1
bendo,1277.2443549,236.473239418,2,0,2,1
tmanmaniac,1277.21945819,227.114770549,2,0,2,1
lalo,1277.06492243,231.622437581,2,0,2,1
knipples,1277.02366963,176.783240858,6,1,5,1
wingding,1276.924676,238.231225337,2,0,2,1
xc3ll13,1276.924676,237.712256153,2,0,2,1
lude,1276.924676,238.031755708,2,0,2,1
malachite,1276.924676,238.111563611,2,0,2,1
moose_,1276.924676,237.712256153,2,0,2,1
jaypee,1276.924676,237.911993656,2,0,2,1
diablomablo,1276.924676,238.31096644,2,0,2,1
monarchy,1276.924676,238.31096644,2,0,2,1
r2z2,1276.924676,238.031755708,2,0,2,1
swiper,1276.924676,237.752217078,2,0,2,1
destiknee,1276.924676,237.99184172,2,0,2,1
praaxx,1276.924676,238.031755708,2,0,2,1
valkyrie,1276.924676,237.911993656,2,0,2,1
beetle,1276.924676,237.712256153,2,0,2,1
tpop,1276.924676,238.470368653,2,0,2,1
dylswitch,1276.924676,237.911993656,2,0,2,1
the dormouse,1276.924676,238.191344774,2,0,2,1
the muffin man,1276.924676,238.071663004,2,0,2,1
timemuffin,1276.924676,237.911993656,2,0,2,1
crysisbacon,1276.8439312,218.899621098,2,0,2,1
matt,1276.84350425,198.922487903,9,3,6,3
yowaffle,1276.62807461,222.816763198,2,0,2,1
squanto,1276.55937839,236.520777822,2,0,2,1
jampion,1276.45252164,234.680352359,2,0,2,1
papa ben,1276.15994885,236.451143464,2,0,2,1
the legendary food,1276.09408322,159.054656088,7,1,6,1
toxic zane,1276.08433618,225.029246947,2,0,2,1
pom,1275.94560704,187.890237084,5,1,4,2
taiko,1275.8402977,188.613274424,5,1,4,2
shabby,1275.64195537,231.325487795,2,0,2,1
sengoh,1275.60110456,161.677366693,6,1,5,1
jayrodd,1275.60011716,198.580396416,5,1,4,2
outlier,1275.39402909,187.116028169,5,1,4,2
luxx,1275.23728752,187.359144791,5,1,4,1
flat,1275.19040298,231.796365237,2,0,2,1
bitch-sensei,1275.08833498,237.133509304,2,0,2,1
cinc0,1274.890944,182.518963447,5,1,4,1
ankle,1274.81557624,233.260651812,2,0,2,1
stewbird,1274.17822559,235.037832617,2,0,2,1
salfam,1274.17822559,235.320595702,2,0,2,1
johncraw,1274.17822559,234.876100873,2,0,2,1
drfabs,1274.1574152,236.562892269,2,0,2,1
sbr,1274.15346157,231.681477832,3,1,2,1
kobold,1274.00546715,228.461927811,3,1,2,1
curry,1273.88629228,235.144227575,2,0,2,1
greenbean,1273.48102088,174.360428169,6,1,5,1
dota,1273.40792005,235.874641673,2,0,2,1
bikefrog,1273.32417553,147.198229816,7,1,6,1
snake master,1272.88115633,213.675801197,2,0,2,1
lfnt,1272.44715169,223.174773665,2,0,2,1
we-g,1272.30363729,229.973995201,2,0,2,1
bushels,1272.30363729,229.973995201,2,0,2,1
kinglewi,1272.28801293,233.100011797,2,0,2,1
ragecage,1272.27712109,233.496164925,2,0,2,1
urpasmash,1272.27712109,233.496164925,2,0,2,1
imbimbo,1272.27645614,228.924491977,2,0,2,1
whims,1272.26973934,231.660543841,2,0,2,1
pintoa,1272.19188911,176.354235455,6,1,5,1
vallarris,1272.18165017,220.484592956,2,0,2,1
wartle,1271.91668987,237.526463448,2,0,2,1
triumph,1271.91668987,237.526463448,2,0,2,1
kiffer,1271.71068904,189.847421872,5,1,4,2
doctor,1271.64873348,174.276514895,6,1,5,1
hop,1271.45690413,166.913763164,8,2,6,3
patchwork,1271.17331149,221.969004793,2,0,2,1
that0neguy,1270.87775109,229.486642614,2,0,2,1
insom,1270.64047023,189.992049016,5,1,4,1
luretryne,1270.36410529,156.39471978,7,1,6,1
hexagons,1270.19526671,229.721755387,2,0,2,1
zamn,1270.16713441,230.047898829,2,0,2,1
ihavesonar,1270.0005754,232.708258841,2,0,2,1
heavenlyflow,1269.91621997,236.858364076,2,0,2,1
tea,1269.83917588,350,7,3,4,2
lawyerdog,1269.74564351,186.663450152,5,1,4,1
pulver,1269.61337459,225.478794125,2,0,2,1
midgetto,1269.45601521,193.391122443,5,1,4,2
faded,1269.28418864,178.230905525,6,2,4,1
lazer,1269.10631761,239.003571756,2,0,2,1
proxibomb,1268.92786269,166.039720501,6,1,5,1
sdoc,1268.77036596,231.385555855,2,0,2,1
digboss,1268.72052976,188.990367969,8,2,6,2
lumia,1268.38437321,166.305931136,10,2,8,2
juststrife,1268.24299448,228.329182566,2,0,2,1
blaziken,1268.02025697,172.579820536,6,1,5,2
lemons,1267.96414866,151.160076419,11,3,8,4
poutine,1267.91859775,171.333903225,6,1,5,1
abdulaziz,1267.91833803,180.521160549,5,1,4,1
ravedave,1267.86035427,176.635004198,6,1,5,1
derpson,1267.80090381,152.033383825,10,2,8,2
flamo,1267.41172473,166.729928471,7,1,6,1
tuba,1267.4000869,219.28721749,2,0,2,1
coysquash,1267.34882519,232.404238054,2,0,2,1
bullebengt,1266.79577967,204.757263945,4,1,3,1
koga,1266.53376757,220.552440209,2,0,2,1
tara,1266.38332159,142.994688986,13,3,10,2
dat cookie doh,1266.16077223,235.610201155,2,0,2,1
kazehana3,1265.91197928,175.359344936,6,1,5,1
rayramono,1265.86141262,188.60165561,5,1,4,2
chrispy,1265.7781529,238.394230779,2,0,2,1
kzidek,1265.51744157,169.351369954,6,1,5,1
mastercat,1265.51744157,169.351369954,6,1,5,1
bruisingprune,1265.51050804,220.0369285,2,0,2,1
micro,1264.99793984,176.606777907,6,1,5,1
adrenaline,1264.85418045,237.03601696,2,0,2,1
xpertwizard,1264.83605353,243.882577993,2,0,2,2
impy,1264.47515247,235.119913243,2,0,2,1
paco [larkin],1264.34929565,233.778227039,2,0,2,1
jaji,1264.34427064,238.150031757,2,0,2,1
mr. cool guy,1264.23564984,237.012148098,2,0,2,1
duni,1263.97046101,156.660712677,10,2,8,2
#yp8cpyg2,1263.44452431,191.248252377,4,0,4,1
z0ra,1263.41409406,238.08291092,2,0,2,1
eggs on legs,1263.09910957,233.176773271,2,0,2,1
dominmuda,1263.0497768,165.074626135,6,1,5,1
penguin,1263.04063507,225.848323324,2,0,2,1
dreamfunk,1262.77583854,230.100900025,2,0,2,1
lightning mcpeen,1262.76856518,228.970830542,2,0,2,1
jams,1262.53582504,189.029811863,5,1,4,2
kulprit,1262.51841267,131.981841759,11,3,8,3
catelt,1262.29256519,155.706185994,9,2,7,2
mayofknees,1262.04897344,229.597567732,2,0,2,1
ladies,1261.97548514,237.514346513,2,0,2,1
jesper,1261.7496729,156.040298633,8,1,7,1
engine,1261.08326343,236.903887632,2,0,2,1
some freaking cactus,1261.08326343,236.903887632,2,0,2,1
enen,1260.92582264,226.379614006,3,1,2,1
e a s t,1260.40122439,237.807467465,2,0,2,1
capitali$m,1260.40122439,237.647620611,2,0,2,1
kups,1260.40122439,237.647620611,2,0,2,1
black pit,1260.40122439,237.647620611,2,0,2,1
mesmerist,1259.89206906,228.456365776,2,0,2,1
truck,1259.83221063,171.311308161,6,1,5,1
henrikvenn,1259.83126178,181.765293248,6,1,5,1
smookums,1259.78637523,232.833450301,2,0,2,1
almost ham,1259.60198316,222.487733759,2,0,2,1
hotsauce,1259.52467593,237.524261767,2,0,2,1
errl,1259.26112827,222.954934159,2,0,2,1
sharkkangaroo,1259.22893431,234.710871922,2,0,2,1
classywolfman,1259.22893431,234.710871922,2,0,2,1
thiefbug,1259.19538664,158.049900102,7,2,5,1
norway,1259.13832372,143.835568092,14,3,11,3
dr. lip,1258.89280925,185.377877113,5,1,4,2
cryptic,1258.87951183,237.123601306,2,0,2,1
dankdaddy,1258.28769972,227.784764686,2,0,2,1
fuwa,1258.17802788,226.544720225,2,0,2,1
jcela,1258.1342392,223.97092946,2,0,2,1
moggle,1258.07601382,218.027805156,3,1,2,1
sentenga0421,1258.00586618,235.051120571,2,0,2,1
volutedmarlin,1258.00586618,235.051120571,2,0,2,1
pews,1257.90760249,154.305503363,7,1,6,1
2sierra,1257.89619387,157.531605623,7,2,5,1
j9d2,1257.7713159,237.301750439,2,0,2,1
cloud,1257.57836393,237.854428306,3,0,3,2
~~boxed~~,1257.51785656,237.463295701,2,0,2,1
darner,1257.51785656,237.583283934,2,0,2,1
mafoo,1257.51785656,237.583283934,2,0,2,1
vell,1257.49995511,228.65031369,3,0,3,2
myst,1257.34422462,244.275540265,3,0,3,1
tbone,1257.25728115,236.282108081,2,0,2,1
parappa,1257.25728115,236.282108081,2,0,2,1
the garbage man,1256.84884369,237.150942947,2,0,2,1
triple f,1256.51567237,233.077935828,2,0,2,1
infest,1256.51567237,233.077935828,2,0,2,1
kappa,1256.51091601,233.700035383,2,0,2,1
ghoul,1256.49559177,195.152830499,12,2,10,3
roy the boy,1256.30854208,226.78947573,3,0,3,1
baku,1255.71222022,235.406064749,2,0,2,1
familiar,1255.71222022,235.406064749,2,0,2,1
muchomario,1255.04981101,233.068524951,2,0,2,1
haiducn,1254.7676583,177.996184238,5,1,4,1
seek,1254.66384488,238.38365596,2,0,2,1
ouicava,1254.66384488,238.940928744,2,0,2,1
zeno,1254.66384488,238.503181171,2,0,2,1
nfoh,1254.66384488,238.5430096,2,0,2,1
bajoggles,1254.66384488,238.940928744,2,0,2,1
dahnade,1254.66384488,238.184313986,2,0,2,1
151a,1254.66384488,238.224195725,2,0,2,1
40 ounce,1254.66384488,238.184313986,2,0,2,1
propaneaccessories,1254.66384488,238.940928744,2,0,2,1
quote,1254.66384488,238.940928744,2,0,2,1
yobbo,1254.66384488,238.5430096,2,0,2,1
joeylove,1254.66384488,238.184313986,2,0,2,1
wonov,1254.66384488,238.5430096,2,0,2,1
shiiv,1254.66384488,238.503181171,2,0,2,1
dudeofhazardz,1254.66384488,238.38365596,2,0,2,1
ahcarbon,1254.66384488,238.940928744,2,0,2,1
crymsen,1254.66384488,238.503181171,2,0,2,1
fan,1254.66384488,238.38365596,2,0,2,1
stitchell,1254.66384488,238.940928744,2,0,2,1
ngwn,1254.66384488,238.184313986,2,0,2,1
him,1254.66384488,238.503181171,2,0,2,1
spigot,1254.66384488,238.5430096,2,0,2,1
splash,1254.66384488,238.38365596,2,0,2,1
yeesus,1254.66384488,238.940928744,2,0,2,1
shoshin,1254.66384488,238.5430096,2,0,2,1
20ll,1254.66384488,238.940928744,2,0,2,1
gudaguda,1254.66384488,238.503181171,2,0,2,1
exlatios,1254.66153983,220.184547292,3,1,2,1
bitterking,1254.17514087,188.455995748,5,1,4,2
strawberry love,1254.06350879,232.878300296,2,0,2,1
vile,1254.05316147,230.189042197,2,0,2,1
satan [wagner],1253.693255,237.527107526,2,0,2,1
rjb,1253.693255,237.487108724,2,0,2,1
cag,1253.54663704,158.212931769,8,2,6,3
cagnar,1253.37026249,243.463523677,2,0,2,1
unit456,1253.37026249,243.463523677,2,0,2,1
kaboom,1253.37026249,243.619554554,2,0,2,1
jimmynojohns,1253.37026249,243.463523677,2,0,2,1
weeee,1252.81530514,199.317618009,4,0,4,1
junirc,1252.79674799,253.570659553,2,0,2,1
jim,1252.79674799,253.945032213,13,8,5,2
double0simon,1252.79674799,254.28149635,2,0,2,1
modus,1252.79674799,253.570659553,2,0,2,1
kebab,1252.79674799,254.28149635,2,0,2,1
major_tem,1252.79674799,253.383265797,2,0,2,1
solace,1252.79674799,254.28149635,2,0,2,1
scabhammer,1252.79674799,253.683029361,2,0,2,1
soma,1252.79674799,253.683029361,2,0,2,1
special events,1252.79674799,253.945032213,2,0,2,1
sebo,1252.79674799,253.383265797,2,0,2,1
techknowledgey,1252.79674799,254.094626834,2,0,2,1
qk shkz,1252.79674799,253.945032213,2,0,2,1
winston,1252.79674799,254.28149635,2,0,2,1
silversage64,1252.79674799,253.870201847,2,0,2,1
gooby,1252.79674799,253.683029361,2,0,2,1
island,1252.79674799,253.570659553,2,0,2,1
adraks,1252.79674799,254.094626834,2,0,2,1
hybrid,1252.79674799,253.683029361,2,0,2,1
fancy wolf,1252.79674799,254.28149635,2,0,2,1
krbay,1252.79674799,253.870201847,2,0,2,1
makeamericagreatagain,1252.79674799,253.720474905,2,0,2,1
1nertia,1252.79674799,254.28149635,2,0,2,1
king k rool,1252.79674799,253.720474905,2,0,2,1
vawx,1252.79674799,253.64557829,2,0,2,1
it's_ogre~,1252.79674799,253.832778391,2,0,2,1
twosick,1252.79674799,254.28149635,2,0,2,1
equinox,1252.79674799,254.28149635,2,0,2,1
big daddy josh,1252.79674799,254.28149635,2,0,2,1
eat it,1252.79674799,254.28149635,2,0,2,1
altf4,1252.79674799,254.28149635,2,0,2,1
radical raymondd,1252.79674799,253.945032213,2,0,2,1
aureate,1252.79674799,253.683029361,2,0,2,1
wildflower,1252.79674799,253.383265797,2,0,2,1
wooter,1252.79674799,253.982439129,2,0,2,1
glist,1252.79674799,254.094626834,2,0,2,1
sinist3r,1252.79674799,254.28149635,2,0,2,1
froge,1252.79674799,254.28149635,2,0,2,1
jmac,1252.79674799,253.683029361,2,0,2,1
tristan taylor,1252.79674799,253.945032213,2,0,2,1
moar,1252.79674799,253.64557829,2,0,2,1
kingkiller,1252.79674799,254.094626834,2,0,2,1
marko,1252.79674799,253.945032213,2,0,2,1
spoons,1252.79674799,254.28149635,2,0,2,1
poontycoon,1252.79674799,254.28149635,2,0,2,1
ferrero64,1252.79674799,254.28149635,2,0,2,1
4skn,1252.79674799,254.28149635,2,0,2,1
nell,1252.79674799,254.28149635,2,0,2,1
serbianfilm,1252.79674799,253.683029361,2,0,2,1
flcd,1252.79674799,253.683029361,2,0,2,1
jerooney,1252.79674799,253.64557829,2,0,2,1
gobos,1252.79674799,253.570659553,2,0,2,1
majesticrhino,1252.79674799,254.28149635,2,0,2,1
prismoid,1252.79674799,253.945032213,2,0,2,1
tblades,1252.79674799,254.28149635,2,0,2,1
rags,1252.79674799,253.383265797,2,0,2,1
troll meister,1252.79674799,254.28149635,2,0,2,1
socalgohan,1252.79674799,254.28149635,2,0,2,1
rainpot,1252.79674799,253.832778391,2,0,2,1
thursday boots,1252.79674799,253.945032213,2,0,2,1
elquapod,1252.79674799,253.720474905,2,0,2,1
bozomozo,1252.79674799,253.945032213,2,0,2,1
time and trust,1252.79674799,254.28149635,2,0,2,1
wonder ginger,1252.79674799,254.28149635,2,0,2,1
tundra,1252.79674799,254.28149635,2,0,2,1
pop magoot,1252.79674799,253.870201847,2,0,2,1
dolphintv,1252.79674799,254.28149635,2,0,2,1
mr. meeseeks,1252.79674799,254.28149635,2,0,2,1
slammy,1252.79674799,253.683029361,2,0,2,1
spry,1252.79674799,254.28149635,2,0,2,1
peebah,1252.79674799,254.28149635,2,0,2,1
omigo,1252.79674799,253.383265797,2,0,2,1
kurben,1252.79674799,253.683029361,2,0,2,1
mesh$,1252.79674799,253.64557829,2,0,2,1
grima,1252.79674799,254.094626834,2,0,2,1
astealthykorean,1252.79674799,254.28149635,2,0,2,1
tagless lauren,1252.79674799,253.945032213,2,0,2,1
file,1252.79674799,253.720474905,2,0,2,1
khakiducks,1252.79674799,254.28149635,2,0,2,1
pythagoras,1252.79674799,253.832778391,2,0,2,1
randocalrissian,1252.79674799,254.28149635,2,0,2,1
njwc,1252.79674799,253.945032213,2,0,2,1
mabotofu,1252.79674799,254.28149635,2,0,2,1
theschmuck33,1252.79674799,253.570659553,2,0,2,1
dankmemer420,1252.79674799,254.28149635,2,0,2,1
queue kyoo,1252.79674799,253.683029361,2,0,2,1
parkachu0,1252.79674799,254.28149635,2,0,2,1
wherd,1252.79674799,253.570659553,2,0,2,1
muzdo,1252.79674799,254.094626834,2,0,2,1
gmny,1252.79674799,254.28149635,2,0,2,1
arga,1252.79674799,253.64557829,2,0,2,1
tsundere,1252.79674799,253.570659553,2,0,2,1
chubell,1252.79674799,253.945032213,2,0,2,1
j$,1252.79674799,254.094626834,2,0,2,1
ny_lights,1252.79674799,253.570659553,2,0,2,1
albinosaurus,1252.79674799,254.28149635,2,0,2,1
brass,1252.79674799,253.383265797,2,0,2,1
nikushimi,1252.79674799,253.64557829,2,0,2,1
syophan,1252.79674799,253.64557829,2,0,2,1
jon dog,1252.79674799,253.570659553,2,0,2,1
vinje,1252.79674799,253.570659553,2,0,2,1
sasquatch,1252.79674799,253.570659553,2,0,2,1
sanjaypanini,1252.79674799,253.757914923,2,0,2,1
fr0d,1252.79674799,253.832778391,2,0,2,1
wifi,1252.79674799,253.683029361,2,0,2,1
cbass,1252.79674799,253.720474905,2,0,2,1
money,1252.79674799,254.28149635,8,4,4,2
shoe,1252.79674799,254.28149635,2,0,2,1
shanook,1252.79674799,253.945032213,2,0,2,1
hatdog,1252.79674799,253.720474905,2,0,2,1
amrit,1252.79674799,254.28149635,2,0,2,1
haise,1252.79674799,254.094626834,2,0,2,1
squab,1252.79674799,254.094626834,2,0,2,1
zarsz,1252.79674799,254.094626834,2,0,2,1
pruben,1252.79674799,253.945032213,2,0,2,1
whatislove,1252.79674799,253.945032213,2,0,2,1
gnat,1252.79674799,253.945032213,2,0,2,1
euclid,1252.79674799,253.870201847,2,0,2,1
slumlord,1252.79674799,253.870201847,2,0,2,1
asianweirdo,1252.79674799,254.28149635,2,0,2,1
archon,1252.79674799,253.383265797,2,0,2,1
buhlaine,1252.79674799,254.28149635,2,0,2,1
the cold vein,1252.79674799,254.28149635,2,0,2,1
yarfy,1252.79674799,253.945032213,9,3,6,2
mlk$,1252.79674799,254.28149635,2,0,2,1
oogaboogacaveman,1252.79674799,254.094626834,2,0,2,1
north dr,1252.79674799,253.945032213,2,0,2,1
@sdashkon,1252.79674799,254.28149635,2,0,2,1
samb,1252.79674799,253.832778391,2,0,2,1
dozy,1252.79674799,253.383265797,2,0,2,1
scyfle,1252.79674799,254.28149635,2,0,2,1
xg,1252.79674799,254.28149635,2,0,2,1
chaoslink,1252.79674799,254.094626834,5,1,4,2
doppler12,1252.79674799,253.570659553,2,0,2,1
gylk,1252.79674799,253.720474905,2,0,2,1
dr. hasbeen,1252.79674799,254.094626834,2,0,2,1
mello,1252.79674799,253.683029361,2,0,2,1
akajumo,1252.79674799,253.383265797,2,0,2,1
chiefreaper,1252.79674799,253.720474905,2,0,2,1
mank,1252.79674799,254.28149635,2,0,2,1
garv,1252.79674799,254.28149635,2,0,2,1
mr cutting horse,1252.79674799,253.64557829,2,0,2,1
nerf r nuthin,1252.79674799,254.28149635,2,0,2,1
jo,1252.79674799,253.832778391,2,0,2,1
edamame,1252.79674799,253.870201847,9,4,5,2
ejmp,1252.79674799,253.383265797,2,0,2,1
nice moose,1252.79674799,253.570659553,2,0,2,1
mtown,1252.79674799,253.945032213,2,0,2,1
mackjeyers,1252.79674799,254.094626834,2,0,2,1
lil mayo,1252.79674799,253.945032213,2,0,2,1
broon the spoon,1252.79674799,254.28149635,2,0,2,1
jngl,1252.79674799,253.383265797,2,0,2,1
quigs,1252.79674799,253.570659553,2,0,2,1
heatriser,1252.79674799,253.570659553,2,0,2,1
swiggu,1252.79674799,253.64557829,2,0,2,1
blackthunder,1252.79674799,254.28149635,2,0,2,1
osiris197,1252.79674799,254.094626834,2,0,2,1
clintbeastwood,1252.79674799,253.832778391,2,0,2,1
hashbrown,1252.79674799,254.28149635,2,0,2,1
juul,1252.79674799,253.64557829,2,0,2,1
fig newton,1252.79674799,254.094626834,2,0,2,1
matt47,1252.79674799,254.28149635,2,0,2,1
anabanana,1252.79674799,253.570659553,2,0,2,1
thugric,1252.79674799,253.945032213,2,0,2,1
sirshmoopi,1252.79674799,253.683029361,2,0,2,1
ponj,1252.79674799,253.570659553,2,0,2,1
xlvr,1252.79674799,254.28149635,2,0,2,1
arjen,1252.79674799,253.64557829,2,0,2,1
digital,1252.79674799,253.383265797,2,0,2,1
smoom,1252.79674799,254.28149635,2,0,2,1
spirit,1252.79674799,253.683029361,2,0,2,1
magma,1252.79674799,253.683029361,2,0,2,1
tonik,1252.79674799,254.28149635,2,0,2,1
enanogee,1252.79674799,254.28149635,2,0,2,1
tsar,1252.79674799,254.28149635,2,0,2,1
goucheenachos,1252.79674799,253.570659553,2,0,2,1
darkclops,1252.79674799,254.28149635,2,0,2,1
ruthy,1252.79674799,253.570659553,2,0,2,1
jake peskin,1252.79674799,254.28149635,2,0,2,1
vorpalstorm,1252.79674799,254.28149635,2,0,2,1
q-star,1252.79674799,254.28149635,2,0,2,1
muthaluva777,1252.79674799,253.683029361,2,0,2,1
mizuki,1252.79674799,253.683029361,2,0,2,1
paqsprime,1252.79674799,254.28149635,2,0,2,1
quibb,1252.79674799,253.383265797,2,0,2,1
grif,1252.79674799,254.28149635,2,0,2,1
wassup,1252.79674799,254.28149635,2,0,2,1
bstubs,1252.79674799,253.945032213,2,0,2,1
elementofsmash,1252.79674799,253.870201847,2,0,2,1
inversion,1252.79674799,253.683029361,2,0,2,1
yuse,1252.79674799,253.757914923,2,0,2,1
charlemagne,1252.79674799,253.757914923,2,0,2,1
puke,1252.79674799,253.945032213,2,0,2,1
negrodamus,1252.79674799,254.094626834,2,0,2,1
vibes,1252.79674799,253.720474905,2,0,2,1
tyger,1252.79674799,253.570659553,2,0,2,1
weeb,1252.79674799,253.945032213,2,0,2,1
butt,1252.79674799,254.28149635,2,0,2,1
theobsoletecomputer,1252.79674799,254.28149635,2,0,2,1
urboygraham,1252.79674799,253.570659553,2,0,2,1
silentknight,1252.79674799,254.28149635,2,0,2,1
spacebears,1252.79674799,254.28149635,2,0,2,1
stickers,1252.79674799,254.28149635,2,0,2,1
muse_10,1252.79674799,254.28149635,2,0,2,1
toes,1252.79674799,253.570659553,2,0,2,1
1e,1252.79674799,253.832778391,2,0,2,1
dennysgrandslambreakfast,1252.79674799,253.683029361,2,0,2,1
catfish,1252.79674799,253.383265797,2,0,2,1
acorn,1252.79674799,253.570659553,2,0,2,1
duhwinning,1252.79674799,254.094626834,2,0,2,1
stoveboy,1252.79674799,253.570659553,2,0,2,1
peachie,1252.79674799,253.383265797,2,0,2,1
faze2,1252.79674799,254.094626834,2,0,2,1
brooke,1252.79674799,254.094626834,2,0,2,1
brokr,1252.79674799,254.28149635,2,0,2,1
humanoid,1252.79674799,254.28149635,2,0,2,1
ronan,1252.79674799,253.832778391,2,0,2,1
fashion police,1252.79674799,254.28149635,2,0,2,1
dr. girlfriend,1252.79674799,254.28149635,2,0,2,1
thrive,1252.79674799,253.570659553,2,0,2,1
spit5000,1252.79674799,254.094626834,2,0,2,1
vampire,1252.79674799,253.945032213,8,3,5,2
linsanity,1252.79674799,253.683029361,2,0,2,1
justinbot,1252.79674799,254.094626834,2,0,2,1
dkoyc,1252.79674799,253.683029361,2,0,2,1
vexoskeleton,1252.79674799,253.683029361,2,0,2,1
dmwc,1252.79674799,253.683029361,2,0,2,1
tengu man,1252.79674799,253.570659553,2,0,2,1
tkyo,1252.79674799,254.094626834,2,0,2,1
motive,1252.79674799,254.28149635,2,0,2,1
johnnytsunamie,1252.79674799,253.945032213,2,0,2,1
yung blessed,1252.79674799,254.28149635,2,0,2,1
saydon,1252.79674799,254.28149635,2,0,2,1
brendy,1252.79674799,253.757914923,2,0,2,1
dirty socks,1252.79674799,253.570659553,2,0,2,1
landry,1252.79674799,253.683029361,2,0,2,1
atm,1252.79674799,253.832778391,2,0,2,1
dyldoge,1252.79674799,253.570659553,2,0,2,1
bugattimaster420,1252.79674799,253.870201847,2,0,2,1
looseblue,1252.79674799,253.683029361,2,0,2,1
lvl6zubat,1252.79674799,254.28149635,2,0,2,1
bbg,1252.79674799,254.28149635,2,0,2,1
abigajillion,1252.79674799,254.28149635,2,0,2,1
bureaucraat,1252.79674799,253.64557829,2,0,2,1
mom's   spaghetti,1252.79674799,254.28149635,2,0,2,1
snoop,1252.79674799,253.683029361,2,0,2,1
cmurda,1252.79674799,253.570659553,2,0,2,1
ramenator,1252.79674799,253.757914923,2,0,2,1
smt,1252.79674799,254.28149635,2,0,2,1
mr. saturn,1252.79674799,254.28149635,2,0,2,1
mason,1252.79674799,253.383265797,2,0,2,1
rayme,1252.79674799,253.383265797,2,0,2,1
scruffy mcwonder crumpet,1252.79674799,253.383265797,2,0,2,1
swift,1252.79674799,253.570659553,2,0,2,1
zaq,1252.79674799,253.683029361,2,0,2,1
grizzlybair,1252.79674799,254.28149635,2,0,2,1
cloakes,1252.79674799,253.383265797,2,0,2,1
irate,1252.79674799,253.720474905,2,0,2,1
james j,1252.79674799,254.28149635,2,0,2,1
docninj,1252.79674799,253.683029361,2,0,2,1
chippo,1252.79674799,254.28149635,2,0,2,1
runix,1252.79674799,254.094626834,2,0,2,1
m@chete,1252.79674799,254.28149635,2,0,2,1
v-bomber,1252.79674799,254.094626834,2,0,2,1
zombie adam,1252.79674799,254.094626834,2,0,2,1
stryj,1252.79674799,254.28149635,2,0,2,1
eorp,1252.79674799,254.28149635,2,0,2,1
kimarah,1252.79674799,254.28149635,2,0,2,1
ollyeuph,1252.79674799,253.870201847,2,0,2,1
vlerk,1252.79674799,253.64557829,2,0,2,1
vaguba,1252.79674799,253.832778391,2,0,2,1
ace turner,1252.79674799,253.570659553,2,0,2,1
neku,1252.79674799,254.28149635,2,0,2,1
sacto style,1252.79674799,254.28149635,2,0,2,1
austyp,1252.79674799,253.945032213,9,3,6,2
sir dax,1252.79674799,253.64557829,2,0,2,1
redmist,1252.79674799,253.945032213,2,0,2,1
barth,1252.79674799,253.383265797,2,0,2,1
chaos,1252.79674799,254.28149635,2,0,2,1
goblin,1252.79674799,254.28149635,2,0,2,1
zigludo,1252.79674799,253.683029361,2,0,2,1
blenderer,1252.79674799,253.570659553,2,0,2,1
tyuip,1252.79674799,253.945032213,2,0,2,1
brwn,1252.79674799,253.945032213,2,0,2,1
ninja nova,1252.79674799,253.832778391,2,0,2,1
$lik,1252.79674799,253.945032213,2,0,2,1
hyliancreation,1252.79674799,254.28149635,2,0,2,1
korova,1252.79674799,253.832778391,2,0,2,1
nat,1252.79674799,253.383265797,2,0,2,1
porkloins,1252.79674799,253.570659553,2,0,2,1
rondelle,1252.79674799,254.28149635,2,0,2,1
tylerx5,1252.79674799,254.094626834,2,0,2,1
soft serve,1252.79674799,253.945032213,2,0,2,1
rasko,1252.79674799,253.383265797,2,0,2,1
hp,1252.79674799,254.28149635,2,0,2,1
limit,1252.79674799,254.28149635,2,0,2,1
fumofuu,1252.79674799,253.683029361,2,0,2,1
bartok,1252.79674799,253.945032213,2,0,2,1
thedqn,1252.79674799,254.28149635,2,0,2,1
rovl,1252.79674799,254.28149635,2,0,2,1
kingmaxor,1252.79674799,253.420755634,2,0,2,1
schwa,1252.79674799,253.383265797,2,0,2,1
oldjokes,1252.79674799,254.28149635,2,0,2,1
pasta,1252.79674799,253.720474905,2,0,2,1
025,1252.79674799,253.832778391,2,0,2,1
jimbabwe,1252.79674799,253.683029361,2,0,2,1
cap10kirk,1252.79674799,253.420755634,2,0,2,1
duck tale,1252.79674799,254.28149635,2,0,2,1
pnis,1252.79674799,254.094626834,2,0,2,1
chromidorr,1252.79674799,253.570659553,2,0,2,1
toro,1252.79674799,254.28149635,2,0,2,1
eggsalad,1252.79674799,254.28149635,2,0,2,1
smlzgood,1252.79674799,253.570659553,2,0,2,1
dranyos,1252.79674799,254.28149635,2,0,2,1
m.kat,1252.79674799,254.28149635,2,0,2,1
20pcmcnugget,1252.79674799,254.28149635,2,0,2,1
tex-mex,1252.79674799,253.870201847,2,0,2,1
lukewarm,1252.79674799,253.570659553,2,0,2,1
imatree,1252.79674799,254.094626834,2,0,2,1
kruzz,1252.79674799,254.28149635,2,0,2,1
filthy,1252.79674799,253.720474905,2,0,2,1
juno,1252.79674799,254.094626834,2,0,2,1
taba,1252.79674799,253.383265797,2,0,2,1
sircitrus,1252.79674799,253.945032213,2,0,2,1
glint,1252.79674799,254.28149635,2,0,2,1
cheez dragon,1252.79674799,253.570659553,2,0,2,1
_ko,1252.79674799,254.28149635,2,0,2,1
rufio,1252.79674799,253.757914923,2,0,2,1
megaamoonguss,1252.79674799,253.683029361,2,0,2,1
scoundrel,1252.79674799,254.28149635,2,0,2,1
myk,1252.79674799,254.094626834,2,0,2,1
locuan,1252.79674799,254.28149635,2,0,2,1
unagi,1252.79674799,254.28149635,2,0,2,1
robobean,1252.79674799,253.757914923,2,0,2,1
~cp9~,1252.79674799,253.870201847,2,0,2,1
riff [fournier],1252.79674799,253.720474905,2,0,2,1
iroga,1252.79674799,254.28149635,2,0,2,1
nate$,1252.79674799,253.945032213,8,2,6,2
the brons kneecap,1252.79674799,253.570659553,2,0,2,1
ajizl,1252.79674799,254.28149635,2,0,2,1
shabba,1252.79674799,253.757914923,2,0,2,1
mufasa,1252.79674799,253.570659553,2,0,2,1
nicholas fletcher,1252.79674799,253.945032213,2,0,2,1
lenori,1252.79674799,253.870201847,2,0,2,1
steakunderthecouch,1252.79674799,253.383265797,2,0,2,1
puff mayne,1252.79674799,253.383265797,2,0,2,1
amaya,1252.79674799,253.720474905,2,0,2,1
djl,1252.79674799,253.683029361,2,0,2,1
kafkah,1252.79674799,253.64557829,2,0,2,1
bojo,1252.79674799,254.28149635,2,0,2,1
supernac,1252.79674799,253.570659553,2,0,2,1
r.i.p.,1252.79674799,253.870201847,2,0,2,1
demm,1252.79674799,253.683029361,2,0,2,1
vari,1252.79674799,254.28149635,2,0,2,1
lifeline,1252.79674799,254.28149635,2,0,2,1
boveda,1252.79674799,254.28149635,2,0,2,1
sg1simmons,1252.79674799,254.094626834,2,0,2,1
pewu,1252.79674799,253.683029361,2,0,2,1
chi$munny$,1252.79674799,254.28149635,2,0,2,1
telmo,1252.79674799,254.28149635,2,0,2,1
moye,1252.79674799,253.832778391,2,0,2,1
m3che,1252.79674799,253.945032213,2,0,2,1
ruskeezy,1252.79674799,254.28149635,2,0,2,1
nutsosteel,1252.79674799,254.094626834,2,0,2,1
freakydashiki,1252.79674799,253.570659553,2,0,2,1
nwchris,1252.79674799,253.383265797,2,0,2,1
earthberg,1252.79674799,253.683029361,2,0,2,1
4sk,1252.79674799,254.28149635,2,0,2,1
term,1252.79674799,253.945032213,2,0,2,1
fresh milk,1252.79674799,253.683029361,2,0,2,1
yoon,1252.79674799,253.720474905,2,0,2,1
ppdmd,1252.79674799,254.094626834,2,0,2,1
heavy metal sheik,1252.79674799,254.28149635,2,0,2,1
hoofarted,1252.79674799,253.683029361,2,0,2,1
cherished doll,1252.79674799,254.28149635,2,0,2,1
longdog,1252.79674799,253.945032213,2,0,2,1
letterboy,1252.79674799,254.28149635,2,0,2,1
caerwyn_montale,1252.79674799,253.870201847,2,0,2,1
atomic,1252.79674799,253.683029361,2,0,2,1
dr piper,1252.79674799,253.383265797,2,0,2,1
rêve,1252.79674799,254.28149635,2,0,2,1
scratchin magician,1252.79674799,254.094626834,2,0,2,1
coleslaw,1252.79674799,254.28149635,2,0,2,1
mornag,1252.79674799,254.094626834,2,0,2,1
jamis,1252.79674799,253.683029361,2,0,2,1
gamarad,1252.79674799,253.945032213,2,0,2,1
mhmm,1252.79674799,254.28149635,2,0,2,1
yungmilford,1252.79674799,254.28149635,2,0,2,1
dude-man,1252.79674799,253.383265797,2,0,2,1
geruyop,1252.79674799,254.28149635,2,0,2,1
thedarkdreamer,1252.79674799,253.720474905,2,0,2,1
sharkman,1252.79674799,253.832778391,2,0,2,1
dyo,1252.79674799,253.683029361,2,0,2,1
prince,1252.79674799,253.720474905,2,0,2,1
roll,1252.79674799,254.28149635,2,0,2,1
bl1nd_gh0st,1252.79674799,253.383265797,2,0,2,1
seymourstyle,1252.79674799,254.28149635,2,0,2,1
mre,1252.79674799,253.683029361,2,0,2,1
raulwalrus,1252.79674799,253.870201847,2,0,2,1
juicy,1252.79674799,253.570659553,2,0,2,1
good loser chaz,1252.79674799,253.383265797,2,0,2,1
gopu,1252.79674799,254.28149635,2,0,2,1
demna,1252.79674799,254.28149635,2,0,2,1
nicklit,1252.79674799,253.683029361,2,0,2,1
pliskin,1252.79674799,254.28149635,2,0,2,1
macho,1252.79674799,253.720474905,2,0,2,1
sircabby,1252.79674799,253.683029361,2,0,2,1
dqking,1252.79674799,253.945032213,2,0,2,1
sink-swim,1252.79674799,253.945032213,2,0,2,1
nattty,1252.79674799,253.383265797,2,0,2,1
charlie sheen,1252.79674799,254.28149635,2,0,2,1
danye,1252.79674799,253.383265797,2,0,2,1
ricedude,1252.79674799,254.28149635,2,0,2,1
helioseven,1252.79674799,253.383265797,2,0,2,1
improved madman,1252.79674799,253.383265797,2,0,2,1
qwetroop,1252.79674799,253.570659553,2,0,2,1
sad jesus,1252.79674799,254.094626834,2,0,2,1
sinine,1252.79674799,254.28149635,2,0,2,1
stop,1252.79674799,253.383265797,2,0,2,1
catosat,1252.79674799,253.383265797,2,0,2,1
c-iv,1252.79674799,254.094626834,2,0,2,1
leazure,1252.79674799,254.28149635,2,0,2,1
it,1252.79674799,253.383265797,2,0,2,1
link master 3000,1252.79674799,253.570659553,2,0,2,1
blindluckbert,1252.79674799,254.28149635,2,0,2,1
ramenshaman,1252.79674799,253.832778391,2,0,2,1
spiderbubble,1252.79674799,254.28149635,2,0,2,1
bebop,1252.79674799,254.094626834,2,0,2,1
gene parmesan,1252.79674799,254.094626834,2,0,2,1
scebbles,1252.79674799,254.28149635,2,0,2,1
slappygilmore,1252.79674799,254.094626834,2,0,2,1
boosh,1252.79674799,253.383265797,2,0,2,1
buttermilk,1252.79674799,254.28149635,2,0,2,1
cr0ak,1252.79674799,254.28149635,2,0,2,1
thederricka,1252.79674799,253.383265797,2,0,2,1
zelus,1252.79674799,254.28149635,2,0,2,1
jandrw,1252.79674799,253.720474905,2,0,2,1
birdman,1252.79674799,253.570659553,2,0,2,1
sirreal,1252.79674799,254.28149635,2,0,2,1
darksilence,1252.79674799,254.28149635,2,0,2,1
disdeyn,1252.79674799,253.945032213,2,0,2,1
b minus,1252.79674799,254.094626834,2,0,2,1
pen15,1252.79674799,254.28149635,2,0,2,1
dethslayr,1252.79674799,253.945032213,2,0,2,1
musicmasterjtw,1252.79674799,254.094626834,2,0,2,1
countedbeef122,1252.79674799,253.570659553,2,0,2,1
kackey,1252.79674799,253.383265797,2,0,2,1
bambam,1252.79674799,253.383265797,2,0,2,1
theargentinegreek,1252.79674799,254.28149635,2,0,2,1
alpha-infinity,1252.79674799,253.945032213,2,0,2,1
shyboy,1252.79674799,254.28149635,2,0,2,1
nugz,1252.79674799,253.683029361,2,0,2,1
kitka,1252.79674799,254.28149635,2,0,2,1
kil,1252.79674799,253.570659553,2,0,2,1
qaz,1252.79674799,253.683029361,2,0,2,1
pupudoodoo,1252.79674799,253.570659553,2,0,2,1
cupcake,1252.79674799,253.683029361,2,0,2,1
/b/l/a/d/e/,1252.79674799,254.28149635,2,0,2,1
djstank,1252.79674799,253.570659553,2,0,2,1
jerm,1252.79674799,253.870201847,2,0,2,1
tokaji,1252.79674799,253.945032213,2,0,2,1
sleeper,1252.79674799,253.64557829,2,0,2,1
taco,1252.79674799,254.28149635,2,0,2,1
afromania,1252.79674799,253.64557829,2,0,2,1
wirsun,1252.79674799,254.28149635,2,0,2,1
stanley mayhem,1252.79674799,254.28149635,2,0,2,1
metalloid,1252.79674799,254.28149635,2,0,2,1
andirama,1252.79674799,254.094626834,2,0,2,1
ganreizu,1252.79674799,253.683029361,2,0,2,1
somethingazn,1252.79674799,254.28149635,2,0,2,1
codytappen,1252.79674799,254.28149635,2,0,2,1
the rampaging mariner,1252.79674799,254.094626834,2,0,2,1
fry,1252.79674799,254.28149635,2,0,2,1
mr yaah,1252.79674799,254.28149635,2,0,2,1
scf3,1252.79674799,254.094626834,2,0,2,1
tranq,1252.79674799,253.683029361,2,0,2,1
shaw,1252.79674799,254.28149635,2,0,2,1
dave,1252.79674799,253.757914923,2,0,2,1
arkana,1252.79674799,254.28149635,2,0,2,1
shas,1252.79674799,254.094626834,2,0,2,1
scoobylew,1252.79674799,253.683029361,2,0,2,1
@xx_po0p_master_520_xx,1252.79674799,253.570659553,2,0,2,1
rf!,1252.79674799,253.945032213,2,0,2,1
shenpai,1252.79674799,254.28149635,2,0,2,1
smish,1252.79674799,254.28149635,2,0,2,1
maverick,1252.79674799,254.28149635,5,1,4,2
jazzy,1252.79674799,254.28149635,2,0,2,1
pirate,1252.79674799,253.870201847,2,0,2,1
dj  jose,1252.79674799,254.28149635,2,0,2,1
xane,1252.79674799,253.870201847,2,0,2,1
tal,1252.79674799,253.870201847,2,0,2,1
t_nils,1252.79674799,253.420755634,2,0,2,1
fro?,1252.79674799,253.720474905,2,0,2,1
jibb,1252.79674799,253.683029361,2,0,2,1
jucotastic,1252.79674799,254.28149635,2,0,2,1
jellocube,1252.79674799,253.570659553,2,0,2,1
ricko chancho,1252.79674799,253.683029361,2,0,2,1
jame,1252.79674799,254.28149635,2,0,2,1
budokan,1252.79674799,254.28149635,2,0,2,1
zachackach,1252.79674799,253.832778391,2,0,2,1
sord,1252.79674799,253.757914923,2,0,2,1
rocktimus crime,1252.79674799,253.570659553,2,0,2,1
anchovy_pizza,1252.79674799,254.28149635,2,0,2,1
sandrin,1252.79674799,253.945032213,2,0,2,1
dr. dreidel,1252.79674799,253.683029361,2,0,2,1
kieu-tip,1252.79674799,254.28149635,2,0,2,1
.mov,1252.79674799,253.683029361,2,0,2,1
helen,1252.79674799,253.570659553,2,0,2,1
nico,1252.79674799,253.683029361,2,0,2,1
gre,1252.79674799,254.28149635,2,0,2,1
anduni,1252.79674799,253.64557829,2,0,2,1
zenyou,1252.79674799,254.28149635,2,0,2,1
nick,1252.79674799,253.570659553,2,0,2,1
jgramm,1252.79674799,253.683029361,2,0,2,1
fluzzarn,1252.79674799,253.683029361,2,0,2,1
iceey,1252.79674799,253.570659553,2,0,2,1
frool,1252.79674799,254.094626834,2,0,2,1
bullshooter,1252.79674799,254.094626834,2,0,2,1
666,1252.79674799,253.870201847,2,0,2,1
anoly,1252.79674799,253.383265797,2,0,2,1
bell pepper,1252.79674799,253.683029361,2,0,2,1
durandal,1252.79674799,253.945032213,2,0,2,1
e-n,1252.79674799,253.570659553,2,0,2,1
captain puff,1252.79674799,254.28149635,2,0,2,1
blackstar,1252.79674799,254.28149635,2,0,2,1
coupon collector,1252.79674799,254.28149635,2,0,2,1
kylebaked,1252.79674799,254.28149635,2,0,2,1
chombomann,1252.79674799,253.720474905,2,0,2,1
radical3i,1252.79674799,253.64557829,2,0,2,1
the pretzel pimp,1252.79674799,254.28149635,2,0,2,1
laham,1252.79674799,254.28149635,2,0,2,1
levonheart,1252.79674799,254.094626834,2,0,2,1
daws,1252.79674799,254.094626834,2,0,2,1
sycko,1252.79674799,254.28149635,2,0,2,1
shaggy,1252.79674799,254.094626834,5,1,4,2
battery,1252.79674799,253.683029361,2,0,2,1
jeff,1252.79674799,254.28149635,2,0,2,1
_dj_mana_,1252.79674799,253.945032213,2,0,2,1
mando,1252.79674799,253.570659553,2,0,2,1
fulltilt,1252.79674799,254.28149635,2,0,2,1
boty,1252.79674799,253.720474905,2,0,2,1
sozo,1252.79674799,253.870201847,2,0,2,1
xanax,1252.79674799,254.28149635,2,0,2,1
yvng coolatta,1252.79674799,253.683029361,2,0,2,1
sss,1252.79674799,253.570659553,2,0,2,1
drewpy,1252.79674799,254.28149635,2,0,2,1
skyguy,1252.79674799,254.094626834,2,0,2,1
swarley,1252.79674799,253.720474905,2,0,2,1
skyles,1252.79674799,253.570659553,2,0,2,1
sebs,1252.79674799,254.28149635,2,0,2,1
beatthat,1252.79674799,253.64557829,2,0,2,1
amoeba,1252.79674799,254.28149635,2,0,2,1
thagoldenchild,1252.79674799,254.094626834,2,0,2,1
crilles,1252.79674799,254.28149635,2,0,2,1
eclipse,1252.79674799,253.720474905,2,0,2,1
corimon,1252.79674799,254.28149635,2,0,2,1
valor_ryan,1252.79674799,254.28149635,2,0,2,1
coinm,1252.79674799,253.945032213,2,0,2,1
4him,1252.79674799,253.720474905,2,0,2,1
bobman,1252.79674799,253.870201847,2,0,2,1
kelso,1252.79674799,254.28149635,2,0,2,1
lusty,1252.79674799,254.094626834,2,0,2,1
lan,1252.79674799,254.094626834,2,0,2,1
eastnutz,1252.79674799,254.094626834,2,0,2,1
gansama,1252.79674799,253.683029361,2,0,2,1
snowman,1252.79674799,253.683029361,2,0,2,1
mmshan,1252.79674799,254.094626834,2,0,2,1
dr.islio,1252.79674799,254.28149635,2,0,2,1
sexynachos,1252.79674799,254.28149635,2,0,2,1
tarzan,1252.79674799,254.28149635,2,0,2,1
druid,1252.79674799,253.570659553,2,0,2,1
bozz,1252.79674799,253.720474905,2,0,2,1
randy butternubs,1252.79674799,253.570659553,2,0,2,1
joshez,1252.79674799,254.094626834,2,0,2,1
captain koala,1252.79674799,253.383265797,2,0,2,1
ritz,1252.79674799,253.683029361,2,0,2,1
jslayer,1252.79674799,254.094626834,2,0,2,1
arch,1252.79674799,254.28149635,2,0,2,1
skelly,1252.79674799,254.28149635,2,0,2,1
sammy,1252.79674799,254.28149635,2,0,2,1
train,1252.79674799,253.570659553,2,0,2,1
kurly,1252.79674799,254.094626834,2,0,2,1
spek,1252.79674799,254.28149635,2,0,2,1
kalands,1252.79674799,253.570659553,2,0,2,1
kannonzz,1252.79674799,253.570659553,2,0,2,1
i2g,1252.79674799,254.094626834,2,0,2,1
wellpebbles,1252.79674799,254.28149635,2,0,2,1
officer doge,1252.79674799,253.383265797,2,0,2,1
wooper,1252.79674799,253.570659553,2,0,2,1
superultradx,1252.79674799,254.28149635,8,4,4,2
notlightningrunner,1252.79674799,253.832778391,2,0,2,1
seamoose,1252.79674799,254.094626834,2,0,2,1
cuffy,1252.79674799,253.757914923,2,0,2,1
technocrow,1252.79674799,254.28149635,2,0,2,1
megaman,1252.79674799,254.28149635,2,0,2,1
ziggy zanderfaul,1252.79674799,253.383265797,2,0,2,1
entropy,1252.79674799,254.28149635,2,0,2,1
psy,1252.79674799,253.570659553,2,0,2,1
vaatu,1252.79674799,253.570659553,2,0,2,1
fire,1252.79674799,253.683029361,2,0,2,1
patty-wagon,1252.79674799,253.720474905,2,0,2,1
nrg,1252.79674799,253.570659553,2,0,2,1
nplusone,1252.79674799,253.683029361,2,0,2,1
smoke,1252.79674799,254.28149635,2,0,2,1
geppetto,1252.79674799,254.094626834,2,0,2,1
zwephy,1252.79674799,254.28149635,2,0,2,1
dolla bill bill,1252.79674799,254.28149635,2,0,2,1
moti,1252.79674799,254.28149635,2,0,2,1
8njay,1252.79674799,253.683029361,2,0,2,1
reah,1252.79674799,253.945032213,2,0,2,1
varian,1252.79674799,253.383265797,2,0,2,1
iiliitist,1252.79674799,253.570659553,2,0,2,1
smooth jon,1252.79674799,253.683029361,2,0,2,1
etroknight,1252.79674799,254.28149635,2,0,2,1
torozan,1252.79674799,254.094626834,2,0,2,1
rambo nanny,1252.79674799,253.570659553,2,0,2,1
edmund nelson,1252.79674799,254.28149635,2,0,2,1
ciao,1252.79674799,254.28149635,2,0,2,1
highlyeducational,1252.79674799,253.683029361,2,0,2,1
joe tuber,1252.79674799,253.383265797,2,0,2,1
red-white,1252.79674799,253.570659553,2,0,2,1
nn7,1252.79674799,253.570659553,2,0,2,1
d2,1252.79674799,254.094626834,2,0,2,1
glitter,1252.79674799,254.28149635,2,0,2,1
pzero39,1252.79674799,253.383265797,2,0,2,1
mxgv!,1252.79674799,254.28149635,2,0,2,1
c0xx,1252.79674799,254.28149635,2,0,2,1
djdriftking.97,1252.79674799,254.28149635,2,0,2,1
edlose,1252.79674799,254.28149635,2,0,2,1
szoltan,1252.79674799,253.64557829,2,0,2,1
dinkles,1252.79674799,254.28149635,2,0,2,1
tevaq,1252.79674799,254.094626834,2,0,2,1
jeo,1252.79674799,253.570659553,2,0,2,1
tats,1252.79674799,254.28149635,2,0,2,1
j.killa,1252.79674799,253.683029361,2,0,2,1
arakune,1252.79674799,254.28149635,6,2,4,2
cakes,1252.79674799,254.28149635,2,0,2,1
sc0pes,1252.79674799,254.28149635,2,0,2,1
kj,1252.79674799,253.570659553,2,0,2,1
shiasurprise,1252.79674799,253.383265797,2,0,2,1
bqx,1252.79674799,253.945032213,2,0,2,1
choco,1252.79674799,253.383265797,2,0,2,1
incurredwrath,1252.79674799,254.28149635,2,0,2,1
arctic,1252.79674799,253.420755634,2,0,2,1
grassmanmatt,1252.79674799,253.945032213,2,0,2,1
mrdr,1252.79674799,253.570659553,2,0,2,1
wumbo111,1252.79674799,253.720474905,2,0,2,1
immawhite,1252.79674799,254.094626834,2,0,2,1
fraude françois,1252.79674799,253.64557829,2,0,2,1
docukid,1252.79674799,253.945032213,2,0,2,1
proxy,1252.79674799,253.683029361,2,0,2,1
mr.squiggles,1252.79674799,254.28149635,2,0,2,1
loonslaaf,1252.79674799,253.64557829,2,0,2,1
kingdong,1252.79674799,254.28149635,2,0,2,1
nolo,1252.79674799,254.094626834,2,0,2,1
guillermoose,1252.79674799,254.28149635,2,0,2,1
crocs,1252.79674799,254.28149635,2,0,2,1
witchcraft,1252.79674799,254.28149635,2,0,2,1
insomniatic,1252.79674799,254.094626834,2,0,2,1
bonnup,1252.79674799,253.720474905,2,0,2,1
tunnelsnakesrule,1252.79674799,253.720474905,2,0,2,1
shlizark,1252.79674799,253.420755634,2,0,2,1
lobster,1252.79674799,254.094626834,2,0,2,1
espar,1252.79674799,253.683029361,2,0,2,1
kyri0n,1252.79674799,253.683029361,2,0,2,1
ditto,1252.79674799,254.094626834,2,0,2,1
long and hard,1252.79674799,253.683029361,2,0,2,1
cru,1252.79674799,253.683029361,2,0,2,1
kiri,1252.79674799,253.683029361,2,0,2,1
picasso,1252.79674799,254.28149635,2,0,2,1
coro,1252.79674799,253.945032213,2,0,2,1
ziltoidfalco,1252.79674799,253.720474905,2,0,2,1
finesse,1252.79674799,253.570659553,2,0,2,1
superbob,1252.79674799,253.570659553,2,0,2,1
aaa,1252.79674799,254.28149635,2,0,2,1
zarfon,1252.79674799,254.28149635,2,0,2,1
nnn,1252.79674799,254.28149635,2,0,2,1
goldenpants,1252.79674799,253.945032213,2,0,2,1
amadzebra,1252.79674799,254.28149635,2,0,2,1
heat,1252.79674799,253.720474905,2,0,2,1
kenzz,1252.79674799,253.945032213,2,0,2,1
eliminate,1252.79674799,254.28149635,2,0,2,1
kyrios,1252.79674799,254.28149635,9,3,6,2
candle,1252.79674799,254.28149635,2,0,2,1
pen,1252.79674799,254.094626834,2,0,2,1
daniel,1252.79674799,254.28149635,2,0,2,1
mr. thee,1252.79674799,254.28149635,2,0,2,1
awe,1252.79674799,253.683029361,2,0,2,1
saltkingmcgee,1252.79674799,253.683029361,2,0,2,1
djcrinklecut,1252.79674799,254.094626834,2,0,2,1
looney,1252.79674799,253.64557829,2,0,2,1
vanillarin,1252.79674799,253.945032213,2,0,2,1
shasha,1252.79674799,253.945032213,2,0,2,1
drum,1252.79674799,253.570659553,2,0,2,1
kokopelli,1252.79674799,253.383265797,2,0,2,1
rapidrage,1252.79674799,254.28149635,2,0,2,1
endo,1252.79674799,253.383265797,2,0,2,1
raver,1252.79674799,254.094626834,2,0,2,1
n!b$,1252.79674799,253.383265797,2,0,2,1
doggyness,1252.79674799,253.945032213,2,0,2,1
orion,1252.79674799,254.094626834,2,0,2,1
nimrod,1252.79674799,254.28149635,2,0,2,1
chiefchickenwing,1252.79674799,253.570659553,2,0,2,1
loncas,1252.79674799,253.683029361,2,0,2,1
iridium,1252.79674799,253.945032213,2,0,2,1
bman8tor,1252.79674799,253.570659553,2,0,2,1
hispanion,1252.79674799,253.683029361,2,0,2,1
antonio,1252.79674799,253.64557829,2,0,2,1
[the fox army],1252.79674799,253.832778391,2,0,2,1
jfro,1252.79674799,253.570659553,2,0,2,1
8bitloser,1252.79674799,254.094626834,2,0,2,1
dr. wu,1252.79674799,253.570659553,2,0,2,1
hurricane rising,1252.79674799,254.28149635,2,0,2,1
dable,1252.79674799,253.570659553,2,0,2,1
moe moe kyun,1252.79674799,254.28149635,2,0,2,1
imdabes,1252.79674799,254.28149635,2,0,2,1
–in–,1252.79674799,254.094626834,2,0,2,1
bathtubfrog,1252.79674799,254.28149635,2,0,2,1
skywalkr000,1252.79674799,254.28149635,2,0,2,1
big l rest in peace,1252.79674799,254.094626834,2,0,2,1
ghost [jackson],1252.79674799,253.720474905,2,0,2,1
zorro,1252.79674799,253.683029361,2,0,2,1
odesza,1252.79674799,253.420755634,2,0,2,1
batista,1252.79674799,253.683029361,2,0,2,1
behappyu,1252.79674799,254.28149635,2,0,2,1
wilachas,1252.79674799,254.094626834,2,0,2,1
tag pending,1252.79674799,254.28149635,2,0,2,1
muse,1252.79674799,253.945032213,2,0,2,1
peegert,1252.79674799,253.570659553,2,0,2,1
ellen degenerate,1252.79674799,253.683029361,2,0,2,1
dern,1252.79674799,254.28149635,2,0,2,1
enoch,1252.79674799,254.28149635,2,0,2,1
derf,1252.79674799,254.094626834,2,0,2,1
nair,1252.79674799,254.28149635,2,0,2,1
sarthssb,1252.79674799,254.094626834,2,0,2,1
under,1252.79674799,253.570659553,2,0,2,1
rubez,1252.79674799,254.28149635,2,0,2,1
themickeynick,1252.79674799,254.28149635,2,0,2,1
bicycle,1252.79674799,254.28149635,2,0,2,1
slugfest004,1252.79674799,253.383265797,2,0,2,1
amplas,1252.79674799,253.570659553,2,0,2,1
czar,1252.79674799,254.28149635,2,0,2,1
eggbert,1252.79674799,253.683029361,2,0,2,1
locoelephante,1252.79674799,253.64557829,2,0,2,1
oam,1252.79674799,253.870201847,2,0,2,1
paws,1252.79674799,254.28149635,2,0,2,1
bren,1252.79674799,253.683029361,2,0,2,1
noire,1252.79674799,253.945032213,2,0,2,1
ghost [gardner],1252.79674799,253.720474905,2,0,2,1
spike,1252.79674799,254.094626834,2,0,2,1
varisia,1252.79674799,253.570659553,2,0,2,1
ben2,1252.79674799,253.420755634,2,0,2,1
stupid yoshii,1252.79674799,254.28149635,2,0,2,1
tome,1252.79674799,254.28149635,2,0,2,1
show me the carfax,1252.79674799,254.28149635,2,0,2,1
dextrous devil,1252.79674799,254.28149635,2,0,2,1
college of luigi,1252.79674799,253.570659553,2,0,2,1
kitab,1252.79674799,253.757914923,2,0,2,1
flerb,1252.79674799,253.383265797,2,0,2,1
tipsytoto,1252.79674799,254.28149635,2,0,2,1
byod,1252.79674799,253.945032213,2,0,2,1
cadronate,1252.79674799,253.683029361,2,0,2,1
tokiokid10,1252.79674799,254.28149635,2,0,2,1
happydude2,1252.79674799,253.832778391,2,0,2,1
rubberdougy,1252.79674799,254.28149635,2,0,2,1
cholo steve,1252.79674799,253.570659553,2,0,2,1
shinsuyavi,1252.79674799,253.570659553,2,0,2,1
beverage,1252.79674799,253.683029361,2,0,2,1
yumyum,1252.79674799,253.570659553,2,0,2,1
bobo big dog,1252.79674799,254.28149635,2,0,2,1
tketle,1252.79674799,253.570659553,2,0,2,1
wetzel,1252.79674799,254.28149635,2,0,2,1
smiles4miles,1252.79674799,254.094626834,2,0,2,1
snak37,1252.79674799,253.570659553,2,0,2,1
guapo,1252.79674799,253.683029361,2,0,2,1
undercoverraptor,1252.79674799,253.420755634,2,0,2,1
hatmadder,1252.79674799,254.28149635,2,0,2,1
browser brown,1252.79674799,253.383265797,2,0,2,1
t-town,1252.79674799,254.28149635,2,0,2,1
l0rdchilled,1252.79674799,254.28149635,2,0,2,1
michael shorten,1252.79674799,253.683029361,2,0,2,1
behemoth,1252.79674799,254.094626834,3,0,3,2
absolute chaos,1252.79674799,254.28149635,2,0,2,1
albert with a money sign,1252.79674799,253.683029361,2,0,2,1
kentobento,1252.79674799,254.28149635,2,0,2,1
spitx,1252.79674799,253.570659553,2,0,2,1
pinocchio,1252.79674799,254.28149635,2,0,2,1
bowman,1252.79674799,253.64557829,2,0,2,1
yosuke,1252.79674799,254.28149635,2,0,2,1
kommatiazo,1252.79674799,253.383265797,2,0,2,1
b4y6,1252.79674799,253.570659553,2,0,2,1
powerlemons,1252.79674799,254.28149635,2,0,2,1
winmil,1252.79674799,253.570659553,2,0,2,1
jeff chang,1252.79674799,253.683029361,2,0,2,1
mohummus,1252.79674799,253.945032213,2,0,2,1
bj,1252.79674799,253.570659553,2,0,2,1
gamestationpro,1252.79674799,254.28149635,2,0,2,1
ikd!,1252.79674799,254.28149635,2,0,2,1
everstorm,1252.79674799,253.570659553,2,0,2,1
archaic,1252.79674799,254.094626834,2,0,2,1
atom,1252.79674799,253.757914923,2,0,2,1
klms,1252.79674799,254.28149635,2,0,2,1
mrdrjacob,1252.79674799,254.28149635,2,0,2,1
wes,1252.79674799,253.832778391,2,0,2,1
rane,1252.79674799,254.28149635,2,0,2,1
thegordocat,1252.79674799,254.28149635,2,0,2,1
dps1,1252.79674799,254.28149635,2,0,2,1
orangepledge,1252.79674799,253.570659553,2,0,2,1
v6,1252.79674799,254.094626834,2,0,2,1
kramff,1252.79674799,253.683029361,2,0,2,1
galeforce,1252.79674799,253.570659553,2,0,2,1
stevie b,1252.79674799,253.570659553,2,0,2,1
god,1252.79674799,254.28149635,2,0,2,1
bizzie smalls,1252.79674799,254.094626834,2,0,2,1
cyrup,1252.79674799,253.683029361,2,0,2,1
upyoda,1252.79674799,254.28149635,2,0,2,1
exvertus,1252.79674799,253.683029361,2,0,2,1
kuebiko,1252.79674799,253.945032213,2,0,2,1
slopnessie,1252.79674799,253.720474905,2,0,2,1
lobo,1252.79674799,253.870201847,2,0,2,1
kswz,1252.79674799,254.28149635,2,0,2,1
mr_dr_higgins,1252.79674799,253.720474905,2,0,2,1
organic_bean,1252.79674799,254.28149635,2,0,2,1
toka,1252.79674799,253.383265797,2,0,2,1
nibbynibbynub,1252.79674799,253.683029361,2,0,2,1
charles,1252.79674799,253.870201847,2,0,2,1
rockin,1252.79674799,253.870201847,2,0,2,1
thrownorc,1252.79674799,253.570659553,2,0,2,1
sunken,1252.79674799,254.28149635,2,0,2,1
shortstack,1252.79674799,253.720474905,2,0,2,1
codec,1252.79674799,254.28149635,2,0,2,1
kanto,1252.79674799,254.28149635,2,0,2,1
captchagod64,1252.79674799,253.570659553,2,0,2,1
crisp,1252.79674799,254.28149635,2,0,2,1
cool,1252.79674799,253.64557829,2,0,2,1
onenightstanz,1252.79674799,254.28149635,2,0,2,1
broclee,1252.79674799,254.28149635,2,0,2,1
bunne,1252.79674799,254.094626834,2,0,2,1
dong,1252.79674799,254.28149635,2,0,2,1
leezy,1252.79674799,253.757914923,2,0,2,1
fernyysanchez,1252.79674799,254.28149635,2,0,2,1
hamhampopo,1252.79674799,254.094626834,2,0,2,1
thedoctorisin,1252.79674799,253.420755634,2,0,2,1
plant,1252.79674799,253.683029361,2,0,2,1
shadaxis,1252.79674799,253.383265797,2,0,2,1
quancentrate,1252.79674799,254.28149635,2,0,2,1
burgei,1252.79674799,253.570659553,2,0,2,1
i'm the nalls,1252.79674799,254.28149635,2,0,2,1
nick allen,1252.79674799,254.28149635,2,0,2,1
asianson,1252.79674799,254.28149635,2,0,2,1
ukulele,1252.79674799,253.683029361,2,0,2,1
cherrypauper,1252.79674799,254.094626834,2,0,2,1
krc_dub,1252.79674799,254.28149635,2,0,2,1
hamstarr96,1252.79674799,253.720474905,2,0,2,1
arán,1252.79674799,253.383265797,2,0,2,1
ninestar,1252.79674799,254.094626834,2,0,2,1
kingsirwankalot,1252.79674799,253.64557829,2,0,2,1
rios,1252.79674799,253.683029361,2,0,2,1
reslived,1252.79674799,254.28149635,2,0,2,1
kos,1252.79674799,254.094626834,2,0,2,1
g-sus,1252.79674799,253.570659553,2,0,2,1
bulgogi,1252.79674799,254.094626834,2,0,2,1
cobalt,1252.79674799,254.28149635,2,0,2,1
stuner323,1252.79674799,254.28149635,2,0,2,1
koj,1252.79674799,253.570659553,2,0,2,1
acons,1252.79674799,253.683029361,2,0,2,1
noopers,1252.79674799,253.570659553,2,0,2,1
eggmode,1252.79674799,254.28149635,2,0,2,1
deestroy,1252.79674799,254.094626834,2,0,2,1
realalexhahn,1252.79674799,253.720474905,2,0,2,1
jaquarium,1252.79674799,254.094626834,2,0,2,1
d ray today,1252.79674799,253.570659553,2,0,2,1
maps,1252.79674799,254.28149635,2,0,2,1
turnt_up,1252.79674799,254.28149635,2,0,2,1
aquwas,1252.79674799,254.094626834,2,0,2,1
goop,1252.79674799,254.28149635,2,0,2,1
weakener,1252.79674799,253.570659553,2,0,2,1
spektatr,1252.79674799,254.28149635,2,0,2,1
handbanana,1252.79674799,253.757914923,2,0,2,1
white,1252.79674799,254.28149635,2,0,2,1
strouticus,1252.79674799,253.683029361,2,0,2,1
2%,1252.79674799,253.683029361,2,0,2,1
raff,1252.79674799,253.720474905,2,0,2,1
lordbeard,1252.79674799,253.683029361,2,0,2,1
serenade,1252.79674799,254.28149635,2,0,2,1
ryzzle,1252.79674799,254.094626834,2,0,2,1
summer was fun,1252.79674799,253.945032213,2,0,2,1
534,1252.79674799,253.683029361,2,0,2,1
hasp,1252.79674799,253.683029361,2,0,2,1
embracethe12,1252.79674799,254.28149635,2,0,2,1
pigwick,1252.79674799,254.094626834,2,0,2,1
fusion,1252.79674799,254.094626834,2,0,2,1
mortfeld,1252.79674799,254.28149635,2,0,2,1
the grouch,1252.79674799,254.28149635,2,0,2,1
kochisnsd,1252.79674799,254.28149635,2,0,2,1
robotsword,1252.79674799,253.570659553,2,0,2,1
faceoats,1252.79674799,254.617515866,2,0,2,2
jayford,1252.79674799,254.28149635,2,0,2,1
humble,1252.79674799,253.683029361,2,0,2,1
jippythelion,1252.79674799,254.28149635,2,0,2,1
pigeon,1252.79674799,253.683029361,2,0,2,1
monkbard,1252.79674799,253.570659553,2,0,2,1
hunterx,1252.79674799,253.383265797,2,0,2,1
eaglebloo,1252.79674799,253.683029361,2,0,2,1
maltrez,1252.79674799,253.945032213,2,0,2,1
missinglink,1252.79674799,254.28149635,2,0,2,1
lydian,1252.79674799,254.28149635,2,0,2,1
trashboat,1252.79674799,254.28149635,2,0,2,1
toptierramen,1252.79674799,253.570659553,2,0,2,1
darthdailey,1252.79674799,254.094626834,2,0,2,1
athens,1252.79674799,254.28149635,2,0,2,1
giga,1252.79674799,254.28149635,2,0,2,1
pure_bazurek,1252.79674799,253.945032213,2,0,2,1
electric soldier,1252.79674799,254.28149635,2,0,2,1
samurice,1252.79674799,254.28149635,2,0,2,1
marker,1252.79674799,253.683029361,2,0,2,1
no true scotsman,1252.79674799,253.420755634,2,0,2,1
artlessavian,1252.79674799,254.28149635,2,0,2,1
pikalu,1252.79674799,253.570659553,2,0,2,1
colin,1252.79674799,254.28149635,2,0,2,1
buck,1252.79674799,253.683029361,2,0,2,1
jlaw,1252.79674799,254.094626834,2,0,2,1
peon,1252.79674799,253.570659553,2,0,2,1
doublepappa,1252.79674799,253.945032213,2,0,2,1
sloper,1252.79674799,254.28149635,2,0,2,1
pk_cheeze,1252.79674799,254.094626834,2,0,2,1
scrubbymac,1252.79674799,253.683029361,2,0,2,1
0ust,1252.79674799,254.28149635,2,0,2,1
the wizard,1252.79674799,253.720474905,2,0,2,1
alui,1252.79674799,253.720474905,2,0,2,1
deathden,1252.79674799,253.683029361,2,0,2,1
varia_gamre,1252.79674799,254.28149635,2,0,2,1
syves,1252.79674799,253.570659553,2,0,2,1
rage,1252.79674799,254.28149635,2,0,2,1
bizon,1252.79674799,253.832778391,2,0,2,1
lazyninja1017,1252.79674799,254.094626834,2,0,2,1
cryptos,1252.79674799,253.870201847,2,0,2,1
itsmadness,1252.79674799,254.28149635,2,0,2,1
lucon,1252.79674799,253.64557829,2,0,2,1
ironpool,1252.79674799,254.28149635,2,0,2,1
riquiz,1252.79674799,253.64557829,2,0,2,1
squallette,1252.79674799,254.28149635,2,0,2,1
drowninfish,1252.79674799,254.28149635,2,0,2,1
mu9en,1252.79674799,253.570659553,2,0,2,1
hctaz,1252.79674799,253.870201847,2,0,2,1
sharkjaw777,1252.79674799,253.720474905,2,0,2,1
atari,1252.79674799,254.28149635,2,0,2,1
youngquest,1252.79674799,254.094626834,2,0,2,1
alcides .i.,1252.73100249,223.911235098,3,0,3,1
luffy,1252.55876026,240.887049803,2,0,2,1
novi,1252.43852623,210.975106949,4,1,3,1
yamsofsteel,1251.82471164,216.657444163,3,0,3,1
redlime,1251.51025547,171.77315144,7,1,6,1
pwnagepolice,1251.47849189,185.700162027,5,1,4,2
captbutter,1251.23626225,227.575261674,3,1,2,1
helio,1251.12636543,135.171042115,13,3,10,2
luke wilson,1250.42441943,217.512676892,2,0,2,1
flyingmelons,1250.18528876,177.291665319,7,1,6,1
aweshucks,1250.02691412,191.81859053,5,1,4,2
marx,1249.9734013,172.842351074,6,1,5,1
miles,1249.91585828,141.901092471,12,3,9,3
grin,1249.75702271,188.026701317,5,1,4,2
kao,1249.57459305,256.879899824,2,0,2,2
porkwings,1249.51271032,256.969571199,2,0,2,2
drybones,1248.87507228,222.887510697,2,0,2,1
mikek,1248.51508457,237.278356402,2,0,2,1
4 phri,1248.51508457,237.638419489,2,0,2,1
surskim,1248.22000706,234.621130583,2,0,2,1
mental,1248.12264472,167.257006172,7,1,6,1
born 2 sd,1247.57745544,184.661570002,5,1,4,1
midgeet,1247.32757262,129.681944644,18,5,13,3
joeyoyos,1246.85222242,230.510435184,2,0,2,1
dustland,1246.85222242,230.510435184,2,0,2,1
trod,1246.7305214,182.111394518,6,1,5,1
vurky,1246.7305214,182.528244426,6,1,5,1
loz,1246.7305214,182.528244426,13,1,12,2
madman3,1246.7305214,182.528244426,6,1,5,1
speck,1246.7305214,182.111394518,6,1,5,1
drastnikov,1246.7305214,182.528244426,6,1,5,1
téabone,1246.7305214,182.528244426,6,1,5,1
isyan,1246.7305214,182.528244426,13,5,8,2
alexander,1246.7305214,182.528244426,13,2,11,2
zelgius,1246.7305214,182.111394518,6,1,5,1
puttep,1246.7305214,182.528244426,6,1,5,1
chelo,1246.7305214,182.111394518,6,1,5,1
dannyy,1246.7305214,182.528244426,6,1,5,1
la8pv,1246.7305214,182.528244426,6,1,5,1
tablesalt,1246.7305214,182.111394518,6,1,5,1
zippow,1246.7305214,182.528244426,6,1,5,1
fawger,1246.7305214,182.528244426,6,1,5,1
dj tyro,1246.7305214,182.111394518,6,1,5,1
beggy,1246.7305214,182.111394518,6,1,5,1
mermaid,1246.7305214,182.528244426,6,1,5,1
rezz,1246.7305214,182.528244426,6,1,5,1
mrtom,1246.7305214,182.528244426,13,5,8,2
sortie,1246.7305214,182.528244426,6,1,5,1
krookk,1246.54692598,197.954532737,4,0,4,1
captain kush,1246.41837931,241.777845192,2,0,2,1
tarn,1245.68008482,160.246917458,10,2,8,4
regralht,1245.16893609,270.099957521,1,0,1,1
giraffe,1245.04176941,183.933517491,7,1,6,2
hadoush,1244.99391106,197.011937137,4,0,4,1
nichu,1244.68911553,156.39471978,7,1,6,1
barking_frog,1244.67508581,228.920106803,2,0,2,1
kitkat,1244.62585205,238.316566229,2,0,2,1
tomcat,1244.14384524,241.185044009,2,0,2,1
gib,1243.79649743,153.873899628,10,2,8,2
hufff,1243.51402949,232.704856193,2,0,2,1
omnicloud7strife,1242.68354712,234.785303782,2,0,2,1
cday,1242.5669774,238.638334758,2,0,2,1
cooljoe,1241.94484136,180.069533119,5,1,4,2
shmoomin_,1241.81525892,237.502569073,2,0,2,1
comment,1241.68906372,233.933288357,2,0,2,1
agyle,1241.68906372,233.933288357,2,0,2,1
holosly,1241.53448425,233.662443179,2,0,2,1
maaron,1241.45908381,238.171585854,2,0,2,1
jpin,1241.31820386,237.224605472,2,0,2,1
call_of_cow,1241.09748892,166.284133449,7,1,6,1
tyler,1241.06600439,193.060808017,5,1,4,2
_diesel,1240.74514988,234.40701879,2,0,2,1
sun$,1239.09191239,193.332802915,4,0,4,1
joehowardjr,1238.91967688,233.658851822,2,0,2,1
cartastikid,1238.83188097,231.626775486,2,0,2,1
rezah,1238.72637342,232.403805727,2,0,2,1
reefx,1238.4511154,165.503043064,7,2,5,1
zeezy,1238.04335206,180.910130572,6,1,5,1
ping warrior,1237.63809205,201.957106687,4,1,3,1
zzz,1237.61269129,214.754784548,9,3,6,3
ckx,1237.19374945,146.596179892,10,2,8,3
hiv+,1237.03387623,191.134091678,5,1,4,2
pelso,1236.79468792,162.354157256,7,2,5,1
pkluv,1236.40643184,240.765372121,2,0,2,1
jepr,1236.40643184,240.765372121,2,0,2,1
rudy,1236.40511266,227.662763805,2,0,2,1
diego,1235.69451897,240.828684841,2,0,2,1
audie,1235.69451897,240.828684841,2,0,2,1
addict,1234.55376878,186.412616894,4,0,4,1
dooi,1233.8409766,182.543935001,7,1,6,2
rewind,1233.49402925,169.799559002,14,4,10,4
mtndewgong,1233.14253471,176.189712101,6,1,5,1
devilgamer,1233.07825749,158.96562567,7,1,6,1
thesurfingpikachu,1233.01334828,176.738059103,6,1,5,1
wrenchingpiff,1232.71777097,242.067536271,2,0,2,1
cfoy,1232.58878387,194.8896827,5,1,4,2
yamz,1232.56778989,195.136137616,5,1,4,2
soupostrich,1232.54682671,195.479355956,5,1,4,2
forte,1232.54682671,195.479355956,5,1,4,2
starsoldier,1232.4370545,221.419125155,2,0,2,1
faddie,1232.23049016,284.552893463,1,0,1,1
slippy,1232.03004636,141.713758272,20,4,16,4
other jon,1231.8154577,240.590270615,2,0,2,1
sin_of_friday,1231.8154577,240.590270615,2,0,2,1
theboy,1231.70883707,240.196214486,2,0,2,1
ca$h morey,1231.51276625,270.091497264,1,0,1,1
tequila,1231.30016845,193.884096852,7,1,6,3
cr4nb3rry,1230.96263321,168.71928854,8,1,7,2
yahara,1230.82914915,191.102483868,4,0,4,1
wheep,1230.48234368,235.120963189,2,0,2,1
meerkat,1230.32471851,167.758340647,8,2,6,2
laration,1229.92415429,194.470241434,5,1,4,1
dorsh,1229.81287804,240.145039085,2,0,2,1
johalter,1229.64766872,240.582878218,2,0,2,1
quarry,1229.53245289,132.675612999,12,2,10,2
pixel beat,1229.44952006,233.856430829,2,0,2,1
zen,1229.07610022,138.34675517,17,5,12,3
beej,1229.00582463,240.74029419,2,0,2,1
joenut,1229.00582463,240.779752568,2,0,2,1
terra,1228.71942228,178.38545632,6,1,5,1
shreddern64,1228.66303135,247.292960072,2,0,2,1
flippy_o,1228.42491342,158.867018509,10,2,8,2
natalie,1228.42350263,238.470368653,2,0,2,1
psychowaffle,1228.42350263,237.911993656,2,0,2,1
little blue,1228.42350263,237.712256153,2,0,2,1
ink,1228.42350263,238.031755708,2,0,2,1
babal,1228.20346089,216.506705104,3,0,3,1
dannx,1228.20346089,216.506705104,3,0,3,1
tabasco,1227.76070313,166.87100646,7,1,6,2
squeemos,1227.63677782,235.677908582,2,0,2,1
vegeta,1227.45474265,232.62442072,2,0,2,1
aml,1226.87503452,230.086662671,3,0,3,2
bewp,1226.72689074,232.238002013,2,0,2,1
rainrobb,1226.05099167,230.062935731,2,0,2,1
doofalo,1226.03557148,240.611221398,2,0,2,1
mech,1226.01165933,233.787424738,3,0,3,2
c0sm1x,1225.75544655,168.515368528,7,1,6,1
awkward,1225.62137478,216.770180986,3,0,3,1
solo,1225.58657407,148.233179309,20,4,16,5
#chultzmack,1225.58049791,207.224089401,4,0,4,1
nonk,1225.26042238,240.886448145,2,0,2,1
teknoor,1224.97953509,194.976228648,4,0,4,2
el garz,1223.98610764,229.504469486,2,0,2,1
brum,1223.98610764,229.173082001,2,0,2,1
nordecai,1223.22528839,230.029567533,2,0,2,1
myxoma,1222.69348354,237.584259555,2,0,2,1
sam the commentator,1222.69348354,237.584259555,2,0,2,1
pika god,1222.39422127,230.41789421,3,0,3,2
amae,1221.58739047,157.644501792,10,2,8,3
rozrus,1221.57588522,242.092255001,2,0,2,2
dizcofunk,1220.81407092,185.623613753,5,1,4,2
rez,1220.71465838,237.481541079,2,0,2,1
l1me,1220.61173906,176.653947425,6,1,5,1
haettis,1220.5858635,164.829603321,7,1,6,1
lownasty,1220.10666123,240.940903918,2,0,2,1
nano,1220.10666123,240.940903918,2,0,2,1
dad nuggets,1219.98486725,241.030598674,2,0,2,1
depsyfer,1219.20613625,241.210375786,2,0,2,1
cadence,1219.01201361,178.896602514,5,1,4,2
majesticwood,1218.58028363,242.563068314,2,0,2,1
brandowonder,1218.58028363,242.680535087,2,0,2,1
chaotropic,1218.58028363,242.563068314,2,0,2,1
whimsy,1218.58028363,242.367163844,2,0,2,1
w1sh,1218.58028363,242.563068314,2,0,2,1
fartrell cluggins,1218.58028363,242.563068314,2,0,2,1
inflatablethor,1218.58028363,242.719678044,2,0,2,1
nurse,1218.58028363,242.719678044,2,0,2,1
radjazz,1218.58028363,242.719678044,2,0,2,1
fuzzman,1218.58028363,242.719678044,2,0,2,1
chamoo,1218.58028363,242.719678044,2,0,2,1
lsupersonicq,1218.58028363,242.680535087,2,0,2,1
hypa,1218.58028363,242.719678044,2,0,2,1
migz,1218.58028363,242.563068314,2,0,2,1
sjipz0r,1218.58028363,242.954403356,2,0,2,1
vench,1218.58028363,243.110760992,2,0,2,1
n0ble,1218.58028363,242.719678044,2,0,2,1
zbomber,1218.58028363,242.680535087,2,0,2,1
hamer,1218.58028363,242.563068314,2,0,2,1
reker,1218.58028363,242.954403356,2,0,2,1
touch tank,1218.58028363,242.680535087,2,0,2,1
anonymous-limbo,1218.58028363,242.719678044,2,0,2,1
orana,1218.58028363,242.563068314,2,0,2,1
vanna black,1218.58028363,242.563068314,2,0,2,1
sean barker,1218.58028363,242.680535087,2,0,2,1
piner,1218.58028363,242.367163844,2,0,2,1
kingvi,1218.58028363,242.680535087,2,0,2,1
michael,1218.58028363,242.680535087,2,0,2,1
elioto,1218.58028363,242.680535087,2,0,2,1
sirdunx,1218.58028363,242.758814691,2,0,2,1
lauerman,1218.58028363,242.367163844,2,0,2,1
ikea,1218.58028363,242.367163844,2,0,2,1
iamse7en,1218.48500189,241.681130709,2,0,2,1
catam,1218.28278036,233.690791573,2,0,2,1
smalleoz,1217.82007554,172.020876339,7,1,6,1
smba,1217.82007554,172.020876339,7,1,6,1
henke,1217.53670197,159.558426778,7,1,6,1
juhseppe,1217.53050562,238.537563284,2,0,2,1
venick,1217.36936508,240.984275234,2,0,2,1
mccombo,1216.93539085,290.003641645,1,0,1,1
chrism,1216.93539085,289.872579192,1,0,1,1
synthesis,1216.93539085,290.232858525,1,0,1,1
scuba steve,1216.93539085,290.331038932,1,0,1,1
applejaxs,1216.93539085,290.003641645,1,0,1,1
everfresh,1216.15935088,176.001751744,6,1,5,1
food,1216.15935088,176.001751744,6,1,5,1
a',1216.15935088,176.001751744,6,1,5,1
ex,1216.15935088,176.001751744,6,1,5,1
asoma,1215.70857521,239.108510029,2,0,2,1
camtwo,1215.69169581,202.646668728,4,0,4,1
tlbs,1215.69169581,202.646668728,4,0,4,1
jigg,1215.62020043,223.858724811,2,0,2,1
svenne,1215.56388987,203.565269083,4,0,4,1
marusudt,1214.97678223,226.835527139,3,0,3,2
4thwrldmrshl,1214.28954708,241.266489738,2,0,2,1
deedoot,1214.06287496,281.502700558,1,0,1,1
seed,1214.04191416,216.656796995,2,0,2,1
tang it rell,1214.00623711,237.376461953,2,0,2,1
sapphire,1213.9893572,174.099485348,7,1,6,2
amaranthx,1213.15739889,213.783682219,4,0,4,1
tehc,1212.9973903,241.616766408,2,0,2,1
nah son,1212.7801273,241.781570409,2,0,2,1
paranoidzoid,1212.43664348,235.466118619,2,0,2,1
labrador,1212.43664348,235.466118619,2,0,2,1
mrbnjmn,1211.78409241,237.658696874,2,0,2,1
tuck,1211.29061184,207.947945359,4,0,4,1
hb,1211.08825507,201.326498832,4,0,4,1
murrkin,1210.54062222,240.920411769,2,0,2,1
fudgeface,1210.37969321,176.91658324,9,1,8,4
c3l,1209.98936336,143.723435498,12,3,9,2
dcj,1209.85229848,205.020385448,4,0,4,1
omega,1209.7105501,193.832529611,13,3,10,2
lightsoul,1209.24269128,226.089162813,3,0,3,2
henomura,1208.93951894,214.824038532,3,0,3,1
swail,1207.23304119,232.34639559,2,0,2,1
asgtwe,1206.92520905,172.103684495,5,0,5,1
fenrir,1206.8134328,156.414632717,14,4,10,3
sixten,1206.2194897,213.440150111,3,0,3,1
fuseless,1206.2194897,213.440150111,3,0,3,1
dragonite,1205.51898084,225.462024492,3,0,3,2
lee,1205.387964,183.470801421,5,1,4,2
ruse,1205.3680636,228.252906302,6,1,5,3
batch,1204.41086701,165.376653495,7,1,6,1
undies!,1204.10432376,289.674510776,9,5,4,2
zerkris,1204.03434793,239.274879261,2,0,2,1
k1lllaag,1203.75786896,239.280235139,2,0,2,1
trogdog,1203.74125678,239.528864883,2,0,2,1
venom turtle,1203.286002,182.01500987,7,1,6,3
aquachu,1203.16192809,199.580887796,4,0,4,1
ppsd,1202.86235858,160.706458678,9,1,8,2
urist,1201.74630837,199.732594332,4,0,4,1
taylortotftw,1201.27090191,235.887579184,2,0,2,1
stk,1201.26850922,201.649208316,5,1,4,2
cheetos,1201.15656844,212.649453534,4,0,4,2
c_mill24,1201.11581611,234.799554657,2,0,2,1
steez,1201.11581611,234.799554657,2,0,2,1
burke092,1201.05364449,251.674892801,2,0,2,1
therealjustinbieber,1201.05364449,251.297138198,2,0,2,1
missesmccloud,1201.05364449,251.486086427,2,0,2,1
slap,1201.05364449,251.486086427,2,0,2,1
rinchilla,1201.05364449,251.108047793,2,0,2,1
ibkenny22,1201.05364449,251.599387253,2,0,2,1
jv4lf,1201.05364449,251.486086427,2,0,2,1
hook,1201.05364449,251.108047793,2,0,2,1
smashphantom,1201.05364449,251.486086427,2,0,2,1
cheeftain,1201.05364449,251.486086427,2,0,2,1
mr.mimetime,1200.48655893,228.317680605,3,0,3,1
orchard,1200.48655893,228.650307843,3,0,3,1
bun$,1200.48655893,228.317680605,3,0,3,1
mistake,1200.48655893,228.650307843,3,0,3,1
theytah,1200.48655893,228.317680605,3,0,3,1
bagel,1200.3105831,186.130341688,4,0,4,2
bobo,1199.90561777,181.839030451,7,1,6,3
pabsmonty,1199.58322186,182.393641454,6,1,5,1
scrublord,1198.79626751,200.99117731,4,0,4,1
narbs,1198.79626751,200.99117731,4,0,4,1
pewpew2,1198.79125997,217.392822536,3,0,3,1
true blue,1198.52701147,176.332426268,6,1,5,1
veryyes,1197.92104799,205.498903524,4,0,4,2
blue ruin,1197.89322737,242.966532923,2,0,2,1
mastermike,1197.80050477,232.381789265,2,0,2,1
peace,1197.56583612,253.040231693,2,0,2,1
ciggas,1197.25892699,249.796384883,2,0,2,1
jeffy,1197.07257987,206.900626684,4,0,4,2
ulf,1196.57477044,187.25483404,4,0,4,1
fish,1196.51181054,223.582961452,3,0,3,2
gyro,1196.40095749,239.655547109,2,0,2,1
stormcloud,1196.04658607,231.139080021,2,0,2,1
isifys,1196.01173272,165.152404993,6,0,6,1
daffle,1195.93351605,237.807252177,2,0,2,1
ad8,1195.93273613,167.408369125,7,1,6,1
krus,1195.2541261,179.081211646,8,1,7,2
kevino,1194.89862916,233.365711494,3,0,3,2
djswerve,1194.89862916,233.365711494,3,0,3,2
darv,1194.81256827,233.334093088,3,0,3,2
boney,1194.81256827,233.334093088,3,0,3,2
jade,1194.79822955,233.566197254,3,0,3,2
mort,1194.66924241,233.823516545,3,0,3,2
bait,1193.38967841,232.555696741,3,0,3,2
bluepartyhat,1193.36892102,232.286202812,3,0,3,2
snow,1193.24444777,232.631083713,3,0,3,2
mr. owl,1192.95448367,233.229873854,3,0,3,2
shucklin,1190.18116589,159.709956454,8,1,7,2
youmakeussick,1189.91874631,197.203794087,4,0,4,1
html,1189.72998715,232.673785889,2,0,2,1
grizzlee,1188.92674605,239.713806919,2,0,2,1
danbo,1187.84421146,181.097952571,7,1,6,3
vitamin,1187.62677646,244.691934324,2,0,2,1
free inui,1187.62677646,244.381142323,2,0,2,1
jake97,1186.64665351,232.69428023,2,0,2,1
cock,1186.13102958,237.556032526,2,0,2,1
zachimon,1185.54433334,204.92207167,4,0,4,2
tet,1185.15222347,164.354053371,15,2,13,3
annapower89,1184.9598423,264.505549361,11,1,10,2
burnyay,1184.8956448,223.776695016,3,0,3,2
masterbazaar,1184.7617964,156.294862046,10,1,9,2
cat,1184.689806,150.597051446,9,1,8,2
thinking man,1184.2370263,228.646234273,2,0,2,1
krythan,1183.793007,244.723872775,2,0,2,1
spoopy,1183.61720844,223.657931403,10,0,10,3
cheeze whizard,1183.52152348,223.946413479,4,0,4,2
tiger,1183.30621765,239.809164913,3,0,3,2
riseup93,1182.81993276,242.250943862,2,0,2,1
luna,1182.74030794,178.47225198,7,1,6,3
porksoda,1182.61803956,159.39301896,7,0,7,1
mrjewlittle,1182.34702473,240.793239033,2,0,2,1
acecraze,1182.34702473,240.793239033,2,0,2,1
flurpel,1182.12669904,247.976337644,2,0,2,1
gorx,1181.86206943,241.242068822,2,0,2,1
freeman,1181.60248748,235.675266947,2,0,2,1
vlanitak,1181.32908228,159.238770089,7,0,7,1
roman,1181.07446975,218.456173986,3,0,3,2
lonbach,1180.88870204,167.065112824,6,0,6,1
iso,1180.63162822,180.82733949,6,1,5,1
izy,1180.06710111,191.897485925,5,0,5,1
trip,1179.06854143,196.444394583,5,0,5,1
fluffmaestro,1179.02393042,159.054656088,7,0,7,1
ejg,1178.51214085,241.008914544,2,0,2,1
caravan,1178.50701251,252.968869418,2,0,2,1
tx toast,1178.40826904,233.281444104,2,0,2,1
tweli,1176.58252982,243.817535715,2,0,2,2
dankpank,1175.47547334,204.118338665,4,0,4,2
bakkestaffen,1175.39706222,134.675686356,13,2,11,2
bourbonjr,1174.56289853,226.316566279,2,0,2,1
batteriez,1174.1344498,245.910330998,2,0,2,1
alucard,1173.55153537,200.513688993,4,0,4,1
kandyman,1173.40871583,238.276702898,2,0,2,1
lordjosh2,1173.40871583,238.196950325,2,0,2,1
dog+,1173.40871583,238.077271372,2,0,2,1
kitsuni,1173.31322416,208.900141169,4,0,4,2
hoz,1169.3571916,243.218988807,2,0,2,1
brat,1168.78243564,157.581788857,7,1,6,1
cowboy dan,1167.76521414,250.532296045,2,0,2,1
porpoise [gill],1167.74092554,250.569884202,2,0,2,1
wulf,1166.56919361,154.305503363,7,0,7,1
arcana,1165.39967338,214.072632052,4,0,4,2
gaijilla,1165.34486607,214.31668072,4,0,4,2
phazeshift,1165.04721189,209.20976259,4,0,4,1
maspect,1165.04721189,209.20976259,4,0,4,1
flash,1165.04721189,209.20976259,4,0,4,1
oops,1165.04721189,209.20976259,4,0,4,1
tropicalsk,1165.04721189,209.572719511,4,0,4,1
z,1165.03141285,200.59573318,5,1,4,1
deefly,1163.2060061,158.049900102,7,1,6,1
ahar,1163.03847198,159.330050772,6,0,6,1
crucialtoast8,1162.35775956,179.590675893,6,1,5,1
rabbitalex,1161.76027351,246.735049544,2,0,2,1
paquito,1161.76027351,246.735049544,2,0,2,1
zerqui,1161.76027351,246.735049544,2,0,2,1
stone free,1161.76027351,247.196651825,2,0,2,1
notos,1161.13927841,247.028827007,2,0,2,1
keff,1160.95520485,248.490828947,2,0,2,1
morpheus,1160.95520485,248.490828947,2,0,2,1
sheikmaster,1160.87371869,253.464329268,2,0,2,1
bayless,1160.87371869,253.201829004,2,0,2,1
mvb,1160.87371869,253.014162076,2,0,2,1
missingn0,1160.87371869,253.351862459,2,0,2,1
safety1st,1160.87371869,253.201829004,2,0,2,1
ynot4k,1160.87371869,253.314362426,2,0,2,1
vheri,1160.87371869,253.351862459,2,0,2,1
sergeanthendog99,1160.87371869,253.351862459,2,0,2,1
claymore,1160.87371869,253.389356941,2,0,2,1
halo,1160.87371869,253.351862459,2,0,2,1
rawdog,1160.87371869,253.314362426,2,0,2,1
dedleg,1160.87371869,253.351862459,2,0,2,1
kambos,1160.87371869,253.351862459,2,0,2,1
echone,1160.87371869,253.351862459,2,0,2,1
pinkieoats,1160.87371869,253.351862459,2,0,2,1
the_sir_reginald,1160.87371869,253.314362426,2,0,2,1
coffeehamster,1160.87371869,253.014162076,2,0,2,1
bleem,1160.87371869,253.351862459,2,0,2,1
skulltown,1160.87371869,253.314362426,2,0,2,1
crimson,1160.87371869,253.576746196,2,0,2,1
digdug,1160.87371869,253.351862459,2,0,2,1
brothabebz,1160.87371869,253.201829004,2,0,2,1
pandaken,1160.87371869,253.314362426,2,0,2,1
shinyralts,1160.87371869,253.351862459,2,0,2,1
xariot,1160.87371869,253.389356941,2,0,2,1
czelt,1160.87371869,253.314362426,2,0,2,1
draxsel,1160.87371869,253.726557954,2,0,2,1
kutskoo,1160.87371869,253.351862459,2,0,2,1
rossmpossm,1160.87371869,253.576746196,2,0,2,1
deku_scrub,1160.87371869,253.351862459,2,0,2,1
genericgamer,1160.87371869,253.201829004,2,0,2,1
gkred,1160.87371869,253.726557954,2,0,2,1
queso,1160.87371869,253.389356941,2,0,2,1
little bill,1160.87371869,253.351862459,2,0,2,1
zapwad,1160.87371869,253.014162076,2,0,2,1
cha0s,1160.74943915,174.346224566,6,0,6,1
horse,1160.7110197,166.729928471,7,0,7,1
whooie,1160.64806002,177.421908486,6,0,6,1
p2g,1160.34622038,251.383697728,2,0,2,1
equin0x,1160.18860933,236.396562819,2,0,2,1
murcaz,1159.56370321,151.257247237,7,0,7,1
mumb1e,1159.27210432,159.996098755,7,0,7,1
mr. toothbrush,1159.26295145,178.92276163,10,0,10,2
scorpiator,1158.4932371,247.602819601,2,0,2,1
disco wolf,1157.96705612,252.152705167,2,0,2,1
mgod,1157.96705612,252.190377935,2,0,2,1
tp the destroyer,1157.75389337,176.783240858,6,0,6,1
kampy,1157.29217269,210.438788431,4,0,4,2
ranger mike,1156.99695453,179.441121248,6,0,6,1
torm,1156.68916292,180.945675808,5,0,5,1
worm,1156.61635061,149.078806173,8,1,7,3
jeezy,1155.9550961,171.333903225,6,0,6,1
rektangles,1155.5782196,181.280772142,6,0,6,1
sir.squanch,1155.42280151,246.00849579,2,0,2,1
vetikke,1155.03651445,174.276514895,6,0,6,1
sofa king,1155.03390695,207.386694145,4,0,4,1
420bonglord,1154.95658469,247.053252683,2,0,2,1
kjs,1154.95658469,247.053252683,2,0,2,1
salz,1154.17007684,234.485694678,2,0,2,1
puma,1154.16947201,225.892239722,2,0,2,1
master j.j.,1153.19872413,215.923364102,4,0,4,2
beastly,1153.15609787,216.145255922,4,0,4,2
sam,1153.15609787,215.925384467,4,0,4,2
fira n ice,1153.11348557,216.674035457,4,0,4,2
charlie harper,1153.11348557,216.674035457,4,0,4,2
rickpicks,1153.11348557,216.674035457,4,0,4,2
djnour,1153.02830282,216.765657092,4,0,4,2
tagless,1153.00701585,216.569328726,4,0,4,2
monsoon,1153.00701585,216.569328726,4,0,4,2
kneel,1153.00701585,216.569328726,4,0,4,2
ilikeswamperts,1153.00701585,216.393794146,4,0,4,2
doublec,1153.00701585,216.569328726,4,0,4,2
bob thunder,1153.00701585,216.569328726,4,0,4,2
silver_yy,1153.00701585,216.569328726,4,0,4,2
butler,1152.9219028,216.880045431,13,3,10,4
federade,1152.9219028,216.660919656,4,0,4,2
tobi,1152.90063324,216.508360204,4,0,4,2
etmiv,1152.90063324,216.902904633,4,0,4,2
daftzeppelin,1152.70936372,217.108361118,4,0,4,2
tripledeckerpbj,1152.70936372,217.108361118,4,0,4,2
bunk,1152.70936372,217.108361118,4,0,4,2
vaccine,1152.61654998,246.424540297,2,0,2,1
pratmire,1152.61654998,246.424540297,2,0,2,1
skittlez,1152.47450927,205.747923312,4,0,4,2
stopthevok,1152.21251288,222.64588766,3,0,3,2
wumbology,1151.93041241,248.282660546,2,0,2,1
rada,1151.01069194,185.7625787,5,0,5,1
ebd,1151.01069194,186.171253541,5,0,5,1
pretzelguy,1149.26534438,319.922891169,6,2,4,2
garbage can,1148.7923549,176.635004198,6,0,6,1
hamalak,1148.68497124,187.237322776,5,0,5,1
flyguy,1148.57338703,175.359344936,6,0,6,1
youngwolf97,1148.0939413,249.139646404,2,0,2,1
wixoz,1146.41306776,203.330689297,4,0,4,1
bustr,1146.13202568,168.912103833,6,0,6,1
tomago,1145.96834237,176.606777907,6,0,6,1
lempo,1145.58146127,248.988018281,2,0,2,1
emceecurtis,1145.46000586,160.696904297,10,1,9,4
holz!,1145.35132821,207.140344887,4,0,4,2
pbj,1144.37324189,254.024757401,2,0,2,1
j-roc,1143.90252621,314.856723652,5,1,4,2
themerman,1143.30308247,202.929973687,4,0,4,2
taotau,1142.64801528,173.677930233,6,0,6,1
chals,1142.5386088,191.437664305,5,0,5,2
oblomkov,1142.21502662,238.410912672,2,0,2,1
sonachan,1140.83801965,199.610172134,4,0,4,2
proxer,1140.74393768,167.257006172,7,0,7,1
day,1140.6247803,203.596436257,5,0,5,2
pinch,1140.59863658,266.040488549,2,0,2,1
kush,1139.94215373,188.646547375,4,0,4,1
big brother,1139.85910377,249.078986556,2,0,2,1
milk monster,1139.85910377,248.926377759,2,0,2,1
chuck lubs,1139.45041356,194.243070151,5,0,5,1
avatar jillian,1139.45041356,194.633939234,12,1,11,2
bjt,1139.45041356,194.633939234,12,2,10,2
hyhy,1139.45041356,194.633939234,5,0,5,1
sennebogen,1139.45041356,194.633939234,5,0,5,1
whidah,1139.45041356,194.633939234,5,0,5,1
cfive,1139.45041356,194.633939234,5,0,5,1
gk_,1139.45041356,194.633939234,5,0,5,1
bloodwhale,1139.45041356,194.633939234,5,0,5,1
sophie the warrior,1139.45041356,194.633939234,5,0,5,1
mrflibble,1139.45041356,194.633939234,5,0,5,1
strawhatter,1139.45041356,194.633939234,5,0,5,1
rävx,1139.45041356,194.633939234,5,0,5,1
nomickok,1139.45041356,194.633939234,5,0,5,1
kexmannen,1139.45041356,194.633939234,5,0,5,1
terrorcheese,1138.23452167,171.77315144,7,0,7,1
lefty,1138.13048915,223.897315235,3,0,3,2
mommy,1137.53861645,177.348834919,9,1,8,4
barrage,1137.33523513,248.756525707,2,0,2,1
starryskye,1136.01032296,172.842351074,6,0,6,1
wade,1134.96855821,166.284133449,7,0,7,1
xenjih,1134.67073211,199.149519381,13,2,11,2
peredido,1133.849631,200.002475099,4,0,4,1
siggen,1132.94979012,181.765293248,6,0,6,1
leffen's visa,1132.58588993,235.549085242,2,0,2,1
xen,1132.42478715,211.254093985,4,0,4,2
philyo,1131.50511387,167.3922807,7,0,7,1
cortez,1131.49254032,249.318723635,2,0,2,1
losviken,1131.2407294,138.78899107,13,3,10,2
prohibition,1130.22216899,177.291665319,7,0,7,1
kennyc,1129.49912546,176.31200742,6,0,6,1
d-money,1127.62340327,251.439680836,2,0,2,1
wzrd,1127.12181282,256.871065182,2,0,2,1
medusa,1125.49555966,204.18584507,5,0,5,3
onehandbackhand,1125.28739294,169.087901323,10,0,10,3
wreckening,1123.42333712,207.879808375,4,0,4,2
av1n,1121.79882297,260.001150565,2,0,2,1
dyldobaggins,1121.79882297,259.854956264,2,0,2,1
mrx,1121.79882297,260.001150565,2,0,2,1
spiritgun,1121.48575665,251.101483775,2,0,2,1
hayzze,1121.46575782,253.106234121,2,0,2,1
crazycookie,1121.46277142,202.97503304,5,0,5,2
foom,1121.22749419,301.9471239,1,0,1,1
deaf_intheleft,1120.61177261,254.436860917,2,0,2,1
deff,1120.09578211,182.528244426,6,0,6,1
skeleton_inside_me,1120.09578211,182.528244426,6,0,6,1
20fu,1120.09578211,182.528244426,13,1,12,2
linney,1120.09578211,182.528244426,12,0,12,2
radio,1120.09578211,182.528244426,6,0,6,1
darentei,1120.09578211,182.528244426,6,0,6,1
allkizz,1120.09578211,182.528244426,6,0,6,1
tharixer,1120.09578211,182.528244426,6,0,6,1
sacred panda,1120.09578211,182.111394518,6,0,6,1
port,1120.09578211,182.111394518,6,0,6,1
ken allen tang,1120.09578211,182.528244426,13,1,12,2
sloppy banana,1120.09578211,182.111394518,6,0,6,1
rogue,1120.09578211,182.528244426,13,3,10,2
samio25,1120.09578211,182.528244426,6,0,6,1
weirdrikka,1120.09578211,182.528244426,6,0,6,1
yung funk,1119.84835719,159.558426778,7,0,7,1
zantpowa,1119.42304025,206.147105565,5,0,5,3
goose,1119.38016608,223.215779894,3,0,3,2
ch0k0 nach0,1116.50308506,202.175912425,4,0,4,2
snafu,1116.31185962,164.829603321,7,0,7,1
moonpuncher,1115.61503513,252.905999299,2,0,2,1
algel,1115.61503513,252.905999299,2,0,2,1
wave,1115.54326005,235.396992366,3,0,3,2
bk,1114.67478187,163.192809612,8,0,8,2
satan,1112.12144157,207.131670772,4,0,4,2
bag of beetles,1112.12144157,207.131670772,4,0,4,2
stark,1111.98427698,207.002170794,4,0,4,2
s-j,1111.43776936,238.469911785,2,0,2,1
racko,1110.46871082,243.345963353,2,0,2,1
azula,1110.46871082,243.345963353,2,0,2,1
bensw,11098.6608745,350,11,6,5,4
jm,1109.77530367,188.923674015,6,0,6,2
random,1105.7556654,218.573881088,4,0,4,2
shank,1105.68918273,151.450100412,13,1,12,2
ciker,1105.54023723,204.757263945,4,0,4,1
yimo,1104.92198547,206.056958335,5,1,4,1
deckerstag,1104.05883279,259.049773467,2,0,2,1
swerliie,1104.05714959,259.164988169,2,0,2,1
versaggi,1104.05546879,259.206858673,2,0,2,1
jonan,1104.05379038,259.212072647,2,0,2,1
ssj2luigi,1103.98916753,273.160543763,2,0,2,1
ghost of harambe,1103.39496021,256.078834264,2,0,2,1
tortuga milk,1102.1809479,253.51007954,2,0,2,1
yellow,1102.04120673,154.534293755,7,0,7,1
carai,1101.81447911,201.87134143,4,0,4,2
risu,1101.18912289,143.850277628,19,2,17,8
drewgs,1099.57246029,195.745521183,8,0,8,5
hurr,1099.4411354,165.376653495,7,0,7,1
ferg,1098.7951853,223.683577754,4,0,4,2
pibb,1097.95141661,176.001751744,6,0,6,1
wrdstang,1097.67205481,248.197798431,2,0,2,1
meamking,1097.54128433,310.211353023,10,4,6,2
bab,1096.99025477,172.367184175,7,0,7,2
bear,1096.88868088,197.36926283,6,0,6,3
neverpullout,1096.27015678,288.581252167,2,0,2,2
ghost_missingno,1096.24280509,242.274052816,2,0,2,1
zooka,1096.09583906,206.06142733,4,0,4,2
rosilius,1093.27540971,257.223829911,2,0,2,1
bandit,1091.89707923,196.491661221,13,3,10,4
phazermuffin,1091.6261375,196.756789155,6,0,6,3
y3fffrsn,1091.21981258,183.924332534,6,0,6,1
boneless,1088.62217235,186.999349561,4,0,4,2
tanking,1087.86739096,187.665051825,5,0,5,1
spaghetti,1086.03321351,324.179725144,6,2,4,2
avr,1085.94964121,194.470241434,5,0,5,1
suitymcgee,1085.49237085,176.189712101,6,0,6,1
dethasarus rex,1082.92368753,189.458813428,5,0,5,3
derek,1081.22708535,210.975106949,4,0,4,1
espio,1081.05227797,262.432273301,2,0,2,1
blakesterr,1078.46899778,170.390190852,8,0,8,2
raven,1076.61062119,182.566156549,7,0,7,2
tophatpat,1073.13766526,182.393641454,13,5,8,2
flims,1067.47007058,157.531605623,7,0,7,1
vikong,1067.21662555,158.049900102,7,0,7,1
thehazman00,1066.96381168,246.453173392,2,0,2,1
stretch,1066.69527347,210.008089933,4,0,4,2
#8cjvulro,1063.91019675,220.518501536,4,0,4,1
austin,1062.0520726,237.840031281,2,0,2,1
icon,1060.79922125,324.309111102,6,2,4,2
ultrabob,1058.08084767,267.221335749,2,0,2,1
slothic,1056.27979508,172.871591856,7,0,7,1
sunwalker,1046.27472987,178.061377807,8,0,8,4
shulkman,1039.23459752,179.590675893,6,0,6,1
appel,1031.9519215,164.059277132,14,1,13,5
shredflintstone,1024.75589313,249.374281631,2,0,2,1
chelly,1011.97685195,132.887420939,23,2,21,5
rolflife,989.958090631,165.503043064,7,0,7,1
tater,980.718163189,350,5,1,4,2
prime,980.718163189,350,8,3,5,2
wolfjudgement,980.718163189,350,9,1,8,2
tomp,980.718163189,350,4,0,4,2
exile,980.718163189,350,9,0,9,2
kitten,980.718163189,350,9,2,7,2
stellar,980.718163189,350,5,1,4,2
royal,980.718163189,350,5,1,4,2
owl,980.718163189,350,7,4,3,2
aspens,980.718163189,350,9,0,9,2
cookie,945.626120184,327.446186944,7,3,4,2
wal,789.898167829,350,5,1,4,2
sabo,766.785644334,350,7,2,5,3
pawn,685.938667551,350,7,1,6,3
