player,mu,sigma,wins,losses,sets
superboomfan,50.3366929526,1.30784039417,100,7,107
alvin,47.9657361941,1.70084430904,26,4,30
wario,46.8011037125,2.77164036346,10,1,11
k y s k,45.8303573405,2.55280925386,8,2,10
wizzrobe,45.5689253847,1.25799231516,57,13,70
mariguas,45.5618457921,1.41158448406,47,12,59
isai,44.6977735024,1.67469014697,32,8,40
wangera,44.3734142345,2.06881314538,16,5,21
dext3r,44.2977889413,1.41488889325,37,12,49
tacos,44.2439947829,1.39538414795,45,14,59
kerokeroppi,44.1493319944,1.2008180269,62,19,81
tr3gthez,43.6646974538,1.49225756066,35,11,46
yu-kun,42.2928048381,2.98715582073,6,2,8
stranded,42.1704499344,1.70407549857,23,8,31
kurabba,41.9666255104,2.97715064691,7,2,9
revan,41.901373155,1.40663997006,39,13,52
barksanchez,41.8121271542,1.35782261098,39,16,55
taimai,41.4993003292,2.98131298308,5,2,7
prince,41.1892899889,2.99401897546,7,2,9
fox,40.4892722307,1.98751486178,17,7,24
dtan,40.3827461697,1.65467996871,23,10,33
zantetsu,39.9678771942,2.49692407694,13,4,17
bark the shark,39.7355071469,1.68940569243,29,11,40
fireblaster,39.5632691177,1.23810484631,54,20,74
derek #squats,39.318397438,2.13155850123,11,5,16
jaimehr,39.3115846162,1.60728589853,27,12,39
kort,38.9735488772,2.31003341971,11,6,17
banze,38.9477232945,2.39828429918,11,5,16
firo,38.7595716979,1.96724361831,15,8,23
marbles,38.2965461612,1.65268467145,27,11,38
vinsanity,38.2668868814,3.34641368653,6,2,8
hero pie,38.0794499959,2.33120168229,11,6,17
combo blaze,37.9965540558,1.84161636532,20,10,30
lowww,37.9206240574,3.18610812784,7,2,9
shalaka,37.7371175209,2.47439934983,10,6,16
heropie,37.6126532768,2.4003979063,12,4,16
zero,37.5889480837,1.81389931785,17,10,27
cobr,37.5367436175,2.07245925352,14,8,22
bonobono,37.5215681788,3.26810400356,5,2,7
handsometom,37.4794118977,2.04838645993,14,8,22
nacl,37.3489082872,1.99854977408,16,9,25
lorenzo,37.3237780376,1.73231698971,22,8,30
kyle tree,37.0167877215,2.12361971847,13,8,21
lord narwhal,36.8525353228,1.99551445403,14,9,23
nintendude,36.84074975,1.53901111585,26,16,42
shears,36.8109031277,1.18071231348,53,27,80
$$$ jim $$$,36.7732175672,2.19938194763,12,5,17
mojomonkey,36.7465834368,3.23325123148,6,2,8
kimimaru,36.4606831443,2.10563988829,16,8,24
nta,36.3335406268,3.3180572192,4,3,7
janitor,35.9144656984,1.66276158687,27,12,39
near,35.8564598969,3.01899918724,7,3,10
ybombb,35.7696664756,2.71023200622,9,5,14
wookiee,35.6725040828,1.76279619212,22,11,33
clubbadubba,35.6463786553,2.47353878856,9,6,15
sotoh,35.6287354466,1.80746424051,20,12,32
janco,35.5138079891,2.75735711011,8,5,13
star king,35.3659210494,3.36163352645,4,3,7
robert,35.3017330196,2.15919682907,15,7,22
jason,35.2103900045,1.88245596023,19,9,28
fumbles,35.1912927426,3.1418460738,5,3,8
nothing,35.1662167856,2.23725447581,15,6,21
pugs,35.1141821107,1.99121068704,13,7,20
amida,34.9576084304,2.232973506,13,7,20
sheermadness,34.8137791393,2.75903467565,7,4,11
hipstur,34.8124190019,1.77044923917,24,11,35
finio,34.709443322,3.56302260724,5,2,7
dajjal,34.7086609702,2.01088901245,15,9,24
a$,34.6529372572,3.61518577109,4,2,6
loto,34.5785570437,2.67558535112,8,4,12
snorlax,34.1509813672,2.19428977085,12,8,20
darkhorse,34.0912951365,1.74230699384,21,15,36
sextc,34.0603159236,3.22483747476,5,3,8
saltsizzle,34.0224122064,2.2104807754,10,8,18
monte,33.8877738107,3.26860967435,4,3,7
sax,33.7237563831,3.16388556743,5,3,8
b link,33.7043735207,3.41574568432,4,3,7
jay-r,33.6986723234,3.67430439323,5,2,7
fishaman p,33.6937242847,2.43782345652,9,6,15
battlecow,33.6697597335,3.11712144552,5,3,8
andykins,33.6625158183,2.92142077205,5,3,8
ctg,33.6395062715,1.78166230778,18,14,32
satan [turner],33.5848320568,3.29623966057,4,3,7
sunnyb,33.5015024567,3.33234229103,5,3,8
facechew,33.4806776768,3.92657652704,5,2,7
collin,33.4759562048,3.99706268072,3,2,5
stonefallow,33.4537595014,3.33820273813,7,4,11
freean,33.3953040256,1.91085051944,17,10,27
dark gentleman,33.3569573422,2.91482922881,7,4,11
the protagonist,33.316379494,2.27863564573,10,9,19
smash jesus,33.3094645151,2.26685997685,14,6,20
jay_mute$,33.2908534773,2.54968174456,9,5,14
poobearninja,33.2675205729,2.85015494485,9,4,13
butt solo,33.2668187459,3.88287929716,3,3,6
nickelbackstreetboy,33.2445204845,3.47417075687,4,2,6
bowl,33.1558843423,2.78502297217,8,5,13
yobolight,33.1253665643,2.40933677569,12,7,19
connor,32.9915151245,2.30009088387,12,7,19
ken,32.9525318648,5.2000068451,2,1,3
box765,32.9486376113,3.17835850471,6,3,9
gravyfingers,32.8679894186,3.33457822164,4,3,7
automatic,32.8666074297,3.67489253005,4,2,6
preston,32.865845254,2.10285196029,14,9,23
nattybroh,32.6576172721,2.58174552461,9,4,13
knitephox,32.6486675768,2.39986838292,10,7,17
dogg,32.6434332409,2.5599016294,8,6,14
scoback,32.6357499164,2.23833302573,9,9,18
logic,32.633296766,2.7329863188,7,4,11
hotline,32.5698923402,3.71403908459,4,2,6
the big d,32.5647297015,4.10768684903,4,2,6
eggmode,32.5351446351,2.08443347408,14,11,25
jimmy joe,32.5287861987,1.63287749621,21,16,37
masterhandjob,32.5266916588,2.00919609506,15,11,26
the dark gentleman,32.4793138171,3.45633939111,4,3,7
greginator,32.4236876056,4.12567348207,3,2,5
yunque,32.4081618263,2.86663073414,6,5,11
tyhiggz,32.3022257452,1.99554160596,13,10,23
mr.sir,32.2395329222,1.53186744593,25,19,44
josephzander,32.2020033826,3.27867843889,6,3,9
letsgo,32.1883005291,2.82142760879,6,6,12
b0n,32.1595441517,3.98560947057,4,2,6
mokkori,32.1114700357,3.91308839434,4,2,6
socrates,32.1069281277,4.20470648305,3,2,5
cyoonit,32.0990958528,3.48305198475,4,3,7
kaz,32.0783309368,2.8077681351,8,5,13
subtle,32.0477713403,2.74771567519,8,7,15
rossi,31.9924556002,4.06630453493,3,2,5
madrush21,31.9747779304,1.45556738768,27,22,49
inukem,31.9541037237,3.27304456236,5,2,7
daniel,31.9411483161,2.31315656094,11,8,19
eg,31.9301102949,1.99952166743,14,8,22
ivor,31.8145289806,4.01162672432,3,2,5
rith,31.7710413189,3.64186631047,4,3,7
a to tr3gthez,31.7217069276,2.102950213,11,10,21
shanks,31.7154959219,2.92695440862,7,5,12
spongy,31.6952978603,2.62890947506,9,4,13
sedda,31.6720830212,2.90689530426,7,4,11
d35,31.6071285168,1.75014426867,20,14,34
limesoda,31.5457597082,2.37157409276,9,7,16
g0d,31.4982352473,4.47998791561,2,2,4
natendo,31.4665474062,3.84524862973,4,2,6
bard,31.4618525499,1.81688297487,18,12,30
tot,31.4563966288,3.01820407253,7,6,13
esid,31.4281713598,3.07269551479,6,3,9
onski,31.4179160374,1.99713484131,18,13,31
kyle,31.4139103813,4.04438002411,3,2,5
studstill,31.3054654082,2.99423820906,7,4,11
se√±orhen10r,31.2897401568,2.73959774825,7,5,12
pete,31.2596994468,3.62257992679,4,3,7
tonester,31.2583317858,2.66451632383,11,6,17
bread,31.1379212941,2.73317833498,8,6,14
llcstoism,31.1316660428,1.90156426136,14,12,26
dam_tewton,31.1083892624,4.51212905715,2,2,4
fck vwls,30.9884771463,2.6143968533,8,8,16
v,30.9699817031,3.80835133669,4,2,6
dfx,30.9568394406,2.3600351461,10,8,18
kirbstomper,30.9517187532,3.44632097783,5,4,9
piratetrips,30.9195273081,2.6605293412,8,4,12
shihman,30.9140428427,1.71177224872,21,13,34
th3kuzinator,30.8601974553,2.98818899985,6,6,12
spark,30.8565212977,2.89035000413,7,4,11
waxy:joe,30.8314688127,2.88640838708,6,4,10
supa,30.8093473359,2.44025761899,8,7,15
dogs_johnson,30.8004342707,2.25995084508,11,9,20
rusty,30.7393905065,2.37839178529,9,8,17
purtle,30.656971653,3.49740430515,3,3,6
heny935,30.6391570083,3.84636324788,4,2,6
fancy,30.499839859,4.16966294177,3,2,5
jxc,30.4955949109,3.7041066548,4,2,6
b.i.,30.4930517777,2.69994081512,7,4,11
elel,30.4207808837,3.17861273215,6,4,10
moogle,30.3547452749,4.27008676874,3,2,5
olbus,30.235202814,3.85840210727,4,2,6
pizza jokes,30.1663034627,3.43590142972,3,3,6
morino,30.1506617443,3.72732224827,3,3,6
quitrage,30.1326635042,3.24268953717,5,4,9
commander,30.0781383948,4.1645089737,3,2,5
nesskhalifa,30.061035925,3.46080180021,5,4,9
duffman,30.0504740014,4.29388077689,3,2,5
chuck lubs,30.0498798852,4.42716092492,3,2,5
the american patriot,30.0004772446,4.24193874381,4,2,6
smurf,29.9531278375,1.80002917486,20,14,34
skyfire,29.9527963513,4.29289896607,3,2,5
blondekid,29.9322692988,2.93681911494,6,6,12
superderekfan,29.9230421298,3.98060511495,3,2,5
gt,29.8889752893,1.6970068769,18,14,32
gildo,29.8849963899,2.45863464998,12,6,18
broly,29.8107162742,4.30923040572,3,2,5
dr. grin,29.7729008148,3.37690165582,4,4,8
bamster,29.7339542308,3.53248325882,5,4,9
umbra,29.6653148683,3.25168600944,6,4,10
korobeniki,29.6403956301,2.71400236635,7,8,15
freddy cougar,29.6190154715,4.80369636988,3,2,5
mustard tiger,29.6149847437,3.32370967272,6,4,10
greeno,29.6003557154,2.19097911477,13,8,21
p21/c,29.5851834956,2.41437168207,10,8,18
xyk,29.5672353755,3.08640859532,6,4,10
darkneon,29.5302814811,4.30636267854,3,2,5
dizzle,29.4903977804,3.35582559588,5,4,9
zyrg,29.4794237968,2.99657164216,6,4,10
whitejesus,29.4672418503,2.52630349941,6,8,14
toro,29.4591415649,4.33761892562,3,2,5
tank,29.42965499,4.14507127951,2,3,5
bon,29.4294581725,2.71669979638,7,8,15
quickcav,29.4196097865,3.08512113383,6,3,9
captain l,29.3847498667,2.39327494351,8,9,17
annex,29.3477462104,2.20589573348,12,9,21
komotonoto,29.3237253757,3.12104975034,5,4,9
travkid,29.2782761158,5.02028646873,1,1,2
pewpewu,29.2686965515,3.31382375194,5,4,9
dpb,29.2524784108,4.54067447503,3,2,5
fil,29.2193758493,3.85847312934,3,3,6
captain fabulous,29.1600602586,2.53958829541,8,8,16
justin,29.0276200479,4.11228649343,3,2,5
the (.)(.),28.9877791848,3.5948769872,3,3,6
a la carte,28.8550346343,3.60784111654,5,4,9
pathall,28.8430032981,4.69943595619,2,2,4
fudgeball,28.8428618688,3.86046783703,3,2,5
professor_wizard,28.7769264801,2.30280387406,9,7,16
ibc,28.7765131925,3.33497860129,4,4,8
sebula4,28.7490311034,4.35983588224,3,2,5
iheartqueso,28.6785208568,3.6767673138,5,4,9
1000,28.6446165202,4.96232019835,3,2,5
vudujin,28.5358925715,4.51236308597,3,2,5
zuko,28.530514436,2.24385881472,12,11,23
my buddy mike,28.5283406973,5.24332305562,2,2,4
toronto joe,28.5159878507,4.46472143658,3,2,5
tvdonk,28.5159878507,4.46472143658,3,2,5
enneielle,28.407797227,3.8228297591,3,3,6
jamjar,28.3881663594,2.30394433191,13,11,24
kraines,28.3781476104,4.80211445935,3,1,4
sunflower,28.3742781939,2.78309480734,6,7,13
hydra,28.3642798889,3.56767211327,4,3,7
coin chaser,28.3398804873,4.41338713391,3,2,5
kabal,28.3246175391,3.82277180882,4,3,7
marlwolfe,28.256038765,3.81013431879,3,3,6
dragoniota,28.2167689426,4.41112725804,3,2,5
blaise,28.2055181803,4.52219949795,3,2,5
thrillhouse,28.1624287422,3.03354288436,5,4,9
autobaun,28.1529055021,4.53845634446,3,2,5
handles,28.151799742,2.54418384098,9,6,15
nattyb,28.1340321176,4.41412338,3,2,5
cmull,28.1054747597,3.22108354575,4,4,8
killahertz,28.0824338464,2.92888723249,7,6,13
q!,28.0763523477,2.08626903461,11,13,24
spamus,28.0429315999,4.57118871244,2,2,4
cody,27.9486161896,5.04650302542,3,2,5
b33f,27.92023597,2.21062457504,11,8,19
t brett,27.9109561884,3.45327948973,5,4,9
horbie,27.899985796,4.06374662367,3,3,6
tbq,27.8891238809,3.18202316669,5,4,9
shyboy,27.8855005042,4.52522270394,3,2,5
xor,27.8477909423,4.54391781032,3,2,5
pizza,27.8344336168,2.10477123339,13,13,26
grahamaglam,27.8300034856,2.36302715785,6,8,14
starchild,27.8262409136,2.67324963633,9,6,15
meerkat,27.7667306628,2.26657798183,9,10,19
cwic-beam,27.7625337748,3.75509936243,4,4,8
dr. lampy,27.7012340579,4.3858154803,3,2,5
paco,27.6900941707,2.27729034149,9,9,18
bigbeaver,27.68685376,1.83105600106,13,15,28
mr. slimey,27.665551347,4.77930876729,2,2,4
zbl_mystic,27.6442350057,4.70282970113,3,2,5
giraphe,27.6259839905,4.34736538899,3,2,5
sheick,27.560447432,4.57676738624,3,2,5
jsmirk,27.5595115728,2.38170645149,8,9,17
miniohh!,27.5381232447,4.69722582098,2,2,4
no~m,27.5287408935,4.54448982974,3,2,5
t0mmii,27.5268971516,4.50511998972,3,2,5
stonehaus,27.518979914,4.54954967357,3,2,5
velocity jones,27.5110874357,4.03185001321,2,2,4
scratch,27.4992245286,2.68284084358,5,8,13
touque,27.4858842567,4.51296989674,3,2,5
tafokints,27.4431132349,5.24771854895,2,1,3
dubs,27.4288727105,2.95638717553,7,5,12
king lumsy,27.418245167,4.5754327375,3,2,5
stevie g$üëåüëåüëåüëåüëåüëåüëåüëå,27.4089970276,5.03296639251,2,2,4
boomalready1,27.4074925344,3.42991343912,5,4,9
maze,27.3991072971,3.30731838716,4,5,9
daniels,27.3908316689,2.05435467802,13,14,27
mando,27.3787849505,3.10339446866,4,6,10
kingkool,27.3741879199,4.51626367599,3,2,5
deathcpo,27.3591560504,2.420764216,9,9,18
vanillarin,27.3521521582,3.56691852247,5,4,9
ern,27.3334373546,4.52651953183,3,2,5
jam,27.2604595159,4.17145944147,2,3,5
razz,27.2135833484,2.85619076813,6,6,12
wazzberry,27.1536110551,4.72588493458,3,2,5
breakthrough,27.1504154495,4.70647587777,2,2,4
greenblob,27.1388132979,4.14897965961,3,2,5
zergos,27.1269678944,4.66386416268,3,2,5
rizner,27.06173088,2.21889047221,12,11,23
box,27.0513887921,4.41908231244,2,2,4
vanddar,27.0269797611,4.91033200857,2,2,4
taiko,27.0116230366,2.40064275916,8,10,18
shishkabobs5,26.9943366155,4.91566277234,2,2,4
pluto,26.9883313047,4.68697626582,2,2,4
mr.watchandlearn,26.9147133534,5.14984675157,2,2,4
supernuggit,26.9084398479,4.36753767637,3,2,5
aisengobay,26.9025562348,4.33606383804,2,2,4
notlightningrunner,26.8919516884,4.32755510643,3,2,5
gaijilla,26.8541430517,5.24456922594,2,2,4
kaladin,26.8193794291,4.85733180033,2,2,4
barron,26.7658233802,4.90881828147,2,2,4
rgood,26.7603418362,4.40844911847,3,2,5
bunz,26.735165573,4.75320381865,2,2,4
drewgong,26.7161664967,2.84956822278,6,8,14
kelvinheit,26.7098686029,3.0951948049,4,5,9
nasian,26.6967887014,4.24330526681,2,2,4
hypa,26.6906245545,4.66747217319,2,2,4
droc,26.6168334602,4.82441931249,2,2,4
synth,26.609829181,4.33493918342,2,2,4
rocket,26.6085456095,2.68741740878,5,6,11
maliki,26.5905882406,3.68416870975,3,4,7
dixoncider,26.5855879165,4.43137193007,3,2,5
k-nut,26.5537371421,3.80008706009,4,3,7
hhhhhhhhhhhhhhh,26.5012571222,4.89299692726,2,2,4
neth,26.4888652287,4.81250871516,2,2,4
spunker,26.46148691,5.39224163072,1,2,3
beans,26.4603790823,2.58046998933,7,9,16
hoofy,26.4428021873,3.17903378335,5,6,11
pochilin,26.4403640874,5.29672942941,2,2,4
duncs,26.4320276709,2.28753988344,11,10,21
elated,26.4202913491,3.16345857911,6,4,10
hariballz,26.388930767,3.38298647581,4,4,8
village mascot,26.388070271,2.33092079567,9,11,20
duff man,26.3165440621,4.24959053614,2,3,5
mmneggs,26.3058876064,3.34970568997,2,6,8
luka,26.2941117225,5.15669574491,2,2,4
dusttin,26.2589956777,2.52537995236,9,9,18
mistertizye,26.2486889407,4.40089164521,1,2,3
white,26.2424899964,4.46351234283,2,3,5
thissidedown,26.219681198,5.24106029979,1,2,3
yrn,26.218959346,3.76793964093,3,4,7
leavescat,26.1418118779,3.50496791086,4,4,8
sandman,26.1362804608,4.62754522802,3,2,5
batterybird,26.106818423,4.04248717378,3,3,6
moonshoe,26.1006526788,2.83905326809,6,6,12
purple fox,26.0826152945,4.68062886934,2,2,4
reptar,26.058735739,3.67783061597,4,4,8
bringdaruckus312,26.0585891092,4.93971246405,2,2,4
rythemretrn,26.0177939388,4.92002604664,2,2,4
spaghetti,25.9989191524,4.04392629426,2,3,5
wincancel,25.9837040849,4.72723742945,2,2,4
capos,25.9375384928,2.2168039731,10,10,20
bflakes,25.9163695424,4.48265698201,2,2,4
dankpank,25.8891329991,2.39219024225,8,9,17
ace,25.8751852655,4.6355168465,2,2,4
imdabes,25.8391116057,4.92746511244,2,2,4
tipc,25.8213420018,4.96998362283,2,2,4
aces,25.7438517269,2.45120268455,8,12,20
moosh_da_moosh,25.7314211338,4.82140766753,2,2,4
hoofydough,25.7113062928,4.91600928402,2,2,4
therapture_,25.7113062928,4.91600928402,2,2,4
mixxedvegetables,25.6809593844,4.72851595519,2,2,4
bre,25.639012476,4.60931517626,2,2,4
brny,25.6114238679,4.81868948349,2,2,4
qubit,25.5807008818,4.90407462887,2,2,4
funkykong,25.5316879683,4.87497619444,2,2,4
beguiler,25.5284653263,4.94429671884,2,2,4
karlthemarx,25.5170909525,4.82004371416,2,2,4
kman,25.5120111883,5.15176625924,2,2,4
cyan can,25.4746993932,4.85996599431,2,2,4
kd3,25.4710617934,4.80986813254,2,2,4
gato,25.45673783,5.18458262465,1,2,3
snowstorm,25.3934923152,4.93156978565,2,2,4
geekliftus,25.3934923152,4.93156978565,2,2,4
reese,25.3801873125,4.60178319143,2,2,4
sinbad,25.3591758556,4.93210064829,2,2,4
stark,25.3538393317,4.58481178489,2,2,4
poptartplug,25.3389419353,4.94299476056,2,2,4
ringedge,25.3250764953,4.84878049501,2,2,4
salt,25.3053977954,4.96499721356,2,2,4
blueman,25.2983107659,4.9639791191,2,2,4
goosewithsocks,25.2807654815,3.54032697725,2,4,6
h2o,25.2659073664,4.86007916983,2,2,4
swiftbass,25.2622368269,4.89216411198,2,2,4
sonicfuzz,25.2544523575,2.75306035095,9,8,17
klms,25.2540556461,4.9265753216,2,2,4
wowzers,25.2437136137,4.68685155708,2,2,4
tauvalian,25.2420048651,4.89068256503,2,2,4
shake,25.2418007224,4.98310494103,2,2,4
yass2queen,25.2080105197,5.604375583,1,2,3
tootmoses,25.2030734801,4.8130042048,2,2,4
kaddy,25.1935464266,6.17369305993,1,1,2
z-rex,25.1815396759,5.67034682221,1,2,3
jazzy jinx,25.1773001046,4.69639147755,2,2,4
moist,25.1501241142,4.84335647834,2,2,4
kristoff,25.1455117651,2.75759706463,6,8,14
maniac379,25.1046882682,2.40182803519,7,11,18
dwreck,25.0918745664,5.05514075948,2,2,4
bacorn,25.0740560051,2.14204840057,10,13,23
antwon420,25.0471239458,5.46151851766,1,2,3
jinjo,25.0463802051,5.37824410789,1,2,3
lookalike,25.0417736066,3.61634173382,4,4,8
cuppajoe,25.0372556577,4.86363350069,2,2,4
apparition the ambassador,25.0314769692,2.26955788002,8,13,21
sun vulcan,25.0312276965,3.46893528603,4,4,8
mahie,25.0,8.33333333333,0,0,0
cortese187,24.9849240387,4.81497526303,2,2,4
clefairy as mew,24.9612859904,4.8678161245,2,2,4
mickeyrat,24.9542466833,6.26500222621,1,1,2
dezno,24.9542466833,6.26500222621,1,1,2
collin the conqueror,24.9470442643,5.04933891529,2,2,4
pizzajokes,24.9470442643,5.04933891529,2,2,4
smashg0d,24.9293768538,5.52604887667,1,2,3
j9d2,24.8696724162,4.36102899981,2,2,4
rawdog,24.8259463312,3.95170373352,3,3,6
soulbroker,24.8226272215,4.78694436349,1,2,3
dance!!,24.7985277364,4.94113111404,2,2,4
gaggleforce,24.7767455995,5.19088013974,1,2,3
the yid,24.7537783812,5.11572862009,2,2,4
chicken,24.7440031217,2.65249454176,6,8,14
gamer4life,24.7429166119,4.65903902943,2,2,4
ngwn,24.7381840918,5.68464339966,1,2,3
ham,24.7352040166,3.10244988377,4,8,12
zhu,24.6928586835,5.26457376368,1,2,3
cagt,24.6865292198,2.89328027076,6,7,13
natty,24.6844611071,4.42354381667,2,2,4
weedwack,24.677484977,4.7003546321,2,2,4
lldl,24.6408296169,4.92675042597,2,2,4
tetsu0,24.6262993259,5.03796166079,2,2,4
static,24.6008810179,4.43189122726,2,2,4
nalgas,24.6002124435,4.09147909928,3,3,6
fanboy,24.5551816752,5.75018982458,1,2,3
leaf fc,24.542814831,3.85644210104,3,4,7
savior,24.5299713381,4.87200900025,2,2,4
david barker,24.4854001285,5.67014521521,1,2,3
blue bear,24.4811564973,4.97400733677,2,2,4
satch,24.4802972817,5.0464574621,2,2,4
jlo,24.4788461412,4.23618089962,3,3,6
eggmcmuffin888,24.4738142841,3.62325416204,4,4,8
steamfriedasian,24.4582480014,5.06356359914,2,2,4
muse,24.4377744855,4.7722743941,2,2,4
nuggzy,24.4222477412,4.68422976186,2,2,4
-philip coast philip-,24.3792903153,5.45304440367,1,2,3
adrian,24.3747996475,5.02034202978,2,2,4
han,24.3188992937,4.70763422455,2,2,4
bhol,24.2886391258,3.58671066862,3,4,7
hunter,24.2734826416,5.05243995141,2,2,4
butcher of bakersfield,24.2663102043,3.32848426011,4,5,9
jungle,24.1987083155,4.80610199671,2,2,4
waldo,24.1753254558,4.11546555848,2,3,5
keagsbsmashin,24.1694684192,4.79629526784,2,2,4
hamburglar,24.1621836968,5.00571875091,2,2,4
little bill,24.1390956232,5.30308975414,1,2,3
luigikid,24.1305246277,4.81093358089,2,2,4
billbacon420,24.0950656947,5.69697364686,1,2,3
ravioli,24.0938144638,5.04758146343,2,2,4
mrpoo,24.0938144638,5.04758146343,2,2,4
ditto,24.0786213438,5.27696000247,2,2,4
nich,24.051848558,5.03396569322,2,2,4
probers,24.0361802424,4.66378750652,2,2,4
fingerblast,24.0343864031,3.93272588312,3,3,6
mr. biz,24.0325158375,5.05035439798,2,2,4
crazyk115,24.0236264376,4.58502916019,2,3,5
frostbyte,24.0165672509,4.0204087533,3,4,7
sombrero,23.9767635054,5.35145865679,1,2,3
kevine,23.9694806945,5.6177536079,1,2,3
frogman [charette],23.9629586064,5.62524597174,1,2,3
cormander,23.9554394409,3.05433065725,4,7,11
lalo,23.9039809957,3.83857275929,3,4,7
kriskringle,23.9024923491,4.44636620007,2,2,4
pokeiman_master,23.9007193478,5.35425456411,1,2,3
jaquarium,23.8986516109,5.19013016581,2,2,4
sebastian,23.8856405837,5.62456426791,1,2,3
monkey,23.8765868078,4.96830367908,1,2,3
hotsauce,23.8737731151,5.54242118765,1,2,3
rebel scum,23.8466970197,3.22433433283,4,5,9
reno,23.8454015557,4.61595500308,2,2,4
meatbeef,23.8256057919,5.31975166163,1,2,3
dankestdad,23.820599809,3.54709741439,4,4,8
weirdy man,23.8127976165,4.88885564151,2,2,4
pintoa,23.7734248099,3.69093235527,3,5,8
dad's musical erasers,23.7494567511,5.46738239721,1,2,3
prime,23.7090971855,2.53786486566,7,12,19
zenaga,23.6995468826,5.51041351297,1,2,3
superflopp,23.6896014171,4.83546634707,1,2,3
wal,23.680769945,5.78786521659,1,2,3
yolochi,23.657024612,5.73711003942,1,2,3
engdrew,23.5979535793,4.67138841348,2,2,4
howdy,23.5636260842,4.47538835513,2,4,6
izoo,23.5614870398,5.43011146819,1,2,3
derstuk,23.5584627999,3.52969414226,4,6,10
maps,23.5522973636,2.73301150374,4,8,12
jmabate,23.5505229459,5.13344476411,1,2,3
arctic,23.5412110525,5.42581543263,1,2,3
pika,23.514032207,5.44392416743,1,2,3
nuro,23.5080409927,4.05549467614,3,3,6
bottle opener guy,23.4846566936,3.25120731929,4,4,8
train_town,23.4594786392,5.11354068695,1,2,3
moze,23.4413102645,4.99645690482,1,2,3
cbones,23.4118466893,5.3741936705,1,2,3
qapples,23.3605205925,5.36146595569,1,2,3
bodacious,23.352876492,4.02601646314,3,4,7
ir,23.3499798037,5.33364103374,1,2,3
macintosh,23.3462813869,4.37003095453,2,3,5
daddy's milk,23.3241696007,3.58842991213,4,5,9
kzidek,23.2863119817,5.35136986949,1,2,3
 ô·¥è·¥Ö·¥Ä·¥Ñ…™·¥è·¥ús,23.2860784575,3.40185277672,2,6,8
jollie,23.258045454,3.03800500549,5,7,12
lucky_hamburger,23.2186588384,5.26212209023,1,2,3
cane ut,23.2042071418,5.37452818268,1,2,3
ego,23.194541687,5.57174097001,1,2,3
qtip,23.1910720358,5.96847661703,1,1,2
evals,23.1715819438,5.29058144113,1,2,3
t-beau,23.1660560338,4.95090358518,2,2,4
sd master,23.1568977681,5.18137296625,1,2,3
ardent rage,23.1356590704,5.34723184218,1,2,3
vidya_james,23.1296702163,5.46105161925,1,2,3
prism,23.0866441296,5.74431129255,1,2,3
masquerade,23.0816744485,5.51639204116,1,2,3
hiv+,23.0811767002,5.2516046076,1,2,3
elitescoringguy,23.0731024925,3.6095111381,3,5,8
ocelot,23.0559251978,2.72289312685,4,10,14
gibbles,23.0411736695,4.98970481603,1,2,3
dankey kang,22.9493205465,5.52291040788,1,2,3
slartibartfast42,22.9398519011,4.0176712361,3,4,7
nigel_thornberry,22.9207264676,5.25914764718,1,2,3
xanz,22.9146545791,5.11949095127,1,2,3
icactusdog,22.9102706453,3.00585066996,4,9,13
the amazing busterino,22.8926262715,4.97058004014,2,2,4
brotherly,22.8902029286,5.2165176492,1,2,3
darv,22.861535888,4.48043634005,2,4,6
v-bomber,22.8346027366,3.94477700004,3,4,7
hayrow,22.8318553693,5.61483967654,1,2,3
big d [hamiel],22.780993209,5.20871385611,1,2,3
precookedbread,22.7806286309,5.29131673702,1,2,3
maaron,22.7767817276,5.26192937688,1,2,3
hsf,22.7763814393,5.27129329791,1,2,3
gera,22.7729761187,5.35735359026,1,2,3
miken,22.7558240765,7.19067244328,0,1,1
blahguy,22.7194533242,5.60201427516,1,2,3
boh,22.7186386742,5.2513492825,1,2,3
myninja,22.716912861,3.78145354127,2,4,6
blackf00t,22.7068181499,4.30540940999,2,4,6
nathansandwich,22.702000146,4.25202445926,3,4,7
paco [larkin],22.6970080719,5.51836530984,1,2,3
changed man,22.6867102224,5.67101579923,1,2,3
cooljoe,22.678172382,5.23651198789,1,2,3
squible,22.6739382715,3.55661216925,3,4,7
ondas,22.6395824631,3.52461393156,3,5,8
zibba,22.6173969986,5.39195617113,1,2,3
schlag,22.5495819272,5.64622353279,1,2,3
littlespoon,22.5284895543,5.43765883182,1,2,3
xiivi,22.5242568431,3.12246800082,5,7,12
dasit mane,22.5241618128,3.911435579,2,5,7
neat,22.5085770168,5.36543693664,1,2,3
damp,22.5027577978,4.26103820797,2,3,5
tmakk,22.4105238057,2.96678902576,5,8,13
robnu,22.4009518598,4.4100118432,2,4,6
banana fiend,22.3948581374,4.97305946234,1,2,3
brown_omega253,22.3842982122,5.39207071382,1,2,3
midgetto,22.3513493277,3.91913215456,3,4,7
mourin,22.3362774999,5.52092281217,1,2,3
chiefreaper,22.3061587368,5.36519924366,1,2,3
yakal,22.2950630033,5.45881954507,1,2,3
walkrofsky,22.2930693144,3.67242153145,2,4,6
shasta,22.1955803154,5.07941061826,1,2,3
capsui,22.1598170777,5.53610295583,1,2,3
stew,22.1192791117,3.31857526628,4,5,9
chai,22.0960315305,7.05717399737,0,1,1
firefly,22.0832446758,5.52720444839,1,2,3
tubby!,22.078831617,5.43540934229,1,2,3
flare,22.0738376453,5.55336859451,1,2,3
boogie!,22.0644004413,3.55121002389,3,5,8
sadu,22.0372260241,5.605089892,1,2,3
slappymcnutz,22.0212456783,5.23959901797,1,2,3
r.o.m.,22.0128787597,5.554682334,1,2,3
castaway,21.9996617541,5.60670948865,1,2,3
mortech,21.922362205,3.33112523921,4,7,11
malkasaur,21.8970233354,7.00839318003,0,1,1
zad,21.881379889,3.36556512154,3,7,10
blisstex,21.8564964912,4.34727989693,2,4,6
scruffy mcwonder crumpet,21.8020421301,5.33797958755,1,2,3
spt,21.7950653918,5.49713248136,1,2,3
khakis,21.7912271073,4.2764290609,2,4,6
mulkster,21.7904849304,5.33558898091,1,2,3
leet,21.7148400594,5.54373941676,1,2,3
trevman,21.7053445722,5.17764394141,1,2,3
burnt out ninja,21.6867950646,5.49425252058,1,2,3
fawnco,21.6867950646,5.49425252058,1,2,3
birdlordmasterbeak,21.6798795071,5.44449392237,1,2,3
k,21.6686004382,5.29479350461,1,2,3
jaws,21.6312919782,5.16118628807,1,2,3
mr_sharpie93,21.6248305885,5.33734769425,1,2,3
evab,21.5855008588,5.46498187956,1,2,3
cardoso,21.5660778322,5.4610452728,1,2,3
maestro,21.5424663615,5.48103394783,1,2,3
anathema,21.5047657545,5.52858492613,1,2,3
jirachinick,21.5047657545,5.52858492613,1,2,3
dhir,21.5047657545,5.52858492613,1,2,3
k-man,21.5047657545,5.52858492613,1,2,3
giraffe,21.5047657545,5.52858492613,1,2,3
zwephy,21.5047657545,5.52858492613,1,2,3
drlight,21.5047657545,5.52858492613,1,2,3
kossismoss,21.5047657545,5.52858492613,1,2,3
zombie!,21.5047657545,5.52858492613,1,2,3
fearlesscaboos,21.4930417573,5.37207909725,1,2,3
dirtcruncher,21.4864392925,3.05016138712,4,8,12
thenuge,21.4834203318,3.53596845738,3,5,8
drewskii55,21.4121457178,5.11850231436,1,2,3
godspeed,21.3877925958,3.07129149876,4,7,11
esuma,21.3511290771,5.46780250884,1,2,3
silentknight,21.3429283565,3.73337621944,2,6,8
chaos pro,21.3422581477,5.51129103904,1,2,3
pastor,21.3422581477,5.51129103904,1,2,3
napkins,21.3422581477,5.51129103904,1,2,3
whoopiecow,21.3422581477,5.51129103904,1,2,3
rhubarb,21.2864311045,2.97470997668,4,8,12
yaron,21.2461410632,3.7274123538,1,6,7
krypto,21.2336873564,4.42996495107,2,4,6
barrels,21.2316392653,3.08601549898,3,8,11
gumbolaya!,21.2289146494,5.23991075822,1,2,3
astumpycow,21.2198698924,5.41073778485,1,3,4
pzero39,21.1995540169,5.34790690083,1,2,3
caelan,21.148080321,7.07591989995,0,1,1
mr baninawi,21.1384803928,4.58263545968,1,2,3
hungrybox,21.1366567644,4.49648285979,2,4,6
the drew,21.1304117444,2.6989813331,4,10,14
throwz?!,21.112323697,5.15730915441,1,2,3
chinstrap,21.1039973139,4.07731458866,2,4,6
15(ichigo),21.070209472,5.51002169606,1,2,3
andy,21.070209472,5.51002169606,1,2,3
nyx,21.070209472,5.51002169606,1,2,3
kavon,21.070209472,5.51002169606,1,2,3
flatline,21.070209472,5.51002169606,1,2,3
iceking,21.035651248,4.43870383163,2,4,6
highlyeducational,21.0243383448,5.26919766642,1,2,3
eliot,20.997525448,3.73764482673,2,6,8
sunshinetk,20.9652073312,4.27054499001,2,4,6
hotpocket,20.956131557,5.52943117951,1,2,3
myroknpancakes,20.8936061849,4.26496677923,2,4,6
hipo,20.8809557962,5.25386526572,1,2,3
therm,20.8278030847,6.43659927828,0,2,2
magitech,20.7592670566,6.88518332941,0,1,1
joshi,20.7267647624,6.89420209085,0,1,1
yungpurp,20.7199998905,6.65800939974,0,1,1
redribb0n,20.6905799049,6.83924500234,0,1,1
kingcool,20.6889800094,3.44743274344,3,6,9
heartsdealer,20.6792794833,4.23734365289,2,4,6
snazzy,20.6718648166,5.43530369455,1,2,3
bohemian milk,20.6559257024,5.33527578769,1,2,3
shyguyking,20.6176088469,3.73176478587,3,5,8
grrg,20.6117485863,2.58565248966,6,12,18
god,20.60416798,7.17147558733,0,1,1
akito555,20.60416798,7.17147558733,0,1,1
penance,20.60416798,7.17147558733,0,1,1
dishier wand,20.60416798,7.17147558733,0,1,1
neverpullout,20.60416798,7.17147558733,0,1,1
ragingcherry,20.60416798,7.17147558733,0,1,1
yung,20.60416798,7.17147558733,0,1,1
akajumo,20.60416798,7.17147558733,0,1,1
the cfb,20.60416798,7.17147558733,0,1,1
adubz,20.60416798,7.17147558733,0,1,1
bunmira,20.60416798,7.17147558733,0,1,1
branchan,20.60416798,7.17147558733,0,1,1
4sk,20.60416798,7.17147558733,0,1,1
uprowr,20.60416798,7.17147558733,0,1,1
masterofzoroark,20.60416798,7.17147558733,0,1,1
patty-wagon,20.5876097381,6.78784393705,0,1,1
spaff,20.5610555606,6.47389141057,0,2,2
flat nat,20.5479924873,6.95413511092,0,1,1
krutchby,20.502033542,5.4629936423,1,2,3
bronze_sun,20.4938607321,6.92549349541,0,1,1
izze,20.4411055742,4.71632313416,1,4,5
schmerka berl,20.4363731895,3.52332577874,3,8,11
tdp,20.3924857844,5.23202975166,1,2,3
astumpyzombie,20.3821885129,4.43917734285,1,4,5
beets,20.3810074908,5.03848159598,1,2,3
mattatari,20.3728408526,5.23299737103,1,2,3
homemadewaffles,20.3612733202,6.92690169084,0,1,1
rice,20.3612733202,6.92690169084,0,1,1
danny,20.3438417603,6.85964341651,0,1,1
big d squirrels,20.2862842216,4.19428929413,2,4,6
redeagle2000,20.2694846785,6.54495798309,0,1,1
mojo,20.2456794396,4.39971882591,2,3,5
swankeaboo,20.2402561334,5.20156078642,1,2,3
danno,20.239360524,5.26908883014,1,2,3
spell,20.1512583707,6.86040096874,0,1,1
hans_mawell,20.1279428502,6.89704561133,0,1,1
i use tap jump,20.1279428502,6.89704561133,0,1,1
fry,20.1262910456,5.13638793868,1,4,5
the professor,20.0902634533,3.4639226375,3,7,10
hotspank,20.087540935,5.15684123528,1,2,3
weatherman,20.0656383241,4.8185524182,1,4,5
erk,20.0492333773,6.44074465425,0,2,2
garv,20.0462174719,3.77708706334,2,3,5
et,19.9865723905,6.74398184354,0,1,1
woof,19.9728803155,3.51699312077,2,7,9
tokaji,19.9579729502,5.31736686858,1,2,3
mikelangelo,19.9500485291,6.474817557,0,2,2
lou sanus,19.9227735063,3.86513934716,1,6,7
moustasher,19.8767987977,2.94806586797,5,9,14
fractal,19.8252639337,6.80589255086,0,1,1
java boy,19.8222814961,5.32304432586,1,2,3
yolft,19.813632835,3.63297502145,2,6,8
nami,19.809354655,6.67820972099,0,2,2
depressed eagle,19.7821090704,4.60868179082,1,4,5
brambramjam,19.7661579584,4.76819120464,1,3,4
sk,19.7618667329,6.3175741257,0,2,2
guccipivotmaster4000,19.7611884188,6.45038251077,0,2,2
jedipanda,19.7262769055,4.3196373264,1,5,6
gallyg,19.7211268474,6.21844109751,0,2,2
tallyshell,19.6468003922,4.79883485272,1,3,4
seantos,19.6417501716,3.09053681723,4,10,14
dmolz,19.6269438817,3.92874887603,1,6,7
husker,19.5931033516,4.26936986944,1,5,6
turtlpower,19.5863016892,6.35928386871,0,2,2
bogmyer,19.5857798245,4.35947821229,1,4,5
luwolf,19.5844892736,6.20840631123,0,2,2
acestarthe3rd,19.5772004683,6.41778962929,0,1,1
iacme,19.5507551047,6.00570146008,0,2,2
dude,19.5026638594,6.91123888483,0,1,1
multiball,19.4739068198,3.24592710128,3,8,11
elu,19.4268137883,3.95635840604,2,6,8
general1712,19.4206353327,4.70309214547,1,5,6
jose,19.3900010576,6.56882410874,0,1,1
squallette,19.2587328724,6.38618672098,0,1,1
missingn0,19.2450213778,6.11511688484,0,2,2
bear,19.2370196838,4.23425593954,1,4,5
nagurnimaster,19.2343577323,6.23400172038,0,2,2
twunt,19.1742161206,4.68545163478,1,4,5
jad,19.1399526773,6.42812648465,0,2,2
mariokartmoney,19.1263628643,4.93003836048,1,4,5
kobra,19.0906594211,4.89608178096,1,4,5
magnus combosen,19.0710020629,4.76836714906,1,4,5
mello,19.0537350268,6.60544666513,0,2,2
maximum can,19.03388571,6.29917382393,0,2,2
esmod,19.020145015,6.53300247209,0,2,2
da_bear,19.0028728103,6.87267909617,0,1,1
bonerstorm,19.0028728103,6.87267909617,0,1,1
rf!,19.0028728103,6.87267909617,0,1,1
milleneum,18.9914016863,4.29511822057,1,4,5
duck chris,18.991102856,6.52889642219,0,2,2
sabo,18.9895447961,6.83048033888,0,1,1
scootieloo,18.9073173409,6.08773885152,0,2,2
jgin,18.8687596805,5.9705800501,0,2,2
jackmehoff,18.8591029525,6.01536787408,0,2,2
refriedjeans,18.8542631408,6.81028010861,0,1,1
stdangerous,18.8357892093,6.22895473857,0,2,2
brendanhall,18.7970867362,6.54992705426,0,1,1
pugdaddyfre$hlyfeogg*flva,18.7582594816,6.34066418816,0,2,2
pilot,18.7550467167,6.63971746947,0,1,1
urpasmash,18.6892117664,6.49071121113,0,2,2
broonz,18.6771715936,3.28800331675,3,8,11
spicky,18.6582839024,6.7839920662,0,1,1
fish,18.644655946,6.47450021445,0,2,2
minusev,18.5904361491,6.45647829037,0,2,2
pidgezero_one,18.5806217981,3.49982244311,2,7,9
tbone,18.5774730416,6.29260400231,0,2,2
kl3an,18.5588529466,6.38820575423,0,2,2
lukem,18.5226291324,6.70750544893,0,1,1
youtwo,18.4585701402,6.47051486517,0,2,2
lloyd-black,18.4380724999,3.37206774755,2,8,10
bus,18.4033731809,6.21857036024,0,2,2
master jay,18.3790600321,6.39548886025,0,2,2
tydye,18.3703722499,6.39112782487,0,2,2
charlie harper,18.341005986,6.3852507322,0,2,2
whitegrizzly,18.321642546,6.02218472055,0,2,2
quinceprince,18.32105969,6.2418644638,0,2,2
nokto,18.3054970617,6.2492609539,0,2,2
big tone,18.2782668002,6.40674489183,0,2,2
albinosaurus,18.2596986996,6.14695225398,0,2,2
blues,18.2561780739,4.81594315439,1,4,5
putpasswordhere,18.2171141797,4.78960947374,1,4,5
avian,18.2135081597,6.35266839978,0,2,2
swerve,18.1949339371,6.34816881003,0,2,2
jesusisking,18.1797671348,6.12566703695,0,2,2
tylenol jones,18.110103572,6.32861787932,0,2,2
aerodet,18.1062489958,6.1910746538,0,2,2
starcutter,18.078370117,6.20432197443,0,2,2
sfat,18.0583866265,6.30932802208,0,2,2
instacover,18.0500741902,6.31453002242,0,2,2
warmachine1919,18.0428187692,6.46387437135,0,2,2
fen,18.0280431471,4.35906342505,1,5,6
electricgazelle,18.0054623606,6.70491637149,0,1,1
hero,18.0031787494,6.30456695442,0,2,2
yam$,17.9980023599,6.32119878345,0,2,2
dennysgrandslambreakfast,17.9980023599,6.32119878345,0,2,2
zarfon,17.9980023599,6.32119878345,0,2,2
drhino,17.9980023599,6.32119878345,0,2,2
akiva,17.9980023599,6.32119878345,0,2,2
jpoptosis,17.9980023599,6.32119878345,0,2,2
duckpimp,17.9980023599,6.32119878345,0,2,2
snack?,17.9980023599,6.32119878345,0,2,2
laugh,17.9980023599,6.32119878345,0,2,2
astropancakes,17.9980023599,6.32119878345,0,2,2
lights,17.9816499173,6.29750892389,0,2,2
alex,17.974994974,6.29057190604,0,2,2
turtle,17.9620315943,6.05749932673,0,2,2
beaver,17.958835544,6.31200221875,0,2,2
sunkin,17.9422599369,6.28362483847,0,2,2
austntatious,17.9417075172,6.10062641597,0,2,2
wolfcry,17.9230213746,6.16381175236,0,2,2
pigwick,17.9085248734,5.83873928228,0,2,2
nfreak,17.8490765439,6.28467902917,0,2,2
maxi,17.8471382488,6.27199149472,0,2,2
holosly,17.8405629898,6.27988339032,0,2,2
ebay,17.8359797122,6.26745356674,0,2,2
jojohnson,17.8270005524,6.29388615473,0,2,2
5000candlesinthewind,17.8270005524,6.29388615473,0,2,2
jfm,17.8270005524,6.29388615473,0,2,2
oljace,17.8270005524,6.29388615473,0,2,2
flash,17.8270005524,6.29388615473,0,2,2
giggitoxin,17.8270005524,6.29388615473,0,2,2
harmless,17.8270005524,6.29388615473,0,2,2
legoman,17.8270005524,6.29388615473,0,2,2
tuna,17.8270005524,6.29388615473,0,2,2
armor,17.8270005524,6.29388615473,0,2,2
black rob,17.8244845934,6.26609822148,0,2,2
mrryanness,17.8012990057,4.75126295633,1,4,5
nadamoor,17.7933081784,6.27484080414,0,2,2
shug,17.748584052,3.76570367541,2,6,8
fs shampoomaster,17.6746083375,6.23169220719,0,2,2
liam_butler,17.6673384456,6.26628461383,0,2,2
matt47,17.6673384456,6.26628461383,0,2,2
goomah,17.6664063144,6.2360574715,0,2,2
meowmix,17.640951491,6.34955791874,0,2,2
uncle onion,17.6088232344,6.2344399148,0,2,2
caleb,17.6083858438,6.14425438923,0,2,2
gambit,17.5381058359,6.04022060431,0,2,2
xlax,17.5183812826,4.72722994877,1,4,5
blank,17.5157993115,5.9797827329,0,2,2
dr. light,17.4910590158,6.18783902128,0,2,2
kevorkian,17.4864699669,3.66655834523,2,8,10
kieuarty,17.4561711102,6.17694174482,0,2,2
mechanicalmarine,17.4443234559,6.30506645139,0,2,2
magfmur,17.4412025514,5.99671252336,0,2,2
scraggus,17.4387726719,6.18889517073,0,2,2
thegoat,17.4077002079,6.29921052072,0,2,2
levity,17.3906834127,6.18744334256,0,2,2
spammalanche,17.3839569334,5.71038817229,0,2,2
draxsel,17.358477432,6.16091093994,0,2,2
jerzilla,17.3191200022,6.0827600164,0,2,2
frogge,17.3106243437,5.7958894936,0,2,2
rodan,17.2927368247,5.76880439345,0,2,2
rockmix,17.2701355939,5.93191792771,0,2,2
juan doe,17.2595814724,6.26664430641,0,2,2
bozz,17.2550251036,6.269075413,0,2,2
awesomethesauce,17.2356560356,6.07607539814,0,2,2
sad,17.2337277143,6.26559255122,0,2,2
drill,17.2305372522,6.25854023277,0,2,2
jobook,17.2263344789,6.25825537996,0,2,2
4 phri,17.2235887762,6.2635158315,0,2,2
fig,17.2100443671,4.23660096954,1,5,6
marfslayer 3000,17.1573329149,6.26923433457,0,2,2
katiebug (sfk),17.1368385314,6.05825628019,0,2,2
sianvar,17.1295386788,6.07090991585,0,2,2
amaya,17.120377916,6.24601280341,0,2,2
lunchy,17.0699686222,6.08232004122,0,2,2
superduperfanofboom,17.0516014721,6.22387436003,0,2,2
werewyatt,17.0342863209,3.98897117378,1,5,6
lonk,17.0073866723,6.02726524418,0,2,2
kayo,16.9847071864,6.21981855558,0,2,2
tarn,16.9557330379,5.80970065648,0,3,3
rocktimus crime,16.9435948502,4.91947414791,0,5,5
redwolf,16.9338774599,5.78770333991,0,2,2
sven stormbeard,16.9273178368,6.23983584333,0,2,2
riseup93,16.9273178368,6.23983584333,0,2,2
shadow light master,16.9273178368,6.23983584333,0,2,2
dd,16.9273178368,6.23983584333,0,2,2
skubtard,16.9273178368,6.23983584333,0,2,2
red,16.9273178368,6.23983584333,0,2,2
yuxminato,16.9273178368,6.23983584333,0,2,2
muthaluva777,16.9273178368,6.23983584333,0,2,2
sambook,16.9273178368,6.23983584333,0,2,2
grraffe,16.9273178368,6.23983584333,0,2,2
bean,16.9273178368,6.23983584333,0,2,2
irish,16.9273178368,6.23983584333,0,2,2
heisenberg,16.9273178368,6.23983584333,0,2,2
ferrero64,16.9273178368,6.23983584333,0,2,2
digital cannon,16.9273178368,6.23983584333,0,2,2
d-tek,16.9273178368,6.23983584333,0,2,2
waffles,16.9273178368,6.23983584333,0,2,2
zombieheart84,16.9273178368,6.23983584333,0,2,2
myk,16.9273178368,6.23983584333,0,2,2
j,16.9273178368,6.23983584333,0,2,2
zurdo,16.9273178368,6.23983584333,0,2,2
miles,16.9273178368,6.23983584333,0,2,2
sharktoast,16.9273178368,6.23983584333,0,2,2
sleeh,16.9273178368,6.23983584333,0,2,2
mr.e [rohr],16.9273178368,6.23983584333,0,2,2
ubll black mage,16.9273178368,6.23983584333,0,2,2
qk shkz,16.9273178368,6.23983584333,0,2,2
benbook,16.9273178368,6.23983584333,0,2,2
aperture,16.9273178368,6.23983584333,0,2,2
sfgman,16.9273178368,6.23983584333,0,2,2
atari,16.9273178368,6.23983584333,0,2,2
searcher,16.9273178368,6.23983584333,0,2,2
aubfox,16.9273178368,6.23983584333,0,2,2
kezzup,16.9273178368,6.23983584333,0,2,2
monk,16.9273178368,6.23983584333,0,2,2
rickter_scale,16.9273178368,6.23983584333,0,2,2
azzy,16.9273178368,6.23983584333,0,2,2
theycallmechris,16.9273178368,6.23983584333,0,2,2
voidstar,16.9273178368,6.23983584333,0,2,2
hyperbole,16.9273178368,6.23983584333,0,2,2
fs mook,16.9273178368,6.23983584333,0,2,2
deku,16.9273178368,6.23983584333,0,2,2
themickeynick,16.9273178368,6.23983584333,0,2,2
umi,16.9273178368,6.23983584333,0,2,2
jazz,16.9273178368,6.23983584333,0,2,2
hail_sagan,16.9273178368,6.23983584333,0,2,2
scuttlebug jamboree,16.9273178368,6.23983584333,0,2,2
uh what,16.9273178368,6.23983584333,0,2,2
beekle,16.9273178368,6.23983584333,0,2,2
paper tiger,16.9273178368,6.23983584333,0,2,2
raxcity,16.9273178368,6.23983584333,0,2,2
thac0,16.9273178368,6.23983584333,0,2,2
grunyan,16.9273178368,6.23983584333,0,2,2
edwin...,16.9273178368,6.23983584333,0,2,2
sunshine,16.9273178368,6.23983584333,0,2,2
smashlopez64,16.9273178368,6.23983584333,0,2,2
phalanx,16.9093882126,6.20923233147,0,2,2
m2cain,16.8917944753,6.20916135901,0,2,2
bunnyblast,16.8822801378,6.20385470448,0,2,2
da bear,16.8812761375,6.06876330157,0,2,2
blizz,16.865327086,6.19888552083,0,2,2
mookie,16.8580758398,6.18930539343,0,2,2
russellsprouts,16.8464471672,5.31227130459,0,4,4
rabizkoshik,16.8426869985,4.44375782152,1,5,6
louieg,16.8356845095,5.90330272919,0,2,2
dk dredd,16.7761720308,5.93345080588,0,2,2
karl,16.6989346205,5.54304228755,0,3,3
iamlazee,16.696235966,5.77536098107,0,2,2
charlie,16.626441672,5.82863506371,0,2,2
colt,16.6196458199,6.16564338099,0,2,2
scott,16.5992027472,6.1532346497,0,2,2
scaryman,16.5975650625,3.92569260291,1,6,7
mikeyg,16.5700072487,5.890521247,0,2,2
bc_burns,16.5383659216,6.12783790491,0,2,2
hashi,16.5372239865,5.86838789476,0,2,2
oxycontin,16.5203068495,3.35229588792,2,7,9
showtime,16.5143839462,5.93526576755,0,2,2
curiousplaces,16.4946314178,5.98428371546,0,2,2
robslabgod,16.4755336938,5.63897775284,0,2,2
pvc,16.400476286,5.99329902216,0,2,2
papa,16.3761193681,5.26067236911,0,4,4
mike4real,16.3699266321,5.81680290168,0,2,2
nyani,16.3397594719,5.85967955801,0,3,3
sam,16.3381578045,6.13084543509,0,2,2
fumofuu,16.3030542888,5.91672443964,0,2,2
dunos_,16.2878779255,5.97763085216,0,2,2
kraken,16.2658891577,5.86023295168,0,2,2
polarbair,16.2621781536,6.13412271997,0,2,2
jame,16.2618344053,6.12535137501,0,2,2
juno,16.2311025997,5.97438046955,0,2,2
b vu,16.2020407999,5.76091243501,0,2,2
recneps,16.1322664317,4.00940667163,1,7,8
yung god,16.085444764,6.08376265746,0,2,2
noelkitten,16.0288009988,5.69217195777,0,2,2
codytappen,15.9983811971,5.62916430069,0,2,2
thedarkdreamer,15.8117426471,6.01673635797,0,2,2
bulldog,15.7875607058,6.01539646542,0,2,2
thissideup,15.7356623074,5.74691500501,0,2,2
ohhhbreezy,15.6702363045,3.92484122059,1,6,7
fmax,15.6571819918,5.57142233693,0,4,4
ceephax,15.6421373773,5.79299171216,0,2,2
tweli,15.607098272,5.97659921269,0,2,2
jet fuel,15.4976218862,3.81393280626,1,7,8
bennyboy98,15.4933695031,5.82064315945,0,2,2
kohenbro,15.4047986868,4.99951426716,0,5,5
failcant,15.357851223,5.8152051293,0,2,2
sweaters,15.3576121017,6.06819483028,0,2,2
abc,15.3337272677,5.91471399227,0,2,2
foxnard,15.3071677446,5.82377275518,0,2,2
ejmp,15.2599305411,5.67318032971,0,2,2
jackkenney,15.2179214176,5.59471936161,0,2,2
cr0ak,15.1875993065,5.90448236514,0,2,2
vondo,15.1580492309,4.50349728494,0,6,6
thisisgettingold,15.115537955,5.93072884891,0,2,2
tanuki,15.1114595287,5.7501719578,0,2,2
ryden hope,15.0465713965,5.70803561869,0,2,2
nikku,15.0008886257,5.85921244623,0,2,2
ppdmd,14.9247578391,5.84013101842,0,2,2
dr-wumbo,14.9067404896,5.47094916165,0,2,2
falln,14.9042212245,5.66942780539,0,2,2
adulix,14.894363068,5.00342255587,0,5,5
neph_girl,14.8681521042,4.29337799099,0,7,7
deep dimples,14.827565824,4.53563174687,0,5,5
djltheescapade,14.7834183395,4.94007254972,0,5,5
nardwell,14.6555827789,2.79192720369,2,17,19
sugaaku,14.4458284627,5.37156501497,0,4,4
dr gibs,14.3419443148,4.69367585186,0,5,5
elrond,14.2988052195,4.1880909207,0,7,7
phex,14.2801438421,5.31669686301,0,4,4
mjim,14.203268616,4.48279087284,0,5,5
link,14.1665568654,5.7580728291,0,2,2
cat,14.0798507803,4.75028887024,0,5,5
jpeghero,13.9960615928,3.73660658896,1,8,9
jedisalazar,13.9563316473,4.95829803815,0,4,4
whiz kid,13.9245818139,5.20699171284,0,4,4
2%gay,13.6517742621,4.95455402708,0,6,6
paul d,13.5849771191,5.21767976443,0,4,4
jeremy,13.5789458536,5.06969480161,0,4,4
nnaughtydogg,13.542532342,4.34848522876,0,6,6
shwang,13.3686879443,4.6571491862,0,6,6
bung0o,13.3629825334,4.50908500892,0,6,6
bagel,13.3436736534,4.48712160472,0,6,6
tehz,13.2437424562,4.69593086243,0,6,6
jonnjonn,13.1448857633,4.64436017747,0,5,5
blanco mano,12.8580337922,4.39617992678,0,6,6
golfclubninja,12.4563634614,4.61116264315,0,8,8
jimbot,12.3978743461,4.4356824385,0,7,7
