player,rating,rd,sets,wins,losses,num_tourneys
k y s k,2262.36813104,153.934772247,10,8,2,1
superboomfan,2121.04226558,68.2694245667,107,100,7,11
alvin,2069.45886898,83.4651397584,30,26,4,3
yu-kun,2002.3111867,154.475826037,8,6,2,1
taimai,1976.04902261,162.362836557,7,5,2,1
wizzrobe,1968.25650613,65.5820481001,70,57,13,9
mariguas,1952.81070495,68.5302721219,59,47,12,6
dext3r,1909.2197997,69.7370471739,49,37,12,5
kerokeroppi,1908.37483117,63.0667302141,81,62,19,9
tacos,1890.52696074,68.4475533669,59,45,14,7
tr3gthez,1887.92950492,73.6388389222,46,35,11,5
isai,1886.98278318,82.5166692688,40,32,8,4
barksanchez,1877.19389228,62.173203251,55,39,16,7
zantetsu,1854.91602206,108.594573957,17,13,4,2
wario,1854.0221633,144.573041605,11,10,1,1
vinsanity,1846.19341828,146.063035911,8,6,2,1
kurabba,1840.17281464,148.620114555,9,7,2,1
dtan,1837.79898802,75.3944387309,33,23,10,4
stranded,1836.43341348,82.501725635,31,23,8,4
revan,1821.7797655,68.791528484,52,39,13,6
lowww,1813.14333142,139.106368101,9,7,2,1
prince,1813.10573268,140.575964575,9,7,2,1
wangera,1806.13160282,102.696884962,21,16,5,2
fireblaster,1798.86332897,64.6363776568,74,54,20,9
heropie,1792.6899803,104.641633006,16,12,4,2
marbles,1783.86361348,78.6556478317,38,27,11,5
derek #squats,1780.09896152,101.361799447,16,11,5,2
lorenzo,1778.26131989,83.8521949483,30,22,8,4
jaimehr,1767.10377427,76.4855476922,39,27,12,5
fox,1764.93593515,96.3012513128,24,17,7,3
bark the shark,1763.33175924,79.1417732755,40,29,11,5
firo,1762.07049906,88.5292532761,23,15,8,3
$$$ jim $$$,1747.77155166,97.7095364271,17,12,5,2
combo blaze,1746.78646918,85.0296343843,30,20,10,4
mojomonkey,1737.76478405,145.154444776,8,6,2,1
cobr,1737.41134065,90.7647238975,22,14,8,3
janitor,1735.76348141,77.3914917471,39,27,12,5
handsometom,1733.30861832,92.4373039913,22,14,8,3
hero pie,1731.20994763,109.203835586,17,11,6,2
bonobono,1726.70743493,144.574576229,7,5,2,1
nacl,1725.77960761,89.4667102406,25,16,9,4
sotoh,1721.13692294,86.3461764203,32,20,12,5
kort,1720.69478629,111.881774572,17,11,6,2
janco,1719.58237243,123.427304886,13,8,5,2
dark gentleman,1718.59374302,133.739475906,11,7,4,2
nothing,1718.22928798,103.077855026,21,15,6,3
ken,1715.77627939,203.119436903,3,2,1,1
pugs,1715.01522827,89.654145354,20,13,7,3
shears,1714.99629168,64.28895783,80,53,27,11
zero,1714.20407703,91.2657661385,27,17,10,4
near,1712.67877469,129.086714036,10,7,3,1
finio,1712.31023663,157.985111099,7,5,2,1
kyle tree,1704.83031062,96.0602793072,21,13,8,3
wookiee,1702.68186008,83.1472590586,33,22,11,5
kimimaru,1701.55689492,96.1821302099,24,16,8,3
facechew,1699.3193371,163.929403172,7,5,2,1
banze,1697.89151596,113.15642126,16,11,5,2
nintendude,1697.0615302,75.3043181301,42,26,16,6
robert,1696.61069545,96.7069798343,22,15,7,3
loto,1691.1432063,120.943918216,12,8,4,2
fumbles,1689.14414511,141.864387412,8,5,3,1
a$,1685.29805196,167.219016955,6,4,2,1
battlecow,1685.28578119,135.075273329,8,5,3,1
jason,1682.41186519,89.4124972813,28,19,9,4
shalaka,1681.55076807,117.895155487,16,10,6,3
star king,1681.00077028,154.03407511,7,4,3,1
spongy,1680.94464829,117.389718744,13,9,4,1
hipstur,1680.45574995,84.3047019617,35,24,11,6
smash jesus,1680.2424137,104.915108998,20,14,6,3
sheermadness,1679.41445743,125.541714185,11,7,4,2
nta,1679.30676957,155.110046041,7,4,3,1
box765,1679.1795837,138.406571396,9,6,3,1
inukem,1678.9936681,140.903167626,7,5,2,1
stonefallow,1677.89642688,139.735002016,11,7,4,2
tonester,1677.25429436,114.885954047,17,11,6,3
andykins,1676.6941115,133.039371736,8,5,3,1
amida,1674.81167695,102.817030888,20,13,7,3
poobearninja,1670.23087474,132.163000167,13,9,4,2
jay-r,1669.30795467,172.572251236,7,5,2,1
collin,1667.87445721,161.194832716,5,3,2,1
connor,1660.27083426,102.50951378,19,12,7,3
fishaman p,1659.73479227,109.818913299,15,9,6,2
nickelbackstreetboy,1659.61460322,156.353378117,6,4,2,1
ybombb,1654.44040011,127.368864291,14,9,5,2
jay_mute$,1653.80218203,112.256003264,14,9,5,2
automatic,1652.4898958,154.325164422,6,4,2,1
josephzander,1650.3417574,129.99963892,9,6,3,1
gildo,1649.69851447,108.349352761,18,12,6,2
yobolight,1647.16576172,106.957413268,19,12,7,3
lord narwhal,1647.0559715,96.1317526596,23,14,9,3
dajjal,1645.90005141,93.5534942799,24,15,9,3
the american patriot,1645.56483791,179.09196903,6,4,2,1
ctg,1645.49043738,85.2634244285,32,18,14,6
nattybroh,1644.0840776,118.863965034,13,9,4,1
logic,1643.16571597,132.670310186,11,7,4,2
v,1640.86359075,160.887844269,6,4,2,1
spark,1640.27872065,126.079125272,11,7,4,2
kraines,1638.60700335,198.796968875,4,3,1,1
the big d,1638.31033548,177.412261629,6,4,2,1
darkhorse,1638.01584872,81.4645165003,36,21,15,6
hotline,1637.32593147,168.338970284,6,4,2,1
kaz,1636.66758961,116.959604403,13,8,5,2
piratetrips,1634.35950755,114.089018157,12,8,4,1
eg,1633.63849244,92.2869997094,22,14,8,3
esid,1633.42250722,150.642670464,9,6,3,1
subtle,1630.87121898,118.449529749,15,8,7,3
dam_tewton,1630.34326787,190.574318007,4,2,2,1
freean,1628.48431496,93.7187486514,27,17,10,4
sextc,1627.57075506,152.351119842,8,5,3,1
mokkori,1626.6347393,182.632308241,6,4,2,1
sunnyb,1624.27956609,142.305908316,8,5,3,1
socrates,1622.5832294,181.776416093,5,3,2,1
butt solo,1620.65656896,167.210049103,6,3,3,1
b0n,1620.14786597,170.551328145,6,4,2,1
rossi,1617.706257,175.907808936,5,3,2,1
clubbadubba,1617.66899376,114.878317846,15,9,6,2
greginator,1614.68403137,179.78070529,5,3,2,1
b link,1614.27935923,150.565355727,7,4,3,1
bowl,1613.64150942,128.413789253,13,8,5,2
kyle,1613.16758913,181.601403272,5,3,2,1
letsgo,1612.73265973,126.598102075,12,6,6,2
snorlax,1612.09331573,106.461016573,20,12,8,3
preston,1611.66907255,97.3684133129,23,14,9,4
olbus,1610.87324496,157.973844521,6,4,2,1
saltsizzle,1610.1766032,97.7738536139,18,10,8,3
quickcav,1609.30298426,145.114210195,9,6,3,1
onski,1609.26093714,87.1278763866,31,18,13,5
1000,1609.18692098,189.221952712,5,3,2,1
jxc,1608.60034052,169.691405051,6,4,2,1
quitrage,1608.07675958,142.821687738,9,5,4,2
ivor,1608.0086602,172.978122015,5,3,2,1
a to tr3gthez,1607.87020724,95.7755881157,21,11,10,3
jimmy joe,1607.49481339,77.9817074864,37,21,16,6
monte,1607.34582104,147.817535783,7,4,3,1
komotonoto,1606.98718769,137.814833621,9,5,4,1
madrush21,1606.11901139,71.568942471,49,27,22,8
natendo,1605.96564751,170.389927779,6,4,2,1
sedda,1604.70331931,133.470812916,11,7,4,2
greeno,1604.16209655,101.112447604,21,13,8,3
masterhandjob,1603.81718482,94.058154825,26,15,11,4
dogg,1603.39563893,110.232015271,14,8,6,2
mr.sir,1603.09214532,76.4074734611,44,25,19,8
heny935,1602.62870545,164.965832939,6,4,2,1
duffman,1602.09904053,174.368180612,5,3,2,1
freddy cougar,1601.06859103,190.88727716,5,3,2,1
the dark gentleman,1600.60106475,158.550027958,7,4,3,1
d35,1600.27011626,81.3994779798,34,20,14,5
supa,1599.45661256,113.131708481,15,8,7,3
eggmode,1599.38448707,93.7537404377,25,14,11,4
shihman,1597.8005966,83.9846657964,34,21,13,5
umbra,1596.50943528,142.167931845,10,6,4,2
cody,1595.09525606,196.313755666,5,3,2,1
broly,1594.47703867,189.446959174,5,3,2,1
bard,1594.4472394,85.1054948962,30,18,12,6
xyk,1594.2372595,135.195533157,10,6,4,2
the protagonist,1593.37361577,105.218928819,19,10,9,3
sax,1592.72929707,144.181788786,8,5,3,1
tafokints,1591.8996249,216.923455552,3,2,1,1
a la carte,1591.82421397,151.583963389,9,5,4,2
tyhiggz,1591.52097998,89.3881046943,23,13,10,4
cyoonit,1591.38535166,147.661669726,7,4,3,1
mustard tiger,1591.05115801,143.7672627,10,6,4,2
kirbstomper,1590.72162031,142.005065816,9,5,4,2
dpb,1589.76072277,189.341002845,5,3,2,1
satan [turner],1588.9363881,157.007331524,7,4,3,1
chuck lubs,1588.83820748,188.109119643,5,3,2,1
studstill,1588.60372759,142.740548609,11,7,4,2
llcstoism,1587.79374197,84.6973332905,26,14,12,4
shanks,1586.11450375,133.707587118,12,7,5,2
limesoda,1586.10712094,108.651595014,16,9,7,3
gravyfingers,1583.62932869,149.028142044,7,4,3,1
my buddy mike,1583.46990319,205.575568275,4,2,2,1
scoback,1582.74465554,102.885200927,18,9,9,3
fudgeball,1581.43679151,159.69610115,5,3,2,1
se√±orhen10r,1580.93177383,120.362634925,12,7,5,2
iheartqueso,1579.65697717,151.470837839,9,5,4,2
mr. slimey,1579.58792934,198.084704323,4,2,2,1
superderekfan,1579.1251077,173.952647946,5,3,2,1
knitephox,1578.72752039,118.523241051,17,10,7,3
moogle,1578.69539633,187.339206223,5,3,2,1
smurf,1577.59327534,86.5574479586,34,20,14,6
zuko,1576.62989096,102.981810945,23,12,11,4
elated,1576.39357416,137.522564594,10,6,4,1
b.i.,1575.89269955,134.778325452,11,7,4,1
dogs_johnson,1575.5963214,101.73414924,20,11,9,4
bamster,1574.99338833,140.627102676,9,5,4,2
elel,1574.77251965,147.729597476,10,6,4,2
skyfire,1574.38440114,185.461136741,5,3,2,1
zyrg,1574.19886086,142.76010842,10,6,4,1
no~m,1574.01605654,187.67573768,5,3,2,1
blaise,1572.10991729,194.731533917,5,3,2,1
autobaun,1572.10991729,194.731533917,5,3,2,1
toronto joe,1572.10991729,194.731533917,5,3,2,1
sebula4,1572.10991729,193.998377059,5,3,2,1
kingkool,1572.10991729,194.731533917,5,3,2,1
vudujin,1572.10991729,194.731533917,5,3,2,1
dragoniota,1572.10991729,194.975306902,5,3,2,2
nattyb,1572.10991729,194.731533917,5,3,2,1
shyboy,1572.10991729,194.731533917,5,3,2,1
king lumsy,1572.10991729,194.487455384,5,3,2,1
ern,1572.10991729,194.731533917,5,3,2,1
xor,1572.10991729,194.731533917,5,3,2,1
tvdonk,1572.10991729,194.731533917,5,3,2,1
zergos,1572.10991729,194.291971789,5,3,2,1
sheick,1572.10991729,194.731533917,5,3,2,1
toro,1572.10991729,194.243070151,5,3,2,1
t0mmii,1572.10991729,194.731533917,5,3,2,1
p21/c,1569.89883062,112.597939768,18,10,8,3
gt,1568.64391487,77.7070830439,32,18,14,5
dubs,1567.77616588,138.301202694,12,7,5,2
g0d,1567.77369899,191.242573026,4,2,2,1
travkid,1567.62585661,222.054951051,2,1,1,1
daniel,1567.54093582,111.927040578,19,11,8,3
pathall,1567.28804249,196.014668548,4,2,2,1
touque,1567.26948004,178.17548071,5,3,2,1
rgood,1567.1892753,186.638960362,5,3,2,1
coin chaser,1566.80634848,186.350242136,5,3,2,1
dizzle,1566.5111977,145.675451584,9,5,4,2
handles,1563.59539527,115.333415071,15,9,6,2
dr. lampy,1563.41505141,187.265133794,5,3,2,1
nesskhalifa,1563.02871947,154.901183174,9,5,4,2
killahertz,1562.57993192,127.343789434,13,7,6,3
b33f,1561.8526044,100.563128085,19,11,8,3
fancy,1560.64369567,184.033511648,5,3,2,1
bread,1560.63417857,119.158873189,14,8,6,2
giraphe,1559.79773079,182.143871767,5,3,2,1
gaijilla,1559.32347324,206.208082329,4,2,2,1
starchild,1559.01149625,121.175846098,15,9,6,3
dr. grin,1558.86211508,159.543005307,8,4,4,2
tot,1558.4585112,130.321319326,13,7,6,2
rusty,1558.38848653,104.543794846,17,9,8,3
ditto,1557.82177907,211.22563739,4,2,2,1
wazzberry,1557.43947197,185.878530446,5,3,2,1
waxy:joe,1556.70848495,138.882843394,10,6,4,1
rith,1556.43598489,172.572251236,7,4,3,1
pete,1556.43598489,172.572251236,7,4,3,1
the yid,1556.41871417,210.70133079,4,2,2,1
annex,1556.13104393,102.252175274,21,12,9,3
notlightningrunner,1554.97095163,185.815794454,5,3,2,1
dfx,1554.41983221,109.958022008,18,10,8,4
stonehaus,1554.14116805,184.940058198,5,3,2,1
thrillhouse,1554.09654997,132.844327394,9,5,4,1
blondekid,1549.79108932,123.908430339,12,6,6,3
pewpewu,1548.49833418,145.775213515,9,5,4,2
commander,1547.41094978,183.057697586,5,3,2,1
pluto,1547.24087673,195.353113483,4,2,2,1
zbl_mystic,1546.34917274,171.445111113,5,3,2,1
vanillarin,1546.27234155,157.432017817,9,5,4,2
purtle,1545.93816807,163.816619695,6,3,3,1
yunque,1544.48950742,134.748914482,11,6,5,2
pochilin,1542.73675285,207.97236989,4,2,2,1
darkneon,1542.16369615,178.288144709,5,3,2,1
tbq,1541.98859366,150.02113251,9,5,4,1
taiko,1541.92633883,120.587897569,18,8,10,4
nasian,1539.55575999,184.041039731,4,2,2,1
dixoncider,1536.23823217,176.024794526,5,3,2,1
korobeniki,1536.11030849,122.980380315,15,7,8,3
boomalready1,1536.0757905,143.220961133,9,5,4,1
t brett,1535.42648184,152.228130157,9,5,4,2
tipc,1533.8689839,199.446215429,4,2,2,1
professor_wizard,1533.79993415,106.43462339,16,9,7,2
hydra,1533.5352319,148.49308943,7,4,3,1
cwic-beam,1533.38685949,158.732213776,8,4,4,2
supernuggit,1532.93181077,177.563004956,5,3,2,1
whitejesus,1532.64724957,116.946085917,14,6,8,2
fck vwls,1532.05485027,118.623270015,16,8,8,3
luka,1531.96766465,203.777271664,4,2,2,1
jamjar,1531.76244049,94.2034478364,24,13,11,5
th3kuzinator,1531.54067703,127.271892305,12,6,6,2
sandman,1529.6048996,180.091185696,5,3,2,1
vanddar,1527.06481915,198.350799936,4,2,2,1
dusttin,1526.89939761,110.094140464,18,9,9,4
justin,1525.61049628,175.559733095,5,3,2,1
pizza jokes,1524.47640843,157.454286468,6,3,3,1
shishkabobs5,1524.08105204,195.988774797,4,2,2,1
cmull,1523.51659797,139.051383132,8,4,4,1
bon,1523.48144033,115.20777099,15,7,8,3
captain fabulous,1523.2887156,113.922776269,16,8,8,3
kabal,1523.25241065,152.039399645,7,4,3,1
bunz,1522.5506471,202.443836219,4,2,2,1
box,1522.29340833,193.368273705,4,2,2,1
mr.watchandlearn,1522.24881677,202.032796488,4,2,2,1
grahamaglam,1519.38901056,111.057773707,14,6,8,3
horbie,1519.26175279,160.370712555,6,3,3,1
hypa,1518.78967376,191.501750335,4,2,2,1
fil,1518.31807327,182.98036334,6,3,3,2
velocity jones,1517.06302248,175.121285497,4,2,2,1
drewgong,1516.70068369,131.898916533,14,6,8,4
spaghetti,1514.3495117,181.226143417,5,2,3,1
greenblob,1513.90162142,172.67823171,5,3,2,1
daniels,1513.79712635,93.9919806321,27,13,14,6
jsmirk,1513.600926,108.741066349,17,8,9,3
cyan can,1513.30492218,200.669269037,4,2,2,1
kaladin,1511.42393302,193.388084977,4,2,2,1
kaddy,1511.07538074,239.35427267,2,1,1,1
synth,1511.02635095,174.840956504,4,2,2,1
shake,1510.85494991,199.463234004,4,2,2,1
stevie g$üëåüëåüëåüëåüëåüëåüëåüëå,1509.91324491,203.44472891,4,2,2,1
duncs,1509.03280316,103.547440809,21,11,10,4
captain l,1508.43278735,113.234003883,17,8,9,3
kd3,1507.78033368,200.754709426,4,2,2,1
pizza,1505.53419335,96.6492003446,26,13,13,6
dankpank,1504.55608511,106.321545414,17,8,9,3
barron,1503.73822577,203.464071992,4,2,2,1
sonicfuzz,1502.04869022,112.236632964,17,9,8,3
rocket,1501.75474647,119.739037181,11,5,6,2
reptar,1501.74737372,155.381923599,8,4,4,2
savior,1501.40438739,200.291170176,4,2,2,1
cuppajoe,1500.76115734,199.348330842,4,2,2,1
deathcpo,1500.65001257,103.667991011,18,9,9,3
purple fox,1500.22842496,187.162256305,4,2,2,1
weedwack,1500.0,209.663360564,4,2,2,1
beguiler,1500.0,209.118924928,4,2,2,1
rawdog,1500.0,181.79812984,6,3,3,1
moist,1500.0,209.436684378,4,2,2,1
ravioli,1500.0,209.20976259,4,2,2,1
h2o,1500.0,209.255166634,4,2,2,1
qtip,1500.0,253.907619787,2,1,1,1
snowstorm,1500.0,209.663360564,4,2,2,1
salt,1500.0,209.255166634,4,2,2,1
swiftbass,1500.0,209.663360564,4,2,2,1
pizzajokes,1500.0,209.663360564,4,2,2,1
qubit,1500.0,209.663360564,4,2,2,1
hamburglar,1500.0,208.982594402,4,2,2,1
leavescat,1500.0,163.108491562,8,4,4,1
klms,1500.0,209.663360564,4,2,2,1
mrpoo,1500.0,209.20976259,4,2,2,1
poptartplug,1500.0,208.982594402,4,2,2,1
mickeyrat,1500.0,253.345770413,2,1,1,1
imdabes,1500.0,209.663360564,4,2,2,1
tauvalian,1500.0,209.436684378,4,2,2,1
clefairy as mew,1500.0,208.982594402,4,2,2,1
jaquarium,1500.0,209.436684378,4,2,2,1
dwreck,1500.0,209.663360564,4,2,2,1
nuro,1500.0,181.79812984,6,3,3,1
dezno,1500.0,253.832778391,2,1,1,1
rythemretrn,1500.0,209.255166634,4,2,2,1
blueman,1500.0,209.255166634,4,2,2,1
kman,1500.0,209.118924928,4,2,2,1
mr. biz,1500.0,209.663360564,4,2,2,1
nich,1500.0,208.982594402,4,2,2,1
karlthemarx,1500.0,209.436684378,4,2,2,1
funkykong,1500.0,208.982594402,4,2,2,1
han,1500.0,209.663360564,4,2,2,1
hoofydough,1500.0,209.663360564,4,2,2,1
morino,1500.0,182.632308241,6,3,3,1
tetsu0,1500.0,209.663360564,4,2,2,1
steamfriedasian,1500.0,209.663360564,4,2,2,1
collin the conqueror,1500.0,209.663360564,4,2,2,1
wincancel,1500.0,209.255166634,4,2,2,1
the amazing busterino,1500.0,209.663360564,4,2,2,1
geekliftus,1500.0,209.663360564,4,2,2,1
adrian,1500.0,209.255166634,4,2,2,1
satch,1500.0,208.937131126,4,2,2,1
therapture_,1500.0,209.663360564,4,2,2,1
mahie,1500,350,0,0,0,1
ibc,1499.96787681,155.046307074,8,4,4,2
hariballz,1499.08576972,155.17416262,8,4,4,1
k-nut,1498.86896074,155.287566446,7,4,3,1
sunflower,1498.62230975,129.61373331,13,6,7,3
aces,1497.2960445,114.402145807,20,8,12,5
brny,1497.24662392,186.43463262,4,2,2,1
lookalike,1496.89817111,160.248349717,8,4,4,2
hoofy,1496.60226686,135.820971012,11,5,6,3
razz,1496.48306306,129.125422651,12,6,6,2
breakthrough,1496.11487725,199.998241092,4,2,2,1
rizner,1494.80547249,102.667743175,23,12,11,5
spamus,1494.5502653,190.654150254,4,2,2,1
tootmoses,1494.44057704,192.388746989,4,2,2,1
batterybird,1492.49363412,173.987721624,6,3,3,2
hunter,1491.98376257,199.804670623,4,2,2,1
paco,1491.71862066,103.620680212,18,9,9,3
weirdy man,1491.19257331,199.998699884,4,2,2,1
bflakes,1490.82744599,183.976132374,4,2,2,1
maze,1490.68448786,135.426196521,9,4,5,2
neth,1490.42168474,198.578310065,4,2,2,1
prism,1490.29062928,246.56903808,3,1,2,1
sinbad,1489.5488855,196.742984418,4,2,2,1
droc,1489.16263168,193.946849852,4,2,2,1
moosh_da_moosh,1488.31179879,195.742836765,4,2,2,1
sun vulcan,1488.07039441,145.971975611,8,4,4,1
bringdaruckus312,1487.86391711,191.068842887,4,2,2,1
hhhhhhhhhhhhhhh,1487.21641669,197.694068074,4,2,2,1
lldl,1486.95102744,203.711213547,4,2,2,1
reno,1486.0626876,188.23220811,4,2,2,1
spunker,1485.72078841,208.206185017,3,1,2,1
bre,1485.5000704,185.411672963,4,2,2,1
jungle,1484.85521545,194.248997391,4,2,2,1
ace,1484.72680142,179.05095847,4,2,2,1
meerkat,1482.94715377,101.958739533,19,9,10,3
reese,1482.62276963,193.7098164,4,2,2,1
bigbeaver,1482.09579352,87.4925515118,28,13,15,4
enneielle,1481.66779105,162.838230654,6,3,3,1
keagsbsmashin,1481.05883983,200.561061709,4,2,2,1
moonshoe,1480.84556304,128.675190019,12,6,6,3
t-beau,1478.18580619,205.770070357,4,2,2,1
mixxedvegetables,1477.70043163,198.940758483,4,2,2,1
j9d2,1477.6825336,179.468934729,4,2,2,1
marlwolfe,1477.25311504,170.694222831,6,3,3,1
leaf fc,1476.74744026,163.344112178,7,3,4,2
village mascot,1476.50001943,107.083011307,20,9,11,4
engdrew,1474.81715665,193.247040533,4,2,2,1
kelvinheit,1473.73069139,134.45482894,9,4,5,1
david barker,1471.47053851,213.985600901,3,1,2,1
ngwn,1471.34896512,234.192995806,3,1,2,1
eggmcmuffin888,1470.84451378,155.192769966,8,4,4,2
fanboy,1470.15233621,233.417074169,3,1,2,1
capos,1470.00928181,96.799486867,20,10,10,4
nathansandwich,1469.92038107,174.768616039,7,3,4,2
aisengobay,1469.75446919,185.322408909,4,2,2,1
q!,1469.53673229,94.8740663277,24,11,13,5
jazzy jinx,1467.50984052,189.244664528,4,2,2,1
billbacon420,1465.057046,230.973921286,3,1,2,1
cortese187,1464.75028036,199.150431212,4,2,2,1
blue bear,1464.72165935,208.777043037,4,2,2,1
scratch,1463.79894003,120.315354437,13,5,8,2
hotsauce,1463.79509766,230.652298424,3,1,2,1
fingerblast,1463.52090056,178.378023766,6,3,3,1
derstuk,1463.27293444,155.054957208,10,4,6,3
miniohh!,1462.89072694,188.363154846,4,2,2,1
wowzers,1461.93427962,200.235602328,4,2,2,1
beans,1461.75773074,108.395638805,16,7,9,2
dankey kang,1460.52752793,216.630734973,3,1,2,1
butcher of bakersfield,1460.51268304,146.435433235,9,4,5,1
muse,1460.47186699,196.593496769,4,2,2,1
mistertizye,1460.46033204,204.332237494,3,1,2,1
rebel scum,1458.48159606,133.72797696,9,4,5,1
sebastian,1458.09512991,227.694089066,3,1,2,1
stark,1458.0012749,188.447766856,4,2,2,1
duff man,1457.51466121,177.970154666,5,2,3,1
frogman [charette],1457.44249243,227.35268284,3,1,2,1
cagt,1457.30794928,126.413783666,13,6,7,3
yrn,1456.14938741,156.829552359,7,3,4,2
goosewithsocks,1456.04823675,153.535787609,6,2,4,1
probers,1456.00741221,193.318266519,4,2,2,1
nuggzy,1455.96356686,200.194329709,4,2,2,1
kevine,1455.8718908,225.767680405,3,1,2,1
the (.)(.),1454.09982457,164.338416454,6,3,3,1
luigikid,1453.80517905,188.925641778,4,2,2,1
kristoff,1452.93249853,121.949340976,14,6,8,3
nalgas,1452.77893905,163.830019431,6,3,3,1
ringedge,1452.56590536,194.377435482,4,2,2,1
prime,1451.90325159,120.322816844,19,7,12,4
brown_omega253,1450.81248061,222.091127882,3,1,2,1
dankestdad,1450.24314403,152.49355913,8,4,4,2
dance!!,1450.17230155,193.724834377,4,2,2,1
bhol,1448.65323032,147.077343664,7,3,4,1
smashg0d,1448.52473071,214.486306613,3,1,2,1
jinjo,1447.54287148,206.797291997,3,1,2,1
jlo,1446.52789991,166.799794127,6,3,3,1
slartibartfast42,1443.76588304,174.009692207,7,3,4,2
yass2queen,1443.71658896,220.681219258,3,1,2,1
masquerade,1443.70641538,221.286939103,3,1,2,1
lalo,1443.56401511,171.689201456,7,3,4,1
bodacious,1443.48097723,172.697139402,7,3,4,2
frostbyte,1442.5048209,162.070868041,7,3,4,2
qapples,1441.78657306,220.509259914,3,1,2,1
crazyk115,1441.6130996,182.506933041,5,2,3,1
meatbeef,1441.55120006,219.254302681,3,1,2,1
antwon420,1441.17487538,217.96313939,3,1,2,1
thissidedown,1441.07322392,222.414701537,3,1,2,1
z-rex,1441.07322392,222.201033886,3,1,2,1
v-bomber,1440.29099204,160.178951214,7,3,4,2
ham,1440.16527338,147.908898504,12,4,8,4
chicken,1440.14784765,119.242753898,14,6,8,2
howdy,1440.00693734,179.670236433,6,2,4,2
tank,1439.54401546,173.72563777,5,2,3,1
zhu,1439.25187479,206.113279653,3,1,2,1
static,1437.93904076,197.162918477,4,2,2,1
mando,1437.60775005,138.537870502,10,4,6,2
gaggleforce,1437.38798073,203.760316714,3,1,2,1
ego,1436.18492272,218.578503916,3,1,2,1
izoo,1436.05159325,219.143634916,3,1,2,1
arctic,1435.49649116,218.617291277,3,1,2,1
pika,1435.30651143,221.050278443,3,1,2,1
midgetto,1434.60852101,162.97128467,7,3,4,2
natty,1433.89312725,189.825967625,4,2,2,1
macintosh,1433.28848555,177.829721898,5,2,3,1
kriskringle,1432.13062953,188.709212916,4,2,2,1
boogie!,1430.87783557,154.038554585,8,3,5,1
little bill,1429.52702546,206.487398893,3,1,2,1
gamer4life,1429.40085761,188.297310293,4,2,2,1
yolochi,1428.62849169,216.01030518,3,1,2,1
pintoa,1428.18246869,144.127555332,8,3,5,1
white,1427.89008271,194.291971789,5,2,3,1
thenuge,1426.6577208,146.346133407,8,3,5,1
daddy's milk,1425.96640822,155.092309,9,4,5,2
jam,1424.10390955,178.120573208,5,2,3,1
vidya_james,1423.64410837,215.772766484,3,1,2,1
cormander,1423.32853064,126.37951241,11,4,7,2
zenaga,1421.10805245,216.761536882,3,1,2,1
maniac379,1420.58882118,103.175990214,18,7,11,3
hungrybox,1420.49719453,193.281844575,6,2,4,3
nigel_thornberry,1420.31341284,213.756284627,3,1,2,1
tubby!,1419.62917476,229.045802507,3,1,2,1
jollie,1419.2115243,124.078524575,12,5,7,2
bacorn,1419.07906858,98.4962092234,23,10,13,6
maliki,1418.81636273,169.692416018,7,3,4,2
cbones,1418.61184812,215.571650919,3,1,2,1
waldo,1418.58320204,164.409485215,5,2,3,1
soulbroker,1418.17198117,206.825539816,3,1,2,1
sombrero,1418.10705796,198.714918583,3,1,2,1
lucky_hamburger,1417.58120018,211.663027857,3,1,2,1
apparition the ambassador,1417.19669876,103.889961767,21,8,13,4
brotherly,1417.12425796,206.888341714,3,1,2,1
shyguyking,1415.61285593,159.634805335,8,3,5,1
cane ut,1415.25489803,226.714083091,3,1,2,1
k,1414.20840953,198.473890061,3,1,2,1
ondas,1413.98257735,145.372989973,8,3,5,1
-philip coast philip-,1413.15627664,212.432820875,3,1,2,1
stew,1413.10032299,134.421133872,9,4,5,1
maaron,1412.16026165,214.814196087,3,1,2,1
ardent rage,1412.14026598,215.561528818,3,1,2,1
zibba,1412.14026598,215.120367949,3,1,2,1
swankeaboo,1408.97170446,213.409631096,3,1,2,1
paco [larkin],1407.57233867,213.461613899,3,1,2,1
robnu,1406.80855726,161.701681537,6,2,4,1
monkey,1406.55741307,202.789662438,3,1,2,1
elitescoringguy,1406.33314169,150.770492313,8,3,5,1
bottle opener guy,1406.17115671,155.50357055,8,4,4,2
littlespoon,1405.50177134,216.155757186,3,1,2,1
jmabate,1405.50177134,216.814001773,3,1,2,1
gera,1405.20288962,205.878712306,3,1,2,1
hiv+,1404.53355079,210.241885232,3,1,2,1
maps,1403.92929778,123.147980939,12,4,8,2
ir,1402.31092179,211.255286088,3,1,2,1
sd master,1401.72895679,210.18621551,3,1,2,1
moze,1401.31155614,194.766266349,3,1,2,1
mulkster,1401.03336195,220.457627025,3,1,2,1
mr_sharpie93,1401.03336195,220.026283234,3,1,2,1
big d [hamiel],1400.87815102,211.17116061,3,1,2,1
precookedbread,1400.65260968,214.828271869,3,1,2,1
evals,1400.65260968,214.651313516,3,1,2,1
hsf,1400.65260968,214.385602115,3,1,2,1
cooljoe,1400.65260968,214.385602115,3,1,2,1
xiivi,1400.17381886,143.505115873,12,5,7,4
fawnco,1400.16218631,228.733389073,3,1,2,1
capsui,1400.16218631,228.109542274,3,1,2,1
burnt out ninja,1400.16218631,228.733389073,3,1,2,1
jirachinick,1400.16218631,228.733389073,3,1,2,1
15(ichigo),1400.16218631,228.317680605,3,1,2,1
flatline,1400.16218631,228.317680605,3,1,2,1
drlight,1400.16218631,228.733389073,3,1,2,1
hayrow,1400.16218631,228.109542274,3,1,2,1
pastor,1400.16218631,228.733389073,3,1,2,1
krutchby,1400.16218631,228.109542274,3,1,2,1
java boy,1400.16218631,227.734413905,3,1,2,1
k-man,1400.16218631,228.733389073,3,1,2,1
esuma,1400.16218631,228.733389073,3,1,2,1
castaway,1400.16218631,228.109542274,3,1,2,1
pokeiman_master,1400.16218631,228.109542274,3,1,2,1
flare,1400.16218631,228.109542274,3,1,2,1
giraffe,1400.16218631,228.733389073,3,1,2,1
kossismoss,1400.16218631,228.733389073,3,1,2,1
mourin,1400.16218631,228.359285506,3,1,2,1
leet,1400.16218631,228.067891814,3,1,2,1
sadu,1400.16218631,228.109542274,3,1,2,1
firefly,1400.16218631,228.733389073,3,1,2,1
hotpocket,1400.16218631,228.109542274,3,1,2,1
birdlordmasterbeak,1400.16218631,228.109542274,3,1,2,1
napkins,1400.16218631,228.109542274,3,1,2,1
zombie!,1400.16218631,228.733389073,3,1,2,1
dhir,1400.16218631,228.733389073,3,1,2,1
kavon,1400.16218631,227.734413905,3,1,2,1
whoopiecow,1400.16218631,228.359285506,3,1,2,1
cardoso,1400.16218631,228.359285506,3,1,2,1
kzidek,1400.16218631,228.317680605,3,1,2,1
chaos pro,1400.16218631,228.733389073,3,1,2,1
yakal,1400.16218631,228.733389073,3,1,2,1
changed man,1400.16218631,228.109542274,3,1,2,1
evab,1400.16218631,228.109542274,3,1,2,1
zwephy,1400.16218631,228.733389073,3,1,2,1
dad's musical erasers,1400.16218631,227.692694825,3,1,2,1
anathema,1400.16218631,228.733389073,3,1,2,1
shasta,1400.16218631,228.733389073,3,1,2,1
maestro,1400.16218631,228.067891814,3,1,2,1
andy,1400.16218631,228.317680605,3,1,2,1
snazzy,1400.16218631,228.109542274,3,1,2,1
nyx,1400.16218631,228.317680605,3,1,2,1
blahguy,1400.16218631,228.317680605,3,1,2,1
spt,1400.16218631,228.109542274,3,1,2,1
r.o.m.,1400.16218631,228.733389073,3,1,2,1
schlag,1400.16218631,228.317680605,3,1,2,1
scruffy mcwonder crumpet,1399.26514264,216.700494047,3,1,2,1
mmneggs,1399.07422238,136.065635046,8,2,6,1
godspeed,1398.77926551,130.919572877,11,4,7,2
tmakk,1397.58061752,124.878409343,13,5,8,3
gato,1396.66763133,214.977190732,3,1,2,1
miken,1396.47551291,269.422638239,1,0,1,1
blackf00t,1396.0553002,169.688162773,6,2,4,1
wal,1395.4225482,218.906996108,3,1,2,1
train_town,1395.27226386,202.077197308,3,1,2,1
chiefreaper,1394.92825753,211.850845916,3,1,2,1
boh,1394.7765604,213.094559329,3,1,2,1
damp,1394.36002994,188.22093032,5,2,3,1
neat,1393.67460744,210.627145922,3,1,2,1
 ô·¥è·¥Ö·¥Ä·¥Ñ…™·¥è·¥ús,1392.27386288,142.281894243,8,2,6,1
gibbles,1391.58865424,194.144190214,3,1,2,1
sunshinetk,1391.06007338,171.105715692,6,2,4,1
hipo,1390.78950118,209.777151258,3,1,2,1
xanz,1390.78950118,209.777151258,3,1,2,1
myroknpancakes,1387.63060583,177.895890611,6,2,4,2
mattatari,1387.53169898,216.904993174,3,1,2,1
pzero39,1387.53169898,216.510452551,3,1,2,1
fearlesscaboos,1387.08061649,229.223241186,3,1,2,1
grrg,1386.80183225,120.189708496,18,6,12,4
superflopp,1385.04942858,198.98440202,3,1,2,1
banana fiend,1384.44620422,203.17408519,3,1,2,1
walkrofsky,1383.32479053,152.323950563,6,2,4,1
darv,1382.57169702,189.780215617,6,2,4,2
throwz?!,1381.07122461,216.736249718,3,1,2,1
slappymcnutz,1379.93845479,208.874924355,3,1,2,1
squible,1377.51185746,162.89820139,7,3,4,1
blisstex,1377.10381768,191.838391281,6,2,4,2
astumpycow,1376.82061196,206.247706872,4,1,3,1
icactusdog,1376.40054874,127.567226228,13,4,9,3
mortech,1376.16682604,132.071488667,11,4,7,2
chai,1374.55035024,269.182071985,1,0,1,1
malkasaur,1373.8889909,266.114637456,1,0,1,1
khakis,1373.11621562,183.358602477,6,2,4,3
iceking,1372.49265091,183.786796907,6,2,4,2
krypto,1372.46024808,184.151289599,6,2,4,2
dirtcruncher,1369.18262027,127.069388189,12,4,8,2
drewskii55,1365.86968286,208.918095286,3,1,2,1
gumbolaya!,1365.40105575,216.550944041,3,1,2,1
trevman,1364.39508973,216.775658065,3,1,2,1
bogmyer,1364.0932158,179.261726552,5,1,4,1
highlyeducational,1356.95489445,218.885015714,3,1,2,1
tokaji,1356.08703056,226.707937112,3,1,2,1
heartsdealer,1355.42521893,176.053057417,6,2,4,2
patty-wagon,1355.41836912,267.670078082,1,0,1,1
dasit mane,1354.60142954,157.485490048,7,2,5,2
mojo,1351.86864414,186.413698215,5,2,3,1
hotspank,1347.80564028,215.747635628,3,1,2,1
kingcool,1344.75357643,141.044848949,9,3,6,1
zad,1344.32727247,130.750952849,10,3,7,2
chinstrap,1343.66207462,175.726424962,6,2,4,2
moustasher,1343.52578424,122.283014426,14,5,9,3
the professor,1342.22692138,147.897246006,10,3,7,2
the drew,1341.44444229,115.578685264,14,4,10,3
myninja,1341.13533333,170.361612154,6,2,4,1
astumpyzombie,1340.32288332,185.849590026,5,1,4,1
yungpurp,1338.22602118,254.763739497,1,0,1,1
branchan,1337.78799739,291.047670779,1,0,1,1
spell,1337.78799739,290.524950161,1,0,1,1
uprowr,1337.78799739,290.55764775,1,0,1,1
masterofzoroark,1337.78799739,291.047670779,1,0,1,1
rice,1337.78799739,291.047670779,1,0,1,1
et,1337.78799739,290.884421491,1,0,1,1
dude,1337.78799739,290.753756065,1,0,1,1
magitech,1337.78799739,290.230506091,1,0,1,1
rf!,1337.78799739,290.753756065,1,0,1,1
i use tap jump,1337.78799739,290.524950161,1,0,1,1
bunmira,1337.78799739,291.047670779,1,0,1,1
bonerstorm,1337.78799739,290.524950161,1,0,1,1
danny,1337.78799739,290.230506091,1,0,1,1
lukem,1337.78799739,290.55764775,1,0,1,1
homemadewaffles,1337.78799739,291.047670779,1,0,1,1
sabo,1337.78799739,290.55764775,1,0,1,1
joshi,1337.78799739,290.230506091,1,0,1,1
4sk,1337.78799739,291.047670779,1,0,1,1
spicky,1337.78799739,290.524950161,1,0,1,1
bronze_sun,1337.78799739,290.655718447,1,0,1,1
dishier wand,1337.78799739,290.55764775,1,0,1,1
caelan,1337.78799739,290.753756065,1,0,1,1
akajumo,1337.78799739,290.263236849,1,0,1,1
flat nat,1337.78799739,290.524950161,1,0,1,1
hans_mawell,1337.78799739,290.655718447,1,0,1,1
adubz,1337.78799739,290.55764775,1,0,1,1
akito555,1337.78799739,291.047670779,1,0,1,1
the cfb,1337.78799739,290.55764775,1,0,1,1
yung,1337.78799739,291.047670779,1,0,1,1
fractal,1337.78799739,290.230506091,1,0,1,1
da_bear,1337.78799739,290.230506091,1,0,1,1
electricgazelle,1337.78799739,290.655718447,1,0,1,1
ragingcherry,1337.78799739,291.047670779,1,0,1,1
refriedjeans,1337.78799739,290.524950161,1,0,1,1
penance,1337.78799739,290.230506091,1,0,1,1
neverpullout,1337.78799739,290.524950161,1,0,1,1
god,1337.78799739,291.047670779,1,0,1,1
beets,1337.63215054,196.360407256,3,1,2,1
weatherman,1337.28406089,179.98525565,5,1,4,1
big d squirrels,1336.28075175,174.175443341,6,2,4,2
mikelangelo,1335.35128945,253.307288994,2,0,2,1
seantos,1334.67804247,123.834344112,14,4,10,3
spaff,1334.18426314,234.707132588,2,0,2,1
maximum can,1332.54668248,227.15593405,2,0,2,1
milleneum,1332.02546646,181.750354841,5,1,4,1
jaws,1330.72071068,214.23997738,3,1,2,1
mr baninawi,1329.5100202,191.53567093,3,1,2,1
iacme,1329.42254718,221.739970239,2,0,2,1
mello,1328.34256432,255.930122478,2,0,2,1
danno,1328.17014511,225.814965352,3,1,2,1
redribb0n,1327.62409232,268.306055931,1,0,1,1
schmerka berl,1326.99287607,150.961408482,11,3,8,3
esmod,1326.74860044,253.642643542,2,0,2,1
redeagle2000,1326.14144296,253.501491445,1,0,1,1
elu,1326.10586597,145.284436475,8,2,6,1
eliot,1325.997482,147.517702729,8,2,6,2
brambramjam,1325.88253541,199.405756577,4,1,3,1
bohemian milk,1325.52397065,227.966982253,3,1,2,1
tdp,1325.52397065,227.966982253,3,1,2,1
rhubarb,1325.34826449,125.533424877,12,4,8,2
yolft,1325.17472819,141.475026825,8,2,6,1
luwolf,1321.89731169,251.606388286,2,0,2,1
jose,1321.85713863,267.469071763,1,0,1,1
general1712,1321.69807631,164.92518374,6,1,5,1
woof,1320.46663096,142.241736948,9,2,7,1
lou sanus,1320.31892377,143.438992476,7,1,6,1
husker,1318.23848358,153.356876363,6,1,5,1
sk,1317.54130678,240.141508981,2,0,2,1
squallette,1317.08876178,255.686946642,1,0,1,1
guccipivotmaster4000,1316.06791925,243.336490671,2,0,2,1
ocelot,1315.88759727,121.766643506,14,4,10,3
turtle,1314.47949325,241.151742743,2,0,2,1
barrels,1312.74935432,130.588652104,11,3,8,2
fry,1309.52453241,208.083292632,5,1,4,2
therm,1308.31026789,242.573957919,2,0,2,1
acestarthe3rd,1306.83665932,253.460207758,1,0,1,1
magnus combosen,1305.67858851,181.616097391,5,1,4,1
mariokartmoney,1303.67100018,205.936452344,5,1,4,2
garv,1302.9334207,166.055132763,5,2,3,2
nagurnimaster,1302.51162622,241.164370115,2,0,2,1
kobra,1301.10892962,205.185719434,5,1,4,2
werewyatt,1299.78209913,161.892017551,6,1,5,1
jad,1297.92304821,236.228338285,2,0,2,1
turtlpower,1296.12052178,238.007831293,2,0,2,1
stdangerous,1294.82594084,232.753226588,2,0,2,1
broonz,1294.62266776,136.840714104,11,3,8,3
gallyg,1294.13045609,239.285075541,2,0,2,1
tallyshell,1293.05452486,203.779047977,4,1,3,1
yaron,1291.42400526,140.478180381,7,1,6,1
dmolz,1289.1960402,146.310870801,7,1,6,1
pidgezero_one,1288.56424199,152.052838594,9,2,7,2
jackmehoff,1288.19280717,227.363707592,2,0,2,1
jedipanda,1288.15074206,154.286679779,6,1,5,1
fig,1287.705046,170.383555264,6,1,5,1
putpasswordhere,1287.43001814,199.928405992,5,1,4,2
silentknight,1287.08534429,169.13983108,8,2,6,3
shug,1286.20834321,152.640636359,8,2,6,3
brendanhall,1284.80077303,274.337750112,1,0,1,1
pilot,1284.80077303,274.441616991,1,0,1,1
mrryanness,1281.99361591,195.831173179,5,1,4,2
depressed eagle,1281.96209659,195.37131524,5,1,4,2
xlax,1281.8360817,195.717501857,5,1,4,2
jgin,1281.23564817,227.062420914,2,0,2,1
nami,1279.84996388,230.895252392,2,0,2,1
fen,1279.32434959,171.105715692,6,1,5,1
twunt,1279.13062508,197.346547353,5,1,4,2
blues,1278.77730457,203.603536594,5,1,4,2
izze,1278.72889613,202.948380071,5,1,4,2
pugdaddyfre$hlyfeogg*flva,1277.70495962,235.34695793,2,0,2,1
quinceprince,1276.924676,238.470368653,2,0,2,1
starcutter,1276.924676,238.31096644,2,0,2,1
magfmur,1276.924676,238.071663004,2,0,2,1
multiball,1273.46888253,141.165690691,11,3,8,2
bus,1270.89511326,231.859837673,2,0,2,1
wolfcry,1270.3226934,236.424373097,2,0,2,1
scootieloo,1270.03702183,233.577233109,2,0,2,1
nokto,1269.38594106,236.172735183,2,0,2,1
austntatious,1269.32500886,231.10744495,2,0,2,1
katiebug (sfk),1268.45066945,227.888024209,2,0,2,1
jesusisking,1265.86848004,227.587260187,2,0,2,1
rabizkoshik,1265.14006072,167.308870405,6,1,5,1
rodan,1263.51305923,227.339219281,2,0,2,1
gambit,1261.10354673,237.638419489,2,0,2,1
albinosaurus,1259.66395661,227.805720367,2,0,2,1
oxycontin,1258.74239877,147.045972064,9,2,7,2
pigwick,1257.04925579,223.638078391,2,0,2,1
tarn,1256.97303003,230.742674872,3,0,3,2
blank,1255.71222022,235.889837256,2,0,2,1
whitegrizzly,1255.71222022,235.123404451,2,0,2,1
tbone,1255.71222022,235.889837256,2,0,2,1
dk dredd,1254.66384488,238.5430096,2,0,2,1
charlie,1253.9871933,235.796985235,2,0,2,1
karl,1253.34254442,216.429087448,3,0,3,1
paper tiger,1252.79674799,254.28149635,2,0,2,1
tydye,1252.79674799,253.907619787,2,0,2,1
irish,1252.79674799,254.28149635,2,0,2,1
abc,1252.79674799,253.383265797,2,0,2,1
kezzup,1252.79674799,253.720474905,2,0,2,1
bean,1252.79674799,254.28149635,2,0,2,1
akiva,1252.79674799,254.28149635,2,0,2,1
cr0ak,1252.79674799,254.28149635,2,0,2,1
kl3an,1252.79674799,254.28149635,2,0,2,1
avian,1252.79674799,253.907619787,2,0,2,1
drill,1252.79674799,253.420755634,2,0,2,1
searcher,1252.79674799,253.832778391,2,0,2,1
jpoptosis,1252.79674799,254.28149635,2,0,2,1
sleeh,1252.79674799,254.28149635,2,0,2,1
drhino,1252.79674799,254.28149635,2,0,2,1
polarbair,1252.79674799,253.945032213,2,0,2,1
hero,1252.79674799,253.945032213,2,0,2,1
thegoat,1252.79674799,253.720474905,2,0,2,1
giggitoxin,1252.79674799,253.720474905,2,0,2,1
charlie harper,1252.79674799,254.094626834,2,0,2,1
erk,1252.79674799,253.383265797,2,0,2,1
sambook,1252.79674799,253.720474905,2,0,2,1
fish,1252.79674799,253.345770413,2,0,2,1
grraffe,1252.79674799,254.28149635,2,0,2,1
dd,1252.79674799,254.28149635,2,0,2,1
tylenol jones,1252.79674799,253.720474905,2,0,2,1
yuxminato,1252.79674799,254.28149635,2,0,2,1
link,1252.79674799,253.683029361,2,0,2,1
jazz,1252.79674799,254.28149635,2,0,2,1
phalanx,1252.79674799,253.720474905,2,0,2,1
zombieheart84,1252.79674799,254.28149635,2,0,2,1
goomah,1252.79674799,253.832778391,2,0,2,1
blizz,1252.79674799,253.945032213,2,0,2,1
ferrero64,1252.79674799,254.28149635,2,0,2,1
sharktoast,1252.79674799,254.28149635,2,0,2,1
youtwo,1252.79674799,253.832778391,2,0,2,1
uncle onion,1252.79674799,253.907619787,2,0,2,1
flash,1252.79674799,253.907619787,2,0,2,1
zurdo,1252.79674799,253.383265797,2,0,2,1
warmachine1919,1252.79674799,253.720474905,2,0,2,1
aperture,1252.79674799,254.28149635,2,0,2,1
master jay,1252.79674799,254.094626834,2,0,2,1
myk,1252.79674799,254.094626834,2,0,2,1
deku,1252.79674799,253.720474905,2,0,2,1
j,1252.79674799,254.28149635,2,0,2,1
lights,1252.79674799,254.094626834,2,0,2,1
nadamoor,1252.79674799,253.345770413,2,0,2,1
theycallmechris,1252.79674799,253.945032213,2,0,2,1
themickeynick,1252.79674799,254.28149635,2,0,2,1
sfat,1252.79674799,253.345770413,2,0,2,1
tuna,1252.79674799,253.945032213,2,0,2,1
yung god,1252.79674799,253.383265797,2,0,2,1
voidstar,1252.79674799,253.383265797,2,0,2,1
oljace,1252.79674799,253.907619787,2,0,2,1
superduperfanofboom,1252.79674799,253.720474905,2,0,2,1
red,1252.79674799,254.28149635,2,0,2,1
draxsel,1252.79674799,254.094626834,2,0,2,1
da bear,1252.79674799,253.495718674,2,0,2,1
armor,1252.79674799,254.28149635,2,0,2,1
atari,1252.79674799,254.28149635,2,0,2,1
scuttlebug jamboree,1252.79674799,253.720474905,2,0,2,1
black rob,1252.79674799,253.720474905,2,0,2,1
kayo,1252.79674799,253.683029361,2,0,2,1
digital cannon,1252.79674799,253.720474905,2,0,2,1
liam_butler,1252.79674799,254.28149635,2,0,2,1
yam$,1252.79674799,254.28149635,2,0,2,1
nikku,1252.79674799,253.720474905,2,0,2,1
urpasmash,1252.79674799,253.945032213,2,0,2,1
zarfon,1252.79674799,254.28149635,2,0,2,1
d-tek,1252.79674799,254.28149635,2,0,2,1
sven stormbeard,1252.79674799,253.945032213,2,0,2,1
alex,1252.79674799,253.683029361,2,0,2,1
benbook,1252.79674799,253.720474905,2,0,2,1
duck chris,1252.79674799,253.945032213,2,0,2,1
jobook,1252.79674799,253.720474905,2,0,2,1
skubtard,1252.79674799,254.28149635,2,0,2,1
waffles,1252.79674799,254.28149635,2,0,2,1
marfslayer 3000,1252.79674799,253.907619787,2,0,2,1
kieuarty,1252.79674799,253.345770413,2,0,2,1
hail_sagan,1252.79674799,253.720474905,2,0,2,1
beekle,1252.79674799,254.28149635,2,0,2,1
sam,1252.79674799,253.683029361,2,0,2,1
lunchy,1252.79674799,254.28149635,2,0,2,1
swerve,1252.79674799,253.683029361,2,0,2,1
sunshine,1252.79674799,253.945032213,2,0,2,1
m2cain,1252.79674799,253.383265797,2,0,2,1
fs mook,1252.79674799,253.683029361,2,0,2,1
sad,1252.79674799,253.720474905,2,0,2,1
ebay,1252.79674799,254.094626834,2,0,2,1
5000candlesinthewind,1252.79674799,254.28149635,2,0,2,1
jfm,1252.79674799,253.683029361,2,0,2,1
matt47,1252.79674799,254.28149635,2,0,2,1
aubfox,1252.79674799,254.28149635,2,0,2,1
juan doe,1252.79674799,253.720474905,2,0,2,1
sunkin,1252.79674799,253.345770413,2,0,2,1
azzy,1252.79674799,254.28149635,2,0,2,1
holosly,1252.79674799,254.094626834,2,0,2,1
instacover,1252.79674799,253.907619787,2,0,2,1
rickter_scale,1252.79674799,254.094626834,2,0,2,1
astropancakes,1252.79674799,254.28149635,2,0,2,1
jojohnson,1252.79674799,253.907619787,2,0,2,1
beaver,1252.79674799,254.094626834,2,0,2,1
hyperbole,1252.79674799,253.720474905,2,0,2,1
monk,1252.79674799,254.28149635,2,0,2,1
bozz,1252.79674799,253.720474905,2,0,2,1
levity,1252.79674799,253.720474905,2,0,2,1
grunyan,1252.79674799,254.28149635,2,0,2,1
edwin...,1252.79674799,254.28149635,2,0,2,1
smashlopez64,1252.79674799,253.945032213,2,0,2,1
4 phri,1252.79674799,253.720474905,2,0,2,1
mr.e [rohr],1252.79674799,253.720474905,2,0,2,1
scott,1252.79674799,253.720474905,2,0,2,1
snack?,1252.79674799,254.094626834,2,0,2,1
muthaluva777,1252.79674799,253.683029361,2,0,2,1
fs shampoomaster,1252.79674799,253.683029361,2,0,2,1
ubll black mage,1252.79674799,253.945032213,2,0,2,1
riseup93,1252.79674799,253.720474905,2,0,2,1
laugh,1252.79674799,253.683029361,2,0,2,1
dr. light,1252.79674799,253.345770413,2,0,2,1
maxi,1252.79674799,254.094626834,2,0,2,1
umi,1252.79674799,253.945032213,2,0,2,1
mechanicalmarine,1252.79674799,253.683029361,2,0,2,1
mookie,1252.79674799,253.383265797,2,0,2,1
raxcity,1252.79674799,254.28149635,2,0,2,1
thac0,1252.79674799,253.720474905,2,0,2,1
colt,1252.79674799,253.945032213,2,0,2,1
meowmix,1252.79674799,253.345770413,2,0,2,1
duckpimp,1252.79674799,254.094626834,2,0,2,1
qk shkz,1252.79674799,253.945032213,2,0,2,1
shadow light master,1252.79674799,254.28149635,2,0,2,1
legoman,1252.79674799,254.094626834,2,0,2,1
bunnyblast,1252.79674799,253.720474905,2,0,2,1
bc_burns,1252.79674799,254.094626834,2,0,2,1
harmless,1252.79674799,254.28149635,2,0,2,1
dennysgrandslambreakfast,1252.79674799,253.683029361,2,0,2,1
minusev,1252.79674799,253.345770413,2,0,2,1
miles,1252.79674799,253.907619787,2,0,2,1
sfgman,1252.79674799,254.28149635,2,0,2,1
scraggus,1252.79674799,253.683029361,2,0,2,1
heisenberg,1252.79674799,254.28149635,2,0,2,1
amaya,1252.79674799,253.720474905,2,0,2,1
ppdmd,1252.79674799,254.094626834,2,0,2,1
uh what,1252.79674799,254.28149635,2,0,2,1
missingn0,1252.35585395,235.090492834,2,0,2,1
nfreak,1249.49724349,256.77008597,2,0,2,2
big tone,1249.26542591,257.659634636,2,0,2,2
kevorkian,1247.50031922,152.650802953,10,2,8,4
frogge,1246.27500262,229.930847033,2,0,2,1
aerodet,1243.34561977,233.292656434,2,0,2,1
scaryman,1238.62194243,159.396349647,7,1,6,1
bear,1234.46300657,192.73028228,5,1,4,2
lonk,1229.00582463,240.779752568,2,0,2,1
curiousplaces,1229.00582463,240.779752568,2,0,2,1
lloyd-black,1228.05963857,133.362288508,10,2,8,2
jame,1225.90941372,243.551899335,2,0,2,1
mike4real,1222.34270831,236.460349063,2,0,2,1
caleb,1222.25679674,240.159734026,2,0,2,1
papa,1221.45002945,187.05725622,4,0,4,1
robslabgod,1219.8533845,225.258502411,2,0,2,1
awesomethesauce,1218.58028363,242.327963946,2,0,2,1
dunos_,1218.58028363,242.719678044,2,0,2,1
pvc,1218.58028363,242.719678044,2,0,2,1
juno,1218.58028363,243.110760992,2,0,2,1
tanuki,1218.58028363,242.327963946,2,0,2,1
jerzilla,1218.48500189,241.838311565,2,0,2,1
louieg,1216.68677083,222.957700798,2,0,2,1
spammalanche,1216.68677083,222.957700798,2,0,2,1
fumofuu,1214.47059913,241.206819308,2,0,2,1
deep dimples,1210.50611479,171.961772477,5,0,5,1
rocktimus crime,1210.48615824,172.226468998,5,0,5,1
recneps,1209.86830049,152.714342314,8,1,7,2
jeremy,1209.85229848,204.602928741,4,0,4,1
rockmix,1209.56452596,234.886293458,2,0,2,1
ohhhbreezy,1208.42361941,159.110724722,7,1,6,1
mikeyg,1207.10695142,222.200397124,2,0,2,1
nnaughtydogg,1207.0119167,160.919988188,6,0,6,1
kohenbro,1205.82351152,181.750354841,5,0,5,1
paul d,1205.41893744,223.031055095,4,0,4,1
jet fuel,1205.41166476,147.892786629,8,1,7,1
sianvar,1201.49536799,244.586596103,2,0,2,1
vondo,1201.47451618,157.023109725,6,0,6,1
russellsprouts,1200.26831047,177.221243119,4,0,4,1
noelkitten,1199.86873077,229.728799684,2,0,2,1
neph_girl,1198.25343134,142.627751609,7,0,7,1
iamlazee,1195.77000735,229.097807211,2,0,2,1
nyani,1194.88428227,233.394371028,3,0,3,2
2%gay,1192.74212163,166.44968355,6,0,6,1
adulix,1190.1171937,181.037755838,5,0,5,1
b vu,1189.53034158,236.30754423,2,0,2,1
mjim,1186.93050349,171.867565369,5,0,5,1
codytappen,1182.394978,224.418627421,2,0,2,1
hashi,1181.85278432,238.756109886,2,0,2,1
ryden hope,1180.39885302,242.691726599,2,0,2,1
kraken,1180.39885302,242.691726599,2,0,2,1
dr gibs,1180.02212929,179.390455459,5,0,5,1
jedisalazar,1175.10708955,192.287249712,4,0,4,2
bagel,1172.4627158,164.403888417,6,0,6,1
jpeghero,1169.95150921,162.572872958,9,1,8,2
failcant,1169.65177662,237.626581518,2,0,2,1
bung0o,1168.90992173,159.84225945,6,0,6,1
elrond,1168.10218124,143.779563202,7,0,7,1
ejmp,1165.56635121,240.417544331,2,0,2,1
bennyboy98,1164.82195562,245.845895574,2,0,2,1
showtime,1161.13730703,247.46489316,2,0,2,1
tweli,1160.87371869,253.351862459,2,0,2,1
thedarkdreamer,1160.87371869,253.351862459,2,0,2,1
bulldog,1160.87371869,253.351862459,2,0,2,1
redwolf,1160.87371869,253.314362426,2,0,2,1
thisisgettingold,1160.87371869,253.351862459,2,0,2,1
foxnard,1160.87371869,252.976611985,2,0,2,1
sweaters,1160.87371869,253.464329268,2,0,2,1
cat,1158.74393027,179.562248964,5,0,5,1
thissideup,1155.17249578,242.174076264,2,0,2,1
ceephax,1155.17249578,242.174076264,2,0,2,1
nardwell,1155.09577673,108.665262051,19,2,17,4
sugaaku,1152.90063324,216.902904633,4,0,4,2
phex,1152.6668976,217.153950691,4,0,4,2
fmax,1152.6668976,217.153950691,4,0,4,2
djltheescapade,1151.90711445,190.757722302,5,0,5,2
falln,1141.82963552,239.106920707,2,0,2,1
dr-wumbo,1141.23098138,230.941212086,2,0,2,1
jonnjonn,1131.41036205,173.022391287,5,0,5,1
jimbot,1129.21436418,155.085397056,7,0,7,1
jackkenney,1128.95003884,233.712931918,2,0,2,1
whiz kid,1127.38976867,201.522325099,4,0,4,2
blanco mano,1120.78651453,168.44398204,6,0,6,1
tehz,1112.86906143,183.427269028,6,0,6,2
shwang,1105.98818033,187.501038404,6,0,6,2
golfclubninja,1063.55492139,182.608078976,8,0,8,3
