player,mu,sigma,wins,losses,sets
armada,53.753887087,1.05906296694,128,15,143
hungrybox,51.6940732574,0.976169995153,172,30,202
mang0,51.6906569981,0.950248529594,143,30,173
mew2king,51.016413052,0.919840042901,136,34,170
leffen,48.8161752563,1.14030124843,72,17,89
sfat,47.7757878856,0.937932624803,120,41,161
wizzrobe,47.722615984,0.985686908141,105,33,138
ice,47.697211986,1.02735006841,116,29,145
plup,47.1552269349,1.09292538682,53,22,75
westballz,46.8487967477,0.962550077464,100,36,136
swedish delight,46.5656601218,1.06261710789,77,27,104
axe,46.5224905691,1.02069963734,70,27,97
shroomed,46.4277223863,1.04419245265,71,26,97
hax,46.0265026406,2.58830229017,8,3,11
lucky,45.8892624982,1.10425987807,59,23,82
chudat,45.790169455,1.33343821098,38,14,52
amsa,45.546011012,2.00529989932,16,4,20
druggedfox,45.4448711792,1.07057614362,72,25,97
pewpewu,45.3524403876,1.09102838718,56,23,79
duck,45.1043816501,1.03884150235,73,28,101
professor pro,45.0425307286,1.05443290023,94,28,122
kirbykaze,44.935849436,1.39906056144,34,13,47
laudandus,44.8972006079,1.4442972451,32,10,42
infinitenumbers,44.7518572115,2.87359107639,7,2,9
s2j,44.7479329096,1.00380391832,86,35,121
n0ne,44.5335714509,1.14246296931,55,24,79
syrox,44.4540176053,1.28917658869,45,15,60
the moon,44.4011199998,1.03850563462,78,34,112
trif,44.321740888,1.48677260872,43,10,53
dizzkidboogie,44.2801256562,1.06787213665,71,24,95
smashg0d,44.2512783748,1.56905795032,28,8,36
kjh,44.0754359423,1.04403060909,74,30,104
mafia,43.9024364201,1.42015191192,29,14,43
colbol,43.7230601447,1.16961369651,61,24,85
mikehaze,43.565019346,1.30158903945,38,17,55
infinite numbers,43.5636334759,2.49719132405,8,4,12
gahtzu,43.5551152825,1.25488394772,39,19,58
zgetto,43.5202605581,1.51320961145,35,11,46
slox,43.5161015996,1.26897538663,45,16,61
chillindude,43.4724421574,1.2223078763,47,19,66
wobbles,43.4177602706,1.18877555339,48,24,72
overtriforce,43.3898449434,1.79122448026,33,6,39
macd,43.3870455195,1.04610938853,76,36,112
silent wolf,43.3558244888,1.54282808604,19,14,33
nintendude,43.2850493045,1.1597592349,44,26,70
kage,43.2597058793,1.73856414489,23,8,31
medz,43.2344013759,2.16706126098,14,4,18
esam,43.1765318659,1.47751563161,33,12,45
hugs,43.1365673994,1.1952417011,46,23,69
abate,43.1305575253,1.6926219576,22,11,33
adamayonmike,43.0028107423,1.78701259667,25,6,31
zhu,42.9820431559,1.29123541157,40,19,59
prince abu,42.8506024665,1.07345614538,65,28,93
fuzzyness,42.8161914333,1.544233458,43,10,53
kalamazhu,42.7229710845,1.85356708547,15,7,22
kels,42.6595540058,1.40095389542,38,12,50
el fuego,42.6415053,2.78621697279,5,3,8
zain,42.6375270031,1.591421046,21,9,30
bladewise,42.631861319,1.54196223203,23,12,35
ginger,42.5851209068,1.50057274077,35,11,46
baxon,42.5651769032,2.17561665136,17,4,21
s0ft,42.561799126,2.4576484488,8,3,11
eddy mexico,42.4716114136,1.93686698682,13,7,20
trulliam,42.4323682394,1.64500817842,27,10,37
vanity angel,42.4189460294,2.15868406549,17,4,21
android,42.2666680329,1.34644923288,51,15,66
beat,42.2273823877,2.98325788567,10,2,12
iceman,42.096663372,1.86345436287,19,7,26
taj,42.057210615,2.17739577806,13,4,17
cdk,42.0128881534,2.1080992417,13,6,19
tai,41.9694116375,1.68737832657,21,10,31
dj nintendo,41.9456432455,1.15384767805,59,24,83
crush,41.9431078096,1.4199004922,27,16,43
darkatma,41.8840878695,1.67102443616,24,12,36
amsah,41.8177611361,1.66366325205,25,10,35
cyrain,41.8159279862,1.73719752327,23,8,31
therealthing,41.789172331,3.13679865046,7,2,9
mrlz,41.7662386864,1.83830158367,26,8,34
calle w,41.7546630087,2.31803838492,18,4,22
llod,41.7414143259,2.18522913673,12,5,17
johnnyfight,41.7360221647,2.18064434219,21,4,25
zealous5000,41.7073817866,2.27252606615,10,4,14
captain faceroll,41.6733526729,1.40348369768,35,14,49
drephen,41.6591458333,1.43993564677,41,14,55
gravy,41.6452288109,2.05290965143,15,6,21
4%,41.6031448669,1.91865866604,20,8,28
vidjogamer,41.6015130319,2.13678017369,13,4,17
coffeeblack,41.5738096746,1.53941794707,31,11,42
ryan ford,41.5641673285,1.50917567668,24,13,37
ib,41.5547256103,2.99190642262,8,2,10
darrell,41.5460891778,1.98449792296,13,7,20
iori,41.5313644094,2.4488736211,14,4,18
reeve,41.5027617637,1.27772130819,51,17,68
army,41.4879404131,2.29704732299,9,5,14
jamrun,41.485259719,1.87619359486,23,7,30
redd,41.4564610818,1.91587232468,15,8,23
zanguzen,41.4042473899,2.20757714245,13,6,19
ppmd,41.4029003644,2.11963086597,8,8,16
frootloop,41.3728682719,1.61637033546,22,11,33
alex19,41.3558522965,1.91864330877,18,8,26
yung arc,41.3555459644,3.32997308117,4,2,6
mahie,41.3515944397,1.71804569469,30,9,39
fiction,41.3346057506,2.29038317007,9,6,15
frycook,41.226110015,1.93385267634,20,6,26
rime,41.2106650804,2.37236621033,9,4,13
orly,41.1954253274,1.75324698752,26,8,34
captain smuckers,41.1741313932,1.48970207538,26,15,41
milkman,41.1383620807,2.05466210252,17,6,23
kpan,41.1285045671,1.57889281061,27,12,39
squible,41.0079600925,2.04065558623,15,5,20
jflex,40.9420033357,1.71341343948,22,10,32
reaper,40.8454932118,2.29264939243,16,4,20
lord,40.8377086381,3.35600350828,5,2,7
ronzell,40.8095776548,3.09855449042,7,2,9
vro,40.8051886219,1.33884462484,36,17,53
kyle,40.7892491522,2.89211826397,8,2,10
taylorhj,40.7739342171,2.50450861259,11,4,15
uncle mojo,40.7651629316,2.91798782148,5,4,9
azusa,40.7569826711,1.99825660687,14,7,21
luigikid,40.7555906643,2.25544678882,13,4,17
$mike,40.7067723521,1.95045410112,16,7,23
anther,40.6561640214,1.80881217095,17,8,25
fatgoku,40.6510411814,2.59378199889,7,3,10
rockleeland,40.5943527026,2.77894981635,8,3,11
r2dliu,40.5698385043,1.4945144537,27,12,39
phil,40.5586183089,1.95417136643,18,7,25
a rookie,40.5586033864,1.98687007349,16,7,23
reno,40.5322528554,1.47238196738,27,15,42
k-12,40.5237922099,2.43893124127,19,4,23
lovage805,40.5217732063,2.58111096592,7,4,11
mike haze,40.5152823622,2.56906526498,8,5,13
hat,40.4935771564,1.72930022558,23,9,32
boulevard,40.4935501256,2.39410512869,10,4,14
jeapie,40.4797822425,3.43366788177,6,2,8
zoler,40.4599324979,2.31163200122,20,4,24
rk,40.4545218059,2.60545059182,7,3,10
blea gelo,40.4236983136,3.0345525152,6,2,8
yoyo,40.4094884062,1.9559870349,15,7,22
plank,40.3927439503,2.57576299931,9,4,13
sago,40.3767593351,1.77193152341,28,6,34
googlyeyed,40.3438004101,3.48962553037,6,2,8
charlon,40.2779417551,2.78132289362,11,2,13
ciz,40.2236986154,1.59856485773,25,11,36
icer,40.215485162,2.45378052355,11,4,15
sol,40.1753937423,2.98311801684,8,2,10
g$,40.1423089694,1.71340481343,22,8,30
spark,40.0830972827,2.1139073426,14,6,20
ibdw,40.0107936364,2.01123326877,15,7,22
tafokints,40.0039940994,1.42900918349,31,17,48
morsecode762,40.0002498479,1.90868077262,16,8,24
crunch,39.9725525257,1.80177461048,24,9,33
dev,39.9191667052,2.97504160487,6,2,8
davidcue,39.9108682579,2.51612010984,12,2,14
timi,39.8996416392,2.82689591258,11,2,13
eagle,39.8719641149,2.36321327837,19,4,23
ka-master,39.8575653824,1.9137113278,17,8,25
bmc,39.8517732499,1.98794399461,19,7,26
homemadewaffles,39.8440794173,1.60985137724,25,13,38
doll,39.8328902414,2.56818465415,10,4,14
koopatroopa895,39.8168085921,1.94330034543,16,7,23
kira,39.8011694678,1.31268779535,41,19,60
flikkflakk,39.7976462788,2.50248597818,17,3,20
silentspectre,39.7879857922,1.9322903725,16,7,23
minty,39.768778962,2.12408044772,15,6,21
shinobi,39.7355768522,1.43480714207,34,14,48
zoma,39.7297237493,3.14250197801,6,2,8
satdaddy,39.7247911283,3.02508864844,5,2,7
ryobeat,39.7148617716,2.35298986795,10,5,15
juggleguy,39.6927330412,1.27336084204,45,20,65
eikelmann,39.6820513482,2.99675259449,6,2,8
@adamayonmike,39.6777730661,2.92549726336,10,2,12
lanceinthepants,39.6423603473,1.62516516155,28,11,39
oaty,39.6388353258,3.11159136683,6,3,9
lint,39.6229711095,1.74971251131,22,9,31
bigfoig,39.6140571921,2.53204853834,8,3,11
nmw,39.6047422196,1.93543439736,17,7,24
pi,39.5837784764,2.27278146227,11,4,15
kage the warrior,39.5709495713,3.1357130008,6,2,8
dudutsai,39.5375245667,1.95429342281,18,7,25
star,39.5319411293,3.2731976022,6,2,8
peanutphobia,39.5129186203,1.89186135123,18,8,26
vinodh,39.5080599689,2.04989222239,15,7,22
wenbobular,39.4824931587,1.89840742544,19,8,27
sauc3,39.4632163941,2.37607593523,11,4,15
ycz6,39.4598446972,2.20555662466,13,6,19
nightmare,39.4423938705,1.42244486869,35,14,49
rold gold,39.426731442,3.37207436366,6,2,8
jkj,39.4051224707,1.90533387225,18,8,26
vish,39.3972384517,1.8588298044,18,9,27
zeo,39.3256232644,1.83936868555,18,9,27
javi,39.2927527749,2.72709611394,8,5,13
bobby frizz,39.2797287103,2.01288902553,16,8,24
pricent,39.2708905317,1.98041395181,25,8,33
linguini,39.2701877691,3.36142313015,5,2,7
bones,39.2475801182,2.03321088974,14,7,21
däumling,39.2331655683,3.34263415061,6,2,8
santiago,39.2058083025,3.49238883642,4,2,6
twitch,39.2045057258,3.26793557429,5,2,7
hamyojo,39.2034778287,1.91148621458,19,8,27
vanitas,39.1665287769,2.05868020025,14,6,20
sk92,39.1659920031,2.58919661477,9,4,13
daydee,39.1610936931,2.05673003746,23,6,29
kdj,39.1229385139,2.94385786768,6,3,9
quaz,39.1141374184,3.08061076218,10,2,12
darkrain,39.1118249961,3.38905276009,5,2,7
triple r,39.104001288,1.94984146899,20,7,27
pit,39.1008951708,3.23104138784,6,2,8
bolt,39.0764906111,2.46321341728,11,4,15
tranimal,39.0741678376,2.07994315698,16,7,23
yort,39.0349696776,2.19289141794,14,6,20
son2,39.0327409012,2.40747452245,10,5,15
vdogg,39.0203678252,2.20428433131,19,5,24
ryan_k,38.9955104618,2.84558315899,8,4,12
cob,38.9666413885,2.3558000948,11,5,16
sothe,38.9490581745,2.53942424885,12,3,15
tm,38.940417241,1.64312045967,26,10,36
ralph,38.9356431544,2.60520685318,7,5,12
uuaa,38.9181036706,1.65277554521,23,10,33
swiftbass,38.8726758386,1.67564412503,23,12,35
fa0,38.840141206,2.15887322469,18,6,24
dendypretendy,38.8171380957,3.41932294071,6,2,8
gar,38.8163780954,1.89891325339,18,8,26
drunksloth,38.8129631921,1.83343067916,22,10,32
bësti,38.7959268238,3.09938537187,9,2,11
lawn chair,38.7878591719,3.372790393,6,2,8
magicubed,38.7871355017,2.34013912157,10,5,15
mattdotzeb,38.7764185071,1.61015961457,26,13,39
jace,38.7631307992,2.6484855818,10,4,14
bizzarro flame,38.7606949813,2.66346585032,9,4,13
rik,38.7331870086,1.40044851066,39,17,56
brokenyew,38.7259164666,3.31911380834,5,3,8
wavebringer,38.7186815009,2.55576096737,9,4,13
nakamaman,38.7110054862,3.25226485232,4,2,6
envy,38.6780841407,1.64849528821,23,11,34
fauster,38.6770695583,2.55856708057,15,4,19
schythed,38.677018086,1.78548701615,22,10,32
monib,38.6592110453,2.15164201429,19,7,26
yams,38.6564303336,3.16597106138,4,2,6
azzu,38.6228405415,1.65771245004,28,10,38
cal,38.609807651,1.85624059529,20,8,28
aglet,38.6060999029,2.61780501559,10,4,14
ken,38.6059422427,2.16067663473,12,7,19
justjoe,38.6033813615,2.20344103091,17,5,22
captainjack,38.603249696,3.03825958527,9,2,11
damian tyson,38.5937335926,2.234381417,18,6,24
sacasumoto,38.5659933442,2.51763773872,10,4,14
rudolph,38.5430808254,2.26018085503,9,7,16
hazygoose,38.5429946507,2.78248219702,11,4,15
moogle,38.538477859,3.43132427869,5,2,7
eggy,38.5063373837,1.63084181506,27,11,38
articanus,38.4964988032,3.18555660619,6,3,9
jawanga,38.4920488685,1.96956672717,16,7,23
junebug,38.4686943735,2.43961798009,14,4,18
rula,38.4671771378,2.28199860195,13,6,19
usleon,38.4151668529,1.86602143234,21,7,28
okamibw,38.405200341,3.33863161943,6,2,8
imyt,38.3842988945,1.79907398327,21,9,30
humpe,38.3745906339,2.53013924777,17,4,21
equal,38.3595669631,1.78487959221,21,9,30
mike g,38.3378894317,3.30124108071,5,3,8
amida,38.3369804668,1.68904007619,23,11,34
shamunt,38.2887575683,2.06587809243,14,7,21
neeco,38.2686473009,2.42859986292,11,4,15
obamallama,38.2286952254,2.39140225713,11,4,15
lovage,38.2284466562,3.28654256773,6,3,9
trichael man,38.2269611482,2.53189726722,11,4,15
tenrye,38.2262203886,3.31049771635,9,2,11
captain crunch,38.2126081829,1.68765310204,24,12,36
doh,38.2037780013,2.81680449685,7,4,11
psychomidget,38.1717521365,2.07646113492,15,6,21
markow,38.1700470113,2.92177680958,9,2,11
vino,38.1523283275,1.96913093883,18,8,26
dizzy,38.1418279467,3.25921050951,6,3,9
jadde,38.1373896588,2.49229498629,17,5,22
cmg,38.1309924005,2.70343196364,10,4,14
suess,38.1192745137,2.12276235523,15,6,21
widl,38.1172183893,2.12984356262,12,7,19
s1,38.1158350428,3.4272416035,5,2,7
alejandro,38.0904231289,3.03222585717,8,2,10
patcake,38.0822581425,3.23568385212,5,2,7
bardull,38.0651280067,2.46885227394,10,4,14
dai,38.061906114,3.32441948923,5,2,7
paper,38.0594172768,2.71591714151,9,4,13
prz,38.0582256962,2.25596226798,14,5,19
alp,38.0538924249,2.65100330076,9,4,13
furta,38.0521548899,3.6456467162,4,2,6
iluvcrispix,38.045812959,3.13719385913,6,2,8
nerin,38.0392864044,2.25412347933,14,6,20
dairdev1l,38.0378273179,1.44383616883,37,17,54
r23,38.0269997817,2.60976600644,10,5,15
levingy,38.0082550224,2.13461340946,15,6,21
zbert,38.003567766,2.41919335524,11,4,15
toph,37.990938327,1.53954591822,25,16,41
green ranger,37.987851806,3.45613230881,6,2,8
nimzo,37.9872400497,3.28414782894,6,2,8
zorc,37.9835086856,1.54256989304,38,13,51
tang,37.9807942775,2.34166638086,11,6,17
beerman,37.9668616885,3.41706653831,4,2,6
vortex,37.966225562,1.44527482934,32,15,47
baka4moe,37.9649612182,2.60453897108,9,5,14
jcam,37.9615029921,3.4263681282,4,2,6
sg,37.9613506697,3.48254614067,5,2,7
kevinm,37.9601082246,3.7403752406,4,2,6
tirno,37.9435916957,2.09303415107,14,8,22
murdock,37.9424013497,3.50360654054,5,2,7
angtheavatar,37.9327171647,3.21053470291,5,2,7
voorhese,37.9257445087,3.14578583688,9,2,11
moky,37.9231631498,2.7394646029,9,4,13
shminkledorf,37.9209262888,3.66965885642,5,2,7
tope,37.9127132967,3.50505180288,4,2,6
i4n,37.9053875547,1.44136128199,37,14,51
kyu puff,37.8665671694,2.7887408664,6,4,10
xif,37.8637688417,2.81886177191,7,5,12
toastyb,37.8306382319,2.02479668439,16,7,23
advanced,37.830617682,2.22377971199,14,6,20
scythe,37.7862172445,1.71853098993,28,9,37
yakal,37.7837093477,3.54906528303,5,2,7
ny joey,37.7708647112,1.61781536293,25,12,37
ministry,37.7601345653,3.04923281791,10,2,12
jrad,37.732803449,1.72097243659,21,10,31
tesla,37.7097545467,3.33042340437,6,2,8
j666,37.7008529051,2.25417486689,12,6,18
bose,37.6807161938,2.21194213751,19,5,24
thoraxe,37.6690727358,2.65438318963,10,4,14
subtle,37.6654134241,1.99733064043,17,8,25
yedi,37.663996933,2.45156573014,9,5,14
beach,37.6437303335,1.4345601295,33,16,49
bimbo,37.642415347,3.32865421903,4,2,6
pikapika!,37.6419996774,2.89297806591,9,4,13
qerb,37.6323422908,3.67442860439,4,2,6
chip,37.6137551382,2.67813181872,8,4,12
chroma,37.6116092611,2.48121106382,10,4,14
nevake,37.5857299711,2.66675549105,8,4,12
peki,37.5674798788,2.32574303807,17,5,22
imperfect,37.5658465424,2.37104721431,17,4,21
luigigoshard,37.5512305887,1.31677636765,43,22,65
rayzorium,37.5425766845,3.40165212631,6,2,8
onion,37.5355038461,2.6156051707,10,4,14
atomsk,37.5318601988,1.83875682846,19,9,28
th0rn,37.5296317628,2.93047850558,6,3,9
umbra,37.5275561787,3.31272635293,6,2,8
rustin,37.517602699,1.8254396,18,9,27
warriorknight,37.5114258395,2.63903153406,8,5,13
makari,37.5103742673,3.49844367902,4,2,6
pengie,37.5053814843,2.62353304007,8,5,13
sverre,37.5007072999,2.25333013631,17,5,22
newera,37.4942818736,3.14555343454,6,2,8
rofl,37.4770554496,3.18397428218,7,3,10
quin,37.4663069567,1.88288834695,18,7,25
oreo,37.4641127616,3.11015388951,8,2,10
berble,37.4609872799,2.76981694241,8,4,12
baeblade,37.449590101,2.06280519451,17,8,25
violence,37.4108935749,2.09694302432,17,8,25
dawn,37.4108480141,2.7401919253,10,4,14
ky,37.3844906155,3.57344725369,5,2,7
thugz,37.3839264919,3.6436481104,5,2,7
arc,37.3736176274,2.24646166492,12,7,19
ferocitii,37.3682384786,2.36626848657,14,5,19
blahyay,37.3670691058,2.73873156966,6,4,10
emt_sol,37.3575519056,1.87241084824,17,9,26
yabasta,37.3446477281,2.09107539843,22,7,29
liquid,37.3364942351,2.66783493752,9,4,13
ambiguously polish,37.3347588867,3.27123740394,5,2,7
tuxedo mask,37.3198532282,2.60620952901,9,4,13
who?,37.3096473884,3.69569848608,3,2,5
kaeon,37.3002157822,2.60010097693,9,4,13
mew,37.2956694583,1.95978514968,21,9,30
blueg,37.2940290822,2.60283575486,8,4,12
liberate,37.2905317884,1.87467261593,19,9,28
pseudoturtle,37.2899093127,3.26942115349,9,2,11
kei,37.289257339,2.60930974022,10,4,14
pudgypanda,37.2808926942,2.24173090754,11,6,17
hello,37.2795630592,2.47626578084,13,4,17
neologism,37.2749710185,2.46053667361,12,6,18
tapion,37.245791019,3.40978835049,5,2,7
klaps,37.2451367103,3.19378006522,5,3,8
hyprid,37.2387618728,3.77004611692,3,2,5
thegooddoctor,37.2286346966,3.04744187492,9,2,11
naminami,37.2255924081,3.48528608444,7,2,9
sharkz,37.2206685361,2.08893623467,14,7,21
porkchops,37.2180074762,2.48223246075,10,5,15
anjo,37.2137275231,2.33922873344,11,5,16
gundersen,37.2081035797,3.29763343525,9,2,11
little england,37.2080507187,3.61469709874,5,2,7
alan,37.2071421675,1.80891151399,18,10,28
phade,37.184208269,2.01748777118,18,7,25
mr. lemon,37.1746639202,3.01367031726,6,3,9
kriz,37.169730316,2.50786221861,16,4,20
ebay,37.1641900316,2.26393019396,12,5,17
mt,37.1191376283,2.75130612667,5,6,11
flamin roy,37.1168911799,3.63643165397,5,2,7
griffith,37.0600575175,3.31211724447,5,2,7
dunk,37.0541131581,1.49368110213,31,15,46
jah ridin',37.0518587286,3.32415621377,9,2,11
lsdx,37.0451857482,3.38814213401,9,3,12
saus,37.044891609,2.67867077002,9,4,13
husband,37.0431648381,2.99410859701,6,3,9
ihavespaceballs,37.0371473597,3.69062325186,5,2,7
johnkorv,37.0329333599,3.35729706748,7,2,9
jonjon,37.0310725055,2.79310601724,9,4,13
moose,37.0234201042,2.02631770688,15,8,23
windrose,37.0194037132,2.96723668806,7,4,11
pig,37.0183823507,2.28242645342,12,6,18
bananas,37.0105771632,1.90299282283,16,8,24
techdeath,37.0073313195,2.68682735354,10,4,14
groovy green hat,36.9924690981,2.51243330051,10,4,14
hulka,36.9583905751,2.6417255628,8,4,12
phex,36.950533352,1.81988889104,21,9,30
shiftingshadows,36.9276784608,2.41625968295,15,5,20
eliott,36.9216002262,1.83925927176,18,9,27
deathgazer,36.9203422062,1.97455246001,20,9,29
arcane,36.9126237317,3.43132589631,6,2,8
bigvegetabluntz,36.9064246719,2.14857912357,13,7,20
mr.postman,36.906240576,2.62483355246,9,4,13
albert,36.8860377278,2.59632785902,8,4,12
gg7,36.8832940993,3.59209830957,5,2,7
| porkchops,36.8803631454,3.19406599665,5,3,8
brtarolg,36.8735332207,1.49133858275,37,15,52
squid,36.873211378,3.20389552444,5,4,9
reason,36.8671307067,3.61244583077,5,2,7
sweet,36.8570275635,2.40314503892,10,5,15
ashtrei,36.8533596466,3.47927117461,8,2,10
mistrrlove,36.8417372427,3.95213899859,6,2,8
kevorkian,36.8299202543,1.70500446255,23,11,34
nhat,36.8286060711,2.94280125015,7,3,10
mr. tuesday,36.8195388738,2.86102010581,5,4,9
home,36.8181208475,2.66043713032,8,4,12
yoshi,36.8109937263,3.49429304119,5,2,7
erik,36.8060669785,2.65769767807,9,4,13
km,36.8032208367,3.03943609307,7,2,9
travis,36.7986835463,2.2071146908,15,6,21
fork,36.7822954897,2.93658045801,7,4,11
sypherphoenix,36.7768231215,2.60938614087,8,4,12
nakamaru,36.7697724513,3.33895303667,5,2,7
heartstrings,36.7536936434,1.46133353572,31,16,47
rainbow,36.7450946884,2.40691526308,11,5,16
skipper,36.7441909953,3.19964480394,7,2,9
hart,36.7400048759,2.12022254955,11,7,18
d..p,36.7311539267,3.78437800729,5,2,7
lock,36.7049785776,2.43415242874,12,5,17
tran,36.682625932,1.81470173502,19,10,29
salevits,36.6802951525,2.58529386444,16,4,20
sinbad,36.6779879218,2.50938380041,9,6,15
avalancer,36.6730478491,3.41443706549,5,3,8
mayhem,36.6718803472,2.56286674509,16,4,20
digital cannon,36.6663850352,3.29477307236,4,3,7
jager,36.6658583331,3.43939472651,5,2,7
absentpage,36.6640059313,1.4602775797,26,15,41
nerodero,36.6420122539,3.52431642147,5,2,7
mikkuz,36.6347970176,2.60932827818,8,4,12
aellwine,36.6317201636,3.26689027386,6,2,8
shabo,36.6228161567,1.72351711193,23,11,34
greed,36.5961717788,3.97794797228,5,1,6
balloon,36.5708229967,2.52972124661,10,4,14
desseler,36.563510848,2.65665185602,11,4,15
mundungu,36.5510788844,2.71609721486,8,4,12
slipnslide,36.5479341608,3.4154916818,5,2,7
alpha dash,36.5400087244,2.71784962956,11,4,15
unreal,36.5387632366,3.13208953831,7,3,10
russell,36.5252801814,2.5898908242,9,4,13
potato,36.5245462198,2.71476104346,8,4,12
uwan,36.5217078232,3.42184846679,5,2,7
flood,36.5178390118,3.4829138769,5,2,7
ftgg,36.511504688,3.14485254762,6,2,8
poonslayer7,36.5108040283,2.78300125737,7,3,10
machiavelli,36.4890867833,3.28093773139,5,2,7
shiny,36.4853888738,3.67116585003,5,2,7
killahertz,36.4785758577,3.29568476347,6,2,8
yomi,36.4748312844,3.77923286981,4,2,6
codi,36.4615971116,3.73119711051,4,2,6
knubs.,36.4569195355,1.63821038169,26,12,38
phake,36.4523720732,3.10039653765,5,4,9
jman3,36.4512595745,2.69903717361,9,3,12
aza,36.4479469198,3.74398607734,4,2,6
metroid,36.427380634,3.14889712295,5,3,8
maruf,36.4141042057,3.38816757007,4,2,6
mooninite,36.4091346986,3.89005994311,4,2,6
dewky,36.408007242,3.69707801343,4,2,6
toastbread,36.4046177467,3.06508992741,6,3,9
quang,36.4009076639,2.53758870043,10,4,14
aellgi,36.4001213267,3.25398675408,8,3,11
mixx,36.3896377982,3.72685346884,4,2,6
haus,36.3593696734,2.62946637117,8,5,13
mojo,36.3345208964,2.68776454077,7,5,12
t. webb,36.3306204451,2.27141953593,11,7,18
hellsingulh,36.3174825589,2.5413691154,10,4,14
theswooper,36.3162208535,2.16685709777,15,8,23
quail,36.3152776783,3.47920596727,6,2,8
nes,36.3094215433,3.32826144356,5,2,7
john ward,36.3015217155,3.41835772823,6,2,8
cactuar,36.2981227665,2.93064848282,4,5,9
iateyourpie,36.2932678661,3.68417287093,4,2,6
vincessant,36.2794240635,2.03252025303,14,8,22
emodinosaur,36.2790782713,1.90537587179,17,9,26
bebop!,36.2736328405,3.61528109834,5,2,7
hungry pigeon,36.2711065252,1.95196862191,16,9,25
tempo,36.2645784773,1.88233516616,19,9,28
stacy's stepdad,36.2515657689,3.26943659967,7,2,9
kevbot,36.2080357783,2.12402226512,12,7,19
stango,36.2034240342,2.81273236993,8,4,12
pajama sam,36.1959252937,3.10311087938,5,2,7
yardsale,36.1774375395,2.30175615934,13,7,20
schlimmshady,36.1750633051,2.90909092809,10,3,13
god with a wavebird,36.1718081716,3.55348536745,5,2,7
rael,36.1648215062,4.37473838206,2,3,5
chris best,36.1644094902,3.54736485887,5,2,7
dansdaman,36.162557849,3.62289599904,4,2,6
craiger,36.1584339584,3.75531300372,4,2,6
venti3hm,36.1563459242,3.33070137092,5,2,7
soccermom69,36.1367450932,3.50482727138,6,2,8
mr good luck,36.1341401515,3.62819696269,3,3,6
| smokey bluntz,36.1285203821,3.64439680539,5,2,7
dr. light,36.1180879511,3.51111762208,4,2,6
hot,36.1145014727,3.61329885774,4,2,6
dalung,36.1115254733,3.50886745958,5,3,8
upke,36.0726510695,2.88415539597,9,4,13
cuff,36.0470269223,3.04058971523,9,3,12
mfsa,36.0409306423,3.60721300535,4,2,6
carrigan,36.0290166526,3.20762554479,5,2,7
chum,36.0286017757,2.77538588649,8,4,12
moist,35.9873920699,2.66887918758,9,5,14
yamaneko,35.9873029358,2.60868086976,9,4,13
nainsoo,35.9845264337,3.62045463892,5,2,7
kimimaru,35.9843980266,2.62788566049,9,4,13
s-royal,35.9835295589,3.51447664915,5,2,7
gato,35.9719811793,1.97811497087,17,10,27
ju4n,35.9650288489,3.5551971969,4,2,6
the phenom,35.9631131467,3.09371905954,6,3,9
gcs,35.9582544932,3.71241111567,5,2,7
it's a wonderful world,35.9428524441,3.69769781646,4,2,6
wts,35.9346291736,2.84788874137,7,3,10
arty,35.9132881103,3.17037275178,5,3,8
yield,35.9074858417,3.96302073316,4,1,5
psi,35.9031988067,3.08419246572,6,3,9
mint,35.8925510929,5.00946119214,1,1,2
nasan,35.8804933113,4.49191761996,1,2,3
jake13,35.8791837851,2.3903812616,9,7,16
pwof,35.8765751957,3.8364620997,4,2,6
liam_butler,35.8699447336,2.03970740217,13,6,19
poop,35.8665315853,2.81656940431,9,4,13
smashbob squarepants,35.8661390224,2.41559316798,11,7,18
eggz,35.8642645419,3.71714100625,4,2,6
shaeden,35.8576325526,2.51648585168,8,5,13
darktooth,35.8547023067,4.05409253006,4,2,6
wakenvape,35.8539207504,1.65892003577,27,12,39
ultimascout,35.8488146125,3.7753051301,4,2,6
buddy guysman,35.8469813312,3.90405512453,4,3,7
citrus,35.8318093522,3.01736997365,8,4,12
umarth,35.8234565118,2.6642197164,7,4,11
dezno,35.8223870833,1.66984794263,25,12,37
jago,35.8182405034,3.35043200337,5,2,7
yeti,35.8151317279,2.23867520403,13,7,20
ajp_anton,35.8148817518,2.52170536578,13,6,19
dyl,35.8095457543,2.90414263112,6,4,10
mike melee,35.8044456563,3.70134315512,5,2,7
emanon,35.8022772175,1.91159387394,17,10,27
prof,35.7950062915,4.12100145497,3,3,6
sealmore,35.7937640854,3.62964389721,7,1,8
dk@runescape.mom,35.7923556375,3.37008962499,5,2,7
njzfinest,35.7917737628,3.72729203239,4,2,6
diplomatictucan,35.7808096307,2.67057971436,6,4,10
coen,35.7790590263,3.43052776515,5,3,8
waterlessfishie,35.7725144203,2.57740001722,9,6,15
lonebutterfish,35.7594924714,2.12141682889,16,8,24
ilovebagelz,35.7531721856,3.45009297375,4,2,6
42nd,35.7522279863,2.22378868075,14,7,21
jdog,35.7460148123,3.28751136073,7,2,9
ed,35.744776152,2.55001984175,10,4,14
random-ness,35.7439347743,2.5153076644,12,5,17
sizzle,35.7396549543,2.162837291,15,6,21
loki,35.7322879009,3.54261840113,4,3,7
dr. z,35.7279785432,1.80077525476,19,12,31
warwick foe,35.7206312124,2.46349856238,10,5,15
dr. greenthumb,35.7177124782,2.55298429005,11,5,16
ellis,35.7010531241,2.55532329524,10,5,15
ridz,35.683816073,2.48305497631,11,6,17
skeith,35.6800622174,2.27342957083,12,6,18
musgraves,35.6767764762,2.2229762988,12,7,19
working class hero,35.662299153,3.99485441877,3,2,5
pgh carroll,35.6330203776,2.93011314286,7,4,11
sung475,35.6226355239,4.28500444302,2,2,4
j00t,35.6131176898,3.79765076292,4,2,6
le fou,35.6128302891,3.98449729239,3,2,5
fendricklamar,35.594559412,1.36963121048,35,21,56
harriet,35.5299700604,3.80084960331,3,2,5
greenmario,35.517095724,3.61857805933,4,2,6
yeyo,35.5161713416,3.3273745933,5,2,7
dan salvato,35.5101626085,3.39374415903,7,2,9
doodler,35.5068908267,2.44450375333,11,5,16
khale,35.5051510649,2.30617969008,11,6,17
starlord,35.4975053285,2.35666883494,11,6,17
off3nse,35.4926989493,3.26633578619,5,3,8
reesch,35.4708949929,1.91546055983,18,10,28
austintacious,35.4694442223,3.89503105993,4,2,6
zilo,35.4549159126,2.90636481592,6,3,9
ozai,35.4433899679,2.09918482414,14,8,22
p-chips,35.4374662723,3.15965464906,8,3,11
skilljkfalco,35.4238753176,4.03850084617,4,2,6
a link named slykbacc,35.4227693586,3.51637073182,4,2,6
dozy,35.4174051976,4.23909275288,3,1,4
askeflink,35.4132071089,2.05731883826,23,8,31
samurai ike,35.4130053739,3.48055708244,4,2,6
fireflyhi,35.4129011646,2.90249701921,7,4,11
nils,35.4056242543,1.96448415822,20,9,29
drug money,35.3885738281,3.70037377055,5,2,7
gso,35.3869422183,2.39545817457,10,6,16
the brig,35.3869078663,3.06795758181,6,4,10
drgn,35.370005765,4.52829331704,3,1,4
jozi,35.3668884955,3.1679207787,5,3,8
electric flux,35.3564203171,3.4949657078,5,2,7
mingee,35.3447287723,3.48028126828,3,3,6
wooptywop,35.3421087407,3.69713932501,5,2,7
luigo,35.3347314132,3.46088204941,7,2,9
peligro,35.331222336,3.82205375662,4,2,6
rocky,35.3253974462,2.17645498283,14,6,20
bonkcushy,35.3141350477,2.30684373706,12,6,18
theprime,35.3103049575,2.7884629348,7,4,11
nikabod,35.3053468315,2.89603725154,7,4,11
summonedfist,35.3041505544,3.29933840666,5,3,8
bimbo mexico,35.2920620484,3.92386110706,4,2,6
derfmidwest,35.2895669657,3.04881315012,5,3,8
kim yung un,35.2661092007,2.10377332232,14,7,21
mijo!,35.2427969755,3.71503507308,4,2,6
twistytreats,35.2419465414,3.23317455461,5,3,8
mahone,35.2413063035,3.24868994935,4,3,7
cheezpuff,35.2384227156,3.91414823132,4,2,6
fueg0,35.2364761042,3.17954627201,6,4,10
boss,35.2330906269,2.55991472888,11,5,16
drewgong,35.2212306686,2.17919754713,14,7,21
specialk,35.2132192738,3.90068547643,4,2,6
natendo,35.2123681886,3.6561241846,5,2,7
torsional strain,35.2107499533,3.20768469879,5,3,8
testament,35.2053267122,3.53359751624,5,2,7
l,35.2025233244,2.35398598634,10,6,16
chipgroove,35.1900233284,3.78768695635,5,2,7
boyd,35.1896687465,2.59002873352,8,6,14
bacon,35.1837914453,1.86342645521,17,10,27
rax,35.1791472978,2.55190517551,14,4,18
een!,35.1758663186,3.7475021223,5,2,7
frenzy,35.1728898731,1.94900576284,23,11,34
fearless,35.1680579993,3.65649320109,4,2,6
maxy,35.1675349561,2.68326400293,10,6,16
phish-it,35.1591808011,1.83828120968,19,11,30
poobanans,35.1574158393,3.80031897406,4,2,6
goomy,35.1533258623,2.63519819243,8,4,12
allen,35.1514356965,2.54166539388,9,5,14
nox,35.1465310139,1.51621248898,28,16,44
velocity,35.1448505068,2.42437844072,11,6,17
fridgebits,35.1409770143,3.78584169735,4,2,6
noah,35.1322820401,3.09683955811,8,4,12
paz,35.1269905507,2.16913151319,11,7,18
massheist,35.1248186169,2.48888727633,9,5,14
denec,35.0959903225,2.61840206319,11,5,16
replicate,35.0931029566,4.54868192823,3,1,4
biggpappa,35.0929712547,2.41900853307,10,6,16
stricnyn3.,35.0833884555,4.14591492465,3,2,5
joeycrzl,35.0688092461,2.34159775116,10,7,17
mb-smash,35.0639429082,2.63729038644,8,4,12
manio,35.0628919878,3.48300903742,7,2,9
tinojoe,35.0548170523,3.78498482445,4,2,6
galen the wise,35.0537289072,2.55727262942,9,5,14
benteezy,35.0534091973,2.61942515294,9,5,14
oc mike the franchise,35.0521829103,2.43033994481,11,6,17
cantus,35.0429460892,2.16336248686,12,8,20
manatee,35.0310883208,2.66277239439,7,4,11
dazwa,35.0308531043,2.93831022759,6,3,9
jam,35.0274184126,2.22320074133,16,8,24
thevelvetmarmot,35.0139329269,3.63996986534,5,2,7
taka,35.0052733862,2.27393518576,15,6,21
king momo,35.0052106568,3.63405579823,4,2,6
choknater,35.0024315379,2.86402539035,6,4,10
ap renekton,34.9898349264,5.03966310239,3,1,4
doubleshine,34.9807796269,3.40232019797,7,3,10
andymosity,34.9699902711,2.80727897015,7,4,11
kami,34.9587190769,3.08032606117,6,3,9
godiegogo,34.9586199454,3.3455949437,5,2,7
aozorax,34.9524646309,3.82125913457,4,2,6
sherigami,34.9393306078,3.13474583158,6,3,9
thissidedown,34.9368301277,1.84602282923,24,11,35
douchebag dylan,34.9347185704,2.64763161979,8,4,12
vudujin,34.9338359596,3.97564835416,4,2,6
myztek,34.9215228879,2.32779030416,11,7,18
eastcoastjeff,34.9186654563,3.95773614543,4,2,6
twisty,34.9161805709,2.99043027386,6,3,9
c#,34.9156051183,2.83918483468,9,4,13
jank,34.9146594889,1.77390812875,21,12,33
shaqfu,34.9077659243,3.3894009093,5,2,7
$tijn,34.9044133297,3.49440525504,5,3,8
rockcrock,34.901106489,2.31988692615,10,6,16
vista,34.8998664113,3.58314087604,4,3,7
lunchables,34.8991482998,3.27909654818,6,3,9
joejoe,34.8944968233,3.47311783705,4,2,6
spiff,34.8893879383,3.4913806354,4,2,6
zasa,34.886839857,2.17932843393,12,7,19
coolkid,34.8845283211,2.91123503703,7,4,11
guluheend,34.8690690768,2.70230205194,8,4,12
sjkf,34.8326155994,3.12627902344,6,4,10
modem,34.8217424818,2.59962070115,10,5,15
rog,34.8101976916,2.56943114227,9,4,13
alain,34.8071101955,3.25423132783,7,3,10
odds,34.8063478744,2.96605562219,7,4,11
kaike,34.8024964552,3.75923302984,4,2,6
admiral,34.7996702622,2.11724496307,12,9,21
grab2win,34.791748881,3.32578787043,7,3,10
tiramisu,34.778568511,3.63791595125,4,2,6
the prince,34.77785304,2.51464029399,10,5,15
vavv,34.77768512,2.52287923964,10,5,15
infernojesus,34.7763810779,1.85238326695,19,10,29
davrob01,34.7757366687,2.36678568145,15,7,22
romeo,34.7649854581,3.18474604213,6,3,9
jdv,34.7633677818,3.15468270905,6,3,9
shanks,34.762639184,3.15102492486,6,3,9
volvo,34.7460561297,3.96475596402,5,2,7
clue,34.7424150692,3.4249063033,5,2,7
mom!,34.7341561394,2.54564861473,10,5,15
messenger,34.7328053685,1.91428157563,15,10,25
@tryceblazer,34.7280998121,3.22349029585,5,3,8
mr. muscles,34.7166083427,2.49358647263,10,6,16
friendly neighborgood puff,34.7049495397,2.89475619495,6,4,10
mask,34.7022776581,2.71492065491,9,5,14
irregularjinny,34.7019685384,2.81864408376,11,4,15
ses,34.7000132039,2.6945420563,9,5,14
jim jam flim flam,34.6972760291,2.95268443552,7,4,11
ko$a!,34.6949282731,3.36927206642,4,2,6
space ghost,34.6743591426,2.58106808861,11,4,15
jf,34.6634322772,1.93290300788,17,11,28
lain,34.6587201429,2.11240101291,14,7,21
zilyn,34.6571720056,3.29349686503,6,3,9
kitsune91,34.655688946,3.01991452568,5,3,8
martin,34.6537696776,3.93500624984,6,1,7
fluid,34.6471588645,2.07824086722,15,8,23
nurok,34.6445707129,1.82259247649,19,11,30
thx,34.634886068,2.53286121554,10,5,15
zamu,34.6338373593,2.41655323199,12,7,19
weeaboo,34.6195527918,2.17018817167,14,8,22
kanti,34.6173158401,3.19057494363,6,3,9
bluefalcon7,34.6141089299,3.73966807364,4,2,6
mwl,34.6135960189,3.16289643052,6,3,9
mr. brandandorf,34.6066446937,2.26133368969,11,8,19
vts,34.6062385635,2.93909896991,6,4,10
spor,34.6045666671,1.8250947077,24,11,35
roid,34.6039135371,3.88137932456,4,2,6
snowy,34.5926801688,1.99646141384,14,8,22
kuyashi,34.5777698944,3.5637986128,4,2,6
inspector gadget,34.5629749499,3.24011995297,4,3,7
conn man,34.5597666841,3.6394342289,4,2,6
mr. f,34.5593366345,2.37758712533,12,7,19
rogee,34.5497092874,3.52267868533,5,2,7
matchu,34.5478957279,3.97217131642,4,2,6
eekim,34.5434866001,2.45872993757,12,6,18
spaceanimalz.com,34.5281237421,3.69880888689,4,2,6
patcombo,34.5058925301,2.47605458677,9,6,15
true dong,34.5037468174,2.92514255743,6,4,10
aether,34.4977577979,2.9098239619,8,4,12
seeray,34.4951052371,3.40993110239,5,3,8
simple,34.4914223432,2.5443021368,11,6,17
quindelin,34.4884855713,3.08243447015,5,3,8
azel,34.4798576609,3.84734802733,3,2,5
der_hund,34.4775501542,4.02425415222,5,2,7
hella,34.476395016,3.8214344131,4,2,6
barraca,34.4607362966,2.59370216135,9,7,16
trilok,34.4499694549,2.40982920688,10,6,16
jim morrison,34.449007454,3.86052236212,4,3,7
scape,34.4421644986,2.6952293308,8,5,13
thunderpaste,34.4369658871,3.49758725484,4,2,6
bor,34.4272239414,3.2288729609,6,3,9
arcadia,34.418625391,2.11576802882,13,9,22
speez,34.3975557529,3.78280063342,4,2,6
kenji,34.396173177,2.25187338608,10,7,17
iamthemicrowave,34.3760016008,2.8847183241,7,5,12
plat,34.363748136,2.90752887549,7,5,12
white guilt,34.3551881383,4.79879383976,4,1,5
darkneo754,34.3485751442,2.7932464996,8,4,12
deepz,34.3405220436,2.90104310071,6,4,10
pasi,34.340445249,5.1340927538,1,1,2
snacks!,34.3397077125,2.71641188378,9,5,14
ricky,34.3331535321,2.32241463713,13,7,20
cascade,34.3238056785,4.34713248943,4,2,6
the leaf,34.3226576244,2.55726160332,8,5,13
akke,34.320013302,3.91118271282,4,3,7
overflow,34.3188472735,2.41035095449,9,5,14
magi,34.3180312715,3.56357993666,4,3,7
legend,34.3129798121,2.15395988935,13,8,21
ratking,34.3056519264,3.75845579678,5,2,7
kraines,34.3054214597,2.77753461043,9,5,14
timemuffinphd,34.3009736051,2.68788756496,9,5,14
puff,34.3005553036,1.70587102338,21,12,33
switch,34.2959282414,2.03419019508,14,10,24
rick,34.2861138762,3.3519134499,5,2,7
derdian,34.2749242872,3.13642173151,6,5,11
dublat,34.2581342401,2.68509290972,9,5,14
eric,34.2534853042,3.03592446908,7,4,11
animal,34.2523098349,4.16689476577,3,2,5
v01d,34.2500929496,3.95832368004,5,2,7
videowaffles,34.2491000709,2.63157966748,8,5,13
parzival,34.2374518256,2.04107208686,16,9,25
signd0g,34.2310592786,2.57375524498,9,5,14
tian,34.2300791128,2.4987331069,8,6,14
ohmyjosh,34.2080732896,3.70486881426,3,2,5
baby bird,34.1870493201,2.92790059776,8,4,12
zook,34.1697188204,2.14232237543,16,9,25
zeldafreak,34.1693026644,2.92922443146,6,4,10
hyunnies,34.156465197,2.41648329326,11,7,18
kei$,34.1498365955,4.49843297946,3,2,5
willz,34.1466682149,2.48094173423,13,6,19
kimmy,34.119994143,3.65321879945,5,2,7
kanye rest,34.1171278002,2.24011378821,14,7,21
47,34.100265697,2.51444474704,11,5,16
omer,34.0816024886,3.73144370783,4,2,6
eclipsing binary,34.0705552268,3.91740274912,4,2,6
kmac,34.0677990445,3.82713839398,4,2,6
slypig,34.0466082347,2.82836994081,7,4,11
sastopher,34.0333611111,3.74605491797,4,2,6
cohenski,34.0311280216,4.17266758793,4,2,6
focus,34.0305245468,1.75507409289,18,10,28
idcrisis,34.0227636994,2.83334534692,6,4,10
twin,34.0134790495,3.00945946142,8,4,12
christian,34.0076643932,3.617933707,4,2,6
decoste in the shell,33.995114167,4.10653074828,4,2,6
manyula,33.9909531008,3.6651454027,6,3,9
mr. nima,33.9903609427,4.22817247971,3,2,5
armand,33.9895208972,3.64179146384,4,2,6
haotwo,33.9823534676,2.58772546556,10,6,16
otg,33.9799580678,4.08696905433,3,2,5
trix,33.9795030434,1.72338148336,20,15,35
zylo,33.9748670416,3.3413506574,5,3,8
akio,33.9731695422,3.89306430982,4,2,6
coin chaser,33.9727063631,3.47022370678,5,3,8
spyderj,33.9648381219,2.75386598418,8,4,12
eet,33.9494395481,2.56487205138,11,5,16
sora,33.9486358427,2.5271305202,8,7,15
kwyet,33.9455147038,3.43654770482,6,2,8
delphiki,33.9449931664,4.22952856495,3,2,5
bluebuster,33.9421210849,2.78823299537,7,4,11
king funk,33.9364768551,2.47210002043,13,5,18
primer,33.9306961009,3.55708844834,5,2,7
dshi,33.9305264517,3.86382195811,3,2,5
cookiemonsta,33.9276428988,2.3018140744,11,8,19
eval,33.9267247179,4.22229684273,3,2,5
ctrlaltdefeat,33.9250803643,3.45388802365,5,3,8
roytheboi,33.9191942829,2.8502433434,7,4,11
anaveragekid,33.9100480751,3.00963053972,8,4,12
dope,33.9069805635,2.01018940174,13,11,24
yasu,33.9065297441,2.70220066219,7,5,12
fannypack,33.9053033382,1.83559074311,22,13,35
gawes,33.9005969589,3.83346211761,3,2,5
mr_sweet,33.8968117266,2.9024477736,7,4,11
punk,33.8864302107,2.7143926566,9,5,14
azen zagenite,33.8696806834,3.39021001516,5,3,8
bëst,33.8612705729,3.56038854994,7,3,10
strawhat,33.8498777938,2.95281095794,6,4,10
thumbs,33.8439946675,3.40668227723,5,3,8
mrbenready,33.8378595548,2.71511897499,9,6,15
sillie willie,33.8311683316,2.92129939164,8,4,12
dr. grin,33.8306930961,2.52247362562,7,5,12
nekonyancer,33.8265214428,3.35991210649,7,3,10
shu shine,33.8240846015,3.96202989566,4,2,6
bonfire10,33.8172947911,3.95680184315,3,2,5
qz,33.8163536311,2.22925512348,10,7,17
sqiddwr,33.8103003916,3.78313987712,4,3,7
damp,33.8035940674,2.94174181079,6,3,9
the jester,33.7934685509,3.66366851748,5,2,7
nexic,33.7923502105,1.90991653343,19,10,29
pikapastor,33.7845188465,2.128280615,14,7,21
donb,33.7761599781,3.69645612428,3,2,5
ru$$,33.7580787184,4.25525728707,3,2,5
frotaz,33.7543073929,3.11369652467,5,4,9
tags,33.7428547291,2.55874170967,10,5,15
q,33.73603166,1.8592528198,16,11,27
flion,33.7270037983,1.97611348964,16,9,25
trademark,33.7250854481,3.17093449454,6,4,10
docta love,33.7196154553,4.09341945833,4,2,6
mayb,33.7177429866,3.48976376461,4,3,7
pop$,33.7000600502,4.00292955627,4,2,6
flambo,33.6970684218,3.70858624094,4,2,6
flop,33.6814542944,3.50046147381,6,2,8
dab,33.678172889,2.50215364308,10,7,17
riio,33.6687982554,3.08933282622,6,4,10
mchi,33.6682769928,2.50456620948,11,6,17
crimsonkid,33.6680067844,2.93980915807,7,5,12
restez,33.6674704179,2.74525013235,8,5,13
hanyuuki,33.6672150522,3.98309029325,4,2,6
indie,33.6597060947,2.7429186042,8,5,13
slowking,33.6567245807,2.23862867516,10,7,17
sfop,33.655555131,2.64009831114,7,4,11
king quiggles,33.6453863283,3.78226067324,4,2,6
.ðempt,33.6403459404,2.67629002446,7,5,12
rasen,33.6312480845,2.03830201918,14,9,23
bob$,33.6208447145,4.55664476671,3,1,4
pervy,33.6202066126,4.27872411162,3,2,5
kalvar,33.6159340247,2.61048905242,8,6,14
keenan,33.6116591257,3.16753711889,5,5,10
deenuna,33.6096449443,2.70378799449,6,5,11
bdr,33.6096025646,2.56145718529,8,5,13
professor peen,33.6005533535,3.04368891256,6,4,10
claw,33.5983331402,3.69672922666,4,2,6
gimme,33.5959859851,2.50391591256,11,6,17
salty seth,33.5947779532,1.8991133782,17,10,27
ghettowarmachine420,33.5844730721,3.5314714806,5,2,7
tempest,33.5839169148,2.75759508937,7,5,12
gulfcoastbrian,33.5781221783,3.22176942602,4,3,7
silence,33.57415529,2.90236672932,7,4,11
younger,33.5588732731,2.11007820365,13,9,22
pk,33.5489149263,3.3900575462,6,2,8
dsj,33.5487117572,3.63728863924,4,3,7
tato,33.5479440838,3.90886080051,4,2,6
mattyice,33.5397428597,4.00802753411,4,2,6
d3rp,33.5370557602,3.30393362566,6,3,9
cool lime,33.5325089321,2.56381733023,8,5,13
veklor,33.5279003264,2.13227697654,12,8,20
wassabi,33.5259570274,2.03767374543,16,7,23
£30-,33.5177569081,3.60897059229,5,3,8
wic,33.5066276532,4.0582156595,5,1,6
mattmog,33.50320522,2.39001208852,12,7,19
lego,33.4974745267,2.41671916836,11,6,17
goonsquad,33.4847555985,2.98833981873,7,4,11
1der,33.4840536557,4.25527589535,3,2,5
dog wearing sunglasses,33.4794860434,3.40871121207,5,3,8
rad,33.4769884729,2.29512665808,11,6,17
jeff foxworthy,33.4752926236,3.68986836992,4,3,7
swordsaint,33.4750840338,3.60540174859,3,2,5
yeeman,33.4713916703,2.61990558621,8,5,13
kason,33.4706888945,4.14256303356,3,2,5
floorboards,33.4646198001,3.24262080452,5,3,8
bo0gyman,33.4636043003,2.77079131533,8,5,13
sawrik,33.4469289132,3.78508374055,4,3,7
smakis,33.4452479579,2.86912516815,10,6,16
jacky,33.440678602,1.78312358361,20,12,32
woley,33.4340908856,1.92541404269,18,11,29
keto,33.4333287434,3.05831321871,6,4,10
dp's mario,33.4302304145,4.26275102378,4,2,6
vulfaerix,33.4200076097,3.71274127035,4,3,7
gator [slater],33.4179507682,3.38542862998,4,3,7
t3nshi,33.4156552229,3.5104357711,5,2,7
nanacomehome,33.4118420567,3.2815542536,6,3,9
ferriswheel,33.4052271924,1.86528429524,20,11,31
den,33.4045184573,2.27456633373,13,8,21
weissclimbers,33.4012171452,2.65164340811,9,4,13
jcubez,33.3997797888,2.61809152455,8,5,13
dkuo,33.3994120797,2.93459762107,6,4,10
noc,33.3878276258,3.73665059871,5,2,7
breezy,33.3870913279,2.7242798683,8,5,13
fabio,33.3797347091,3.25332081158,5,4,9
s2b,33.3776037874,2.63978756834,7,5,12
keithrep,33.371991941,2.40940462491,10,6,16
| jeezimsobored,33.3678553585,3.43069033049,5,3,8
spoopy williams,33.3654819265,3.26727728501,4,3,7
jwilli,33.3601127545,2.85177127376,7,5,12
fraudy,33.358450564,3.24022752909,8,4,12
gtown_tom,33.3551263682,2.91811342202,8,4,12
gme,33.3544085589,4.0330891967,3,2,5
wild,33.343840965,3.50701917223,5,3,8
sycorax,33.3436236016,2.99026492465,6,3,9
wreck,33.3372311465,3.45122971889,4,4,8
bzrk,33.3303641555,3.64372283532,5,2,7
callmeaustino,33.3284494947,3.05099850188,6,3,9
sneddy,33.3191817952,2.63101838857,7,6,13
tek9,33.3059713466,2.58437441457,9,5,14
juicebox,33.3034142979,3.3790472879,5,3,8
trk,33.2989710718,2.60587176281,8,5,13
low5,33.2980582595,2.71118418097,6,4,10
zoap,33.2976541574,2.7561348044,9,5,14
pure,33.2860549694,2.36091003051,11,7,18
rybanz,33.2805197518,3.04345085616,6,5,11
webwipe,33.2792120219,2.59044545227,8,5,13
neft,33.2756315852,3.88783557586,4,2,6
future,33.2753051984,3.0382496013,6,4,10
copycat,33.2730906718,3.86552144057,4,2,6
hdyambo,33.2721465159,3.43056074774,5,3,8
skillznasty,33.2577762648,2.15520814824,12,8,20
ender,33.2569927089,3.97012008862,4,2,6
caup,33.2473848442,3.51140180741,5,3,8
didact,33.2456454779,3.48601664157,4,3,7
syd,33.2423232794,3.43442372,5,3,8
photonic,33.2407274105,2.14774159322,17,9,26
vdub,33.236972915,2.37262148529,12,7,19
clade,33.2255815813,3.59668071221,6,3,9
kramepie,33.2207841371,2.56683474695,8,5,13
n0z1ck,33.2205073984,2.75528958683,8,5,13
trinity92,33.2139925264,3.89717674091,4,3,7
ninji,33.2115564395,2.73114608825,8,5,13
pas,33.2005609016,2.78033196029,9,5,14
vj,33.1817104439,3.44616521372,6,3,9
prevalence,33.1810980247,3.90960087158,4,2,6
bobi,33.1752113881,3.60334197647,4,3,7
iifter,33.1719457233,2.60966272717,8,5,13
coastward,33.1709643506,3.05641875427,7,4,11
techboy,33.1679561663,2.36937725973,10,8,18
dfu,33.1649699734,3.15956558469,4,3,7
gumble,33.1636760534,2.6919075717,9,5,14
travist,33.1566714022,2.17610113104,15,8,23
hyperflame,33.1549480614,2.49614518865,11,6,17
chompskye,33.1469863639,3.76952498955,4,2,6
metal reaper,33.1414144455,3.70807026106,4,2,6
blendtec,33.140112922,2.19211696677,16,9,25
drolian,33.1387258137,3.61588062551,6,3,9
colonel dog,33.1186727472,4.08733106956,4,2,6
shrug,33.1185552788,2.82464275986,6,4,10
lazarous,33.1162684675,3.64395798797,5,3,8
wolven,33.1037659547,2.36107343967,14,7,21
nja,33.0994168066,3.96916109625,4,2,6
vigilance,33.0952832734,3.90997452361,4,2,6
vestboy myst,33.0911078358,3.12924385383,5,3,8
joshuwasha,33.0831495513,2.70386695164,8,5,13
wasabi,33.081689788,2.61306236379,9,5,14
yordy,33.0752478537,3.3875921331,4,3,7
nino,33.0739502909,2.85270034413,8,4,12
fives,33.0737426197,3.19218170151,6,3,9
bananasack,33.0662862336,3.61777624073,5,3,8
walt,33.0648845313,3.95655829988,4,2,6
ott,33.0581795279,2.99127963096,6,4,10
frogge,33.0560953629,4.82990095826,3,1,4
gardex,33.054765784,2.06014198544,15,10,25
elegy,33.0428606665,3.31171443375,7,3,10
elcancell,33.0412010991,3.93318843342,4,2,6
hippo,33.0367582649,3.55610457838,5,3,8
sodrek,33.0332159041,4.45690035593,5,1,6
bigwenz,33.0315162381,1.81884164694,18,13,31
fiya,33.0314092729,3.81917780983,3,2,5
rebel,33.0270730322,3.9126823669,4,2,6
snoosnoo,33.0199561505,2.39793029009,12,7,19
999,33.0105989491,3.56394239298,4,2,6
kingbbb,33.0021063064,3.79558699533,4,2,6
clouded,32.9988520247,3.44699295076,4,3,7
maybe,32.9981910427,2.35722858841,12,7,19
scar,32.9970004615,2.00194479869,14,9,23
atlus,32.9871511166,4.07770237025,3,2,5
decaf,32.9798954869,3.1468745724,6,3,9
halestorm,32.9730086203,3.87013084459,4,2,6
flashburn 117,32.9677962164,1.51488196066,34,19,53
yandere tet$uo,32.9627317364,4.9748727859,1,2,3
duel,32.9569305671,3.01537191025,5,3,8
emukiller,32.9539393052,4.33814403332,4,2,6
isdsar,32.9534288275,3.46765286257,5,3,8
length plank,32.9497569195,4.35660690129,5,3,8
anti,32.9433949177,3.14941659466,5,4,9
setchi,32.9426999124,3.12248238704,6,4,10
ionthekid,32.9292169992,3.18942349743,7,4,11
peelee,32.9288873843,3.54795009265,5,2,7
hayrow,32.9250758749,2.38121767457,10,6,16
sandy,32.9205113087,4.29303292466,4,2,6
cheato,32.9203453321,2.32186569867,12,8,20
soulpech,32.9084158603,3.54858232217,4,3,7
dash,32.9065321637,2.38602433821,13,7,20
pleeba,32.900283888,1.80067324279,18,11,29
pizzainacup,32.8981837256,3.61217467589,5,2,7
l2p,32.894632435,4.34641941087,4,2,6
nasa,32.8891477304,3.40641025153,5,3,8
stelzig,32.8856248692,2.60645604677,13,6,19
bedgar,32.8835871196,3.88325716801,3,2,5
pleasantries,32.8818991953,2.15204666149,16,9,25
nu,32.8799267424,3.78227369222,3,3,6
kizzo,32.8762460901,3.41361259598,5,3,8
bhoogs,32.8727037005,4.06462345015,4,2,6
tilt,32.8714881138,2.58140676482,11,6,17
farks,32.8704236844,3.44007851877,5,3,8
jnaut,32.8615738861,3.77712918653,4,2,6
zombie!,32.8463001382,3.3437250953,6,3,9
iram,32.8311599468,3.94975897086,4,2,6
ziren,32.8116257473,3.46597470139,5,3,8
quality steve,32.8098946201,4.0258898195,4,2,6
chandy,32.8039512367,2.45542713674,10,6,16
thrash,32.7995986455,1.9927830033,18,9,27
atlas,32.7974939514,2.17025237766,13,8,21
quaff,32.7959707327,3.92387647055,4,2,6
glitchy,32.7905171114,4.20392948334,3,3,6
thoreo,32.7785843946,2.87606426528,9,4,13
a-wall,32.7768527815,2.56296172435,7,7,14
fuddyduddy,32.7705853826,3.91950775686,5,2,7
bravo,32.7617856492,1.98944751767,18,12,30
frizz,32.7532308473,5.14726784967,2,1,3
pb&j,32.7431214514,1.96060288267,15,12,27
darby,32.7221656066,3.66288477629,5,2,7
kony,32.7205477568,2.68496387231,8,6,14
giogio,32.7203465746,2.084370804,14,11,25
store-bought pancakes,32.7157261041,4.04263199965,3,2,5
thenumber47,32.7113960852,3.24935295694,7,4,11
krudo,32.7063226533,3.09118440435,7,4,11
ihwp,32.6946500537,3.27726011772,7,4,11
oc zack,32.6886682984,4.26991763331,4,2,6
kihyun,32.6884123341,3.08944270371,6,4,10
basic stitch,32.686499405,2.90480531393,8,4,12
piranha,32.6809088431,3.61538669558,5,2,7
wheat,32.6806945423,4.18140505478,3,2,5
ezvip,32.6800470595,3.288767352,6,3,9
ripple,32.6752111725,3.34957479331,7,3,10
falcoty,32.6707164439,4.04455721748,3,2,5
village mascot,32.6571179939,1.98261925133,15,10,25
petteh,32.6559352333,2.767624551,10,6,16
dero,32.6548250693,3.37075079339,6,3,9
meo,32.6530630501,3.4612000253,5,3,8
ryucloud,32.6506855473,3.98461041649,3,2,5
blaze,32.6499357046,1.89969100445,19,12,31
doyoung2win,32.648247945,4.02089526819,3,2,5
shonic,32.6473489209,3.3463598346,6,3,9
kaimen,32.6458220726,3.74661153298,4,2,6
plinci,32.6255935563,3.59103972415,6,3,9
w33dl0rd840,32.6236249254,4.04853438432,3,2,5
zorbak,32.6223077787,3.85233387461,4,2,6
gas$,32.6085810625,3.66531921224,4,3,7
strain,32.6011924618,4.03172747537,3,2,5
oro?!,32.5984686925,3.88494568037,3,2,5
firefly,32.5977447457,3.27627555801,6,4,10
mouf,32.5852247887,3.32902173125,4,4,8
zeeop,32.585167709,3.6099668336,5,3,8
squid kid,32.5763256273,4.22138949584,3,2,5
thebattlerifle,32.5759155195,3.63383630448,5,3,8
fortissimis,32.5755402401,2.63594964105,10,6,16
fist mexico,32.5629836724,2.90808496344,6,4,10
giraphe,32.5613362108,3.91225125932,4,2,6
ganz,32.5581716106,3.74614771062,6,3,9
sailormoon420,32.5520815106,4.05218288561,3,2,5
smashdaddy,32.5496111515,2.79121573054,6,5,11
guac,32.5479569531,3.56454284113,5,3,8
pinkdeaf1,32.5445315517,3.18605982531,5,3,8
| kitsune91,32.5444006703,4.03273798944,3,2,5
ippo,32.5411647314,3.97100173254,4,2,6
yold,32.5386950201,2.39032328831,10,7,17
mentaculus,32.5331263166,2.68416833532,7,5,12
lk,32.5187999548,1.97982533314,16,11,27
devastation,32.5144305933,4.06121025964,3,2,5
tuesday,32.5088393406,1.90589722658,15,13,28
rare,32.5077836397,3.59226768106,4,3,7
exumer,32.5062766029,2.98574390713,6,4,10
brog,32.5062276109,4.19106346114,3,2,5
koopakev,32.5060409213,3.01673039083,6,4,10
thad,32.5039154168,4.21083109288,3,2,5
birdshit,32.5006725215,2.88539244013,7,4,11
tm12,32.4948200036,4.39081562148,3,2,5
marco,32.4824545341,2.78540624855,6,4,10
taki,32.4618584122,3.89999156407,3,2,5
gibbles,32.4593340364,3.65749461639,4,3,7
myl,32.4586861445,3.35631650863,4,3,7
hannydoon,32.4518006604,3.63532569075,4,2,6
mike,32.4496291643,2.81919835802,8,5,13
young,32.4475091835,3.05401631289,6,4,10
antic,32.4404173553,3.57380468914,4,3,7
norwood,32.4378688455,2.67142373524,7,4,11
bertbusdriver,32.4357257843,2.17165173273,13,9,22
barbado,32.4346165202,3.87288853985,3,3,6
liqued,32.4317182681,3.08743262316,6,4,10
chillypotpie,32.4257443793,3.97349677447,4,2,6
luan,32.4237317477,3.70599397835,3,2,5
k1kk0m4n,32.4134014418,4.05950543435,5,3,8
j,32.411933638,2.57564018821,9,6,15
mr. potatobread,32.3876828756,3.6415795695,4,3,7
puppeh,32.3848474866,2.14095962343,14,9,23
dirtboy,32.3799081204,3.8018053117,4,2,6
smopup,32.3785345371,4.00598680061,4,2,6
maskless,32.3727428701,2.29004049812,14,9,23
bryan,32.3593885714,2.7189395639,7,5,12
fishaman p,32.3468965895,3.37122522706,7,3,10
kibbles,32.3285766483,2.25375578288,13,8,21
xell,32.3234674568,4.05346070823,3,2,5
robin,32.3223195894,3.14328903833,7,4,11
devil may cry 3,32.3205912299,3.86981368914,4,2,6
feradit,32.3205003656,2.59139441304,8,7,15
dusty md,32.318743044,5.81844725581,2,0,2
l1fe,32.3186353279,3.9460791426,3,2,5
brick,32.313375725,2.54078199175,10,6,16
*zen,32.3020365638,3.99836141997,5,3,8
datrooph,32.295253838,4.18787113066,2,2,4
looke,32.2940814636,2.75544901569,9,6,15
yashichi,32.293285461,3.10735298919,5,4,9
yat,32.2923810427,3.72455846833,4,3,7
2highsofly,32.2817672583,2.66510295258,8,5,13
roochi,32.2789366876,2.95951969363,8,5,13
bluezaft,32.2770831783,3.86783213536,4,2,6
irotikuz,32.2656319796,3.66538820579,6,3,9
rappsody,32.2644392654,1.98262697406,18,11,29
karson,32.2616932997,3.61850980955,6,4,10
tc,32.2612302253,3.34072713124,6,3,9
guero,32.2572811974,3.81460143287,4,3,7
roukiske,32.2554780298,3.02231064334,7,4,11
fluffs,32.2507915251,3.31684100927,5,3,8
jonathan cotto,32.240621405,3.01192340455,6,3,9
sr-cue,32.2378653097,3.35162632927,6,4,10
ebola,32.2372760694,4.16578593945,4,2,6
egg,32.2237211214,3.41003671829,3,4,7
cow,32.2234051731,2.14406727159,11,9,20
mrbeenready,32.2144294043,2.97907085119,7,4,11
lad,32.2119118597,3.38479812092,7,5,12
desucakes,32.2036629358,3.58185489028,4,3,7
type1,32.1946939584,3.90018081719,5,2,7
roboticphish,32.1823946128,1.82200690979,18,13,31
nagy,32.1801526474,3.38331323038,5,3,8
llama,32.1740483829,2.71726035896,8,6,14
zodiac,32.1730604258,3.71847765306,4,3,7
gtone,32.1726195584,2.57985887449,8,5,13
kohai,32.1706261875,3.07699006602,7,4,11
team nick,32.162721038,3.6213224666,4,3,7
onisser,32.1608740283,3.39633028069,4,2,6
voo,32.1586023009,3.83727978894,4,2,6
coyote,32.1525531568,4.03052703428,3,2,5
marko64,32.1501464357,2.67201149613,6,7,13
nix,32.1488117375,2.48179506726,10,6,16
l33t,32.1471406052,5.09848003436,3,1,4
mittens,32.1442474325,3.11448142424,6,5,11
zepto,32.14020331,2.12651338952,15,11,26
@ssbm_ichigo,32.132761549,4.00745177035,3,2,5
dilla,32.1305104681,2.78363606823,8,5,13
explo,32.127324301,2.5514885513,10,7,17
surf's up. hail satan.,32.1257009749,2.23491145827,12,7,19
sc00p,32.1251354829,3.07330294913,7,4,11
arc tres,32.1223004183,3.46165000609,5,3,8
xardov,32.1197333123,2.76466477268,9,5,14
kex,32.1173362224,4.03910110051,3,2,5
danch,32.0992376122,3.61608636245,5,2,7
valdo,32.0987168889,4.80646030847,2,3,5
hh toast,32.0976954118,3.52591553849,5,3,8
lacroix,32.090736294,3.55222918679,5,3,8
xpilot,32.0881933384,4.00017467576,3,2,5
mrjungstuffed,32.0875524754,2.20748809444,14,7,21
hylian,32.0863664358,2.97122815235,8,3,11
elementalpenguin,32.0820794822,2.51623767034,10,7,17
syko,32.0798766271,3.13545908184,6,4,10
mementomori,32.0781327978,3.58257063126,4,3,7
dj red lantern,32.0763031674,3.40206527176,4,3,7
duckpimp,32.0743285233,4.38431257859,3,2,5
dana,32.073617609,3.10648766007,6,4,10
mustang,32.0701210396,3.81524172871,3,2,5
blockhead,32.0684766707,2.89953187323,8,4,12
arby,32.0673609671,4.40280004581,2,2,4
pj,32.065365866,2.15842388124,11,10,21
wubbs,32.0608441917,3.73282772238,4,2,6
pureskillz,32.0570503529,3.67313955612,4,3,7
tonic,32.0545650368,2.48838995074,11,7,18
luck,32.0486495578,3.61524444055,5,2,7
ford$,32.0436246503,4.05162012011,4,2,6
mekk,32.0317718835,1.89378886604,15,14,29
xelius,32.0303049607,3.67982961196,6,3,9
mojoe,32.0289590702,2.25644016438,9,8,17
vilness,32.0278539544,3.36989504959,6,3,9
holiday,32.0267623961,2.25106487603,10,8,18
vgmasta,32.0185257697,4.41146390821,2,2,4
2gs,32.0128023282,3.40443888841,5,3,8
panties,32.0107069032,2.51015524758,9,7,16
level 100 potato,32.0057355357,4.42562132218,4,2,6
joe k,32.0043954499,3.03605135517,7,4,11
voff3,32.0032855176,3.82350104529,6,3,9
sasha,31.9993860535,2.57680669498,9,7,16
2krunkvillain,31.9982964573,4.24395613085,3,2,5
aly,31.9933793824,2.62963428271,9,6,15
saiko,31.9875082946,3.56073011224,3,3,6
mika,31.9785759283,3.36440532513,4,4,8
bpow,31.9751884408,3.35676683287,6,3,9
nice boy,31.9693703786,3.86990507666,4,2,6
holy ham,31.9678139791,3.44220389113,5,3,8
xam,31.9565871815,3.93644067625,3,2,5
slartibartfast42,31.9533757959,2.27682853608,12,9,21
blitzbolt,31.9524848068,3.12115522615,6,4,10
belia,31.9489071331,3.52326834928,3,3,6
badmdvafox829,31.9474593944,4.38959542385,3,2,5
will pickles,31.9419089793,1.94658236495,20,12,32
legion,31.9412529013,1.67012413758,22,15,37
creature,31.9410459858,4.38160667822,3,2,5
tapsody,31.9407324404,2.25764197081,9,7,16
moy,31.9366158982,2.58393868425,9,5,14
pikminbutdeadly,31.934324508,4.02935953592,3,2,5
rhan,31.9310884467,2.75067896195,10,6,16
endeby,31.9307783639,2.59226215753,13,8,21
nuggets,31.9285979312,2.30413427375,12,8,20
kurt kobain,31.927871804,3.77992016102,4,3,7
nerd,31.9258473528,4.06806133727,4,2,6
alphicans,31.9182674249,4.08339936524,3,2,5
sam:),31.9170290653,4.60690940165,3,2,5
bolvelt,31.9148618317,2.96061456811,9,5,14
clickclack,31.9136991834,3.76364535507,4,2,6
clockmire,31.9126781005,3.54712341974,4,3,7
frost,31.9056960591,2.95068654987,7,5,12
tylenol p-m,31.9018348131,2.58983003233,7,6,13
dakpo,31.9010202947,3.13130745961,6,4,10
frozenlight1337,31.9004523489,4.1985687194,3,2,5
simna ibn sind,31.8940872199,2.75004849953,7,5,12
zent,31.8812255354,2.98246540454,6,4,10
uma thurman,31.8812252373,3.80182892429,5,2,7
rensxd,31.8761322923,3.7777464746,4,3,7
garbage prince,31.8745634503,4.3166020924,3,2,5
cesar,31.8735218462,3.5877015834,3,3,6
jojo,31.8702410189,3.41469038032,5,3,8
dempsey,31.8639606225,2.99901141198,7,4,11
cupofwater,31.8623168004,3.81423318234,4,2,6
suidt,31.8589193756,3.83386197897,3,3,6
owl,31.8586106189,3.75342949056,4,3,7
gurglehusk,31.85600652,3.09199450735,5,4,9
tl | 343,31.8546090289,3.00460639803,6,5,11
anytime99,31.8502483093,3.59971438218,4,3,7
bearsfan092,31.8463765116,2.1256701355,12,11,23
gambs,31.8413871993,4.15047083527,3,2,5
mprime,31.830850094,4.51155201672,3,2,5
tessa,31.8147975642,3.83375866982,4,2,6
baker,31.814013064,3.47505561061,5,3,8
harald,31.8102583245,2.77333265803,11,5,16
watt the flux,31.8051968817,4.66828719218,3,2,5
thebiggestc,31.8050246871,3.60093123474,4,3,7
fizzba,31.7941495493,3.53952497519,4,3,7
phrase,31.7916270962,3.38126585986,5,3,8
ghidorah,31.7910514585,3.34268195705,5,4,9
ae.,31.7835900404,3.72139557783,5,3,8
boston's finest,31.782689268,4.40074240796,2,2,4
brian,31.7825842807,1.8067066178,17,15,32
kofi,31.7757592602,2.87142062605,6,5,11
mogwai,31.7697079668,2.73744596076,7,5,12
elephante,31.7661162269,2.69190039907,10,5,15
drag,31.7586046626,2.70040825278,11,6,17
wrenches,31.7563605966,3.45418346099,5,2,7
hurlevent,31.7542723184,3.94013360787,5,2,7
chardlos,31.7538237563,4.09068485884,4,2,6
jackkenney,31.753421217,2.47495709917,9,7,16
almond,31.748429756,3.99812130583,3,2,5
infernoomni,31.7318696615,3.57046035353,5,3,8
billyboy48,31.7284925447,3.70939464316,4,3,7
cheesepuff,31.7232002816,3.90659113588,3,2,5
jc,31.7225650091,2.7786594809,8,5,13
gblade,31.6927215632,2.32291937419,14,9,23
mervis,31.6901766616,4.29540473604,3,2,5
european greazemans,31.6815545174,2.72892744024,8,5,13
eon,31.6813528894,2.81729350615,9,6,15
fazers,31.6753787528,3.8501446489,4,2,6
mgeezus,31.6735807264,3.74161448664,4,3,7
lxix,31.6668012581,2.3353972998,11,9,20
theunabletable,31.6625011044,3.72020786829,4,3,7
karma,31.6617845234,2.14366429724,13,10,23
silver,31.6425212248,2.15993213555,14,9,23
rockmix,31.6312281758,2.76741078671,10,6,16
lightning weeg,31.6299912199,4.30150991182,3,2,5
archive,31.6274382429,3.66518706027,4,2,6
watchingtime,31.6265257503,2.98414975666,7,4,11
xii,31.6213617239,3.18247533232,5,3,8
dunkasaurus_rex,31.6173576295,4.06172823201,4,2,6
hitmonchanondorf,31.6124108852,4.31004984765,4,2,6
judge,31.609652884,3.01865890333,7,4,11
jedijakethemystical,31.6090956233,3.59157142354,4,2,6
yuna,31.6071009506,3.7032862774,5,3,8
sooji,31.6012037507,2.57079851452,10,6,16
golden,31.5975340099,3.29325534248,5,4,9
shot,31.592408317,4.06764827328,5,2,7
peanut,31.5908975024,2.90878756456,8,5,13
char,31.5848191382,1.80665596718,19,13,32
spud,31.5835298633,3.15949360013,5,4,9
lil isai,31.582996684,3.7122594137,4,3,7
wishh,31.5789944459,4.00074218602,4,2,6
carso,31.5759237213,1.97136873833,15,10,25
tichinde925,31.5751488627,3.82500950675,4,2,6
8,31.5736274721,3.14360211315,5,3,8
boamba,31.5703189949,2.33880109546,10,8,18
metaknight0,31.5645973897,4.47624616807,3,2,5
sigh,31.5557754143,3.98971724394,3,2,5
monkey,31.5547630324,3.45677423175,5,4,9
friend,31.5528558978,2.87985990255,9,4,13
kip,31.5511695486,4.20199321309,3,2,5
masquerade,31.5469013478,3.27699889986,5,3,8
kotojo,31.5447996613,3.39846528063,5,3,8
frosti,31.5329709212,4.55349456874,3,2,5
darkcloud,31.532789871,3.74538646893,5,2,7
crusifix,31.5300115558,4.30631452464,3,2,5
hazard,31.525036502,3.56267661767,4,3,7
gorbachev,31.5242325812,4.12446119336,3,2,5
frogman [charette],31.523255462,4.27929667499,3,2,5
a_e_d,31.521256958,4.27489564037,3,2,5
benstillerfan69,31.5176493573,2.94199009939,7,6,13
enemy unit,31.5162508849,3.35790720437,5,3,8
souroush,31.5159988176,4.08845850221,3,2,5
jvamos,31.5143195299,2.61333627037,7,6,13
robbyk,31.5086008236,2.32127266973,10,7,17
luka,31.50751941,4.36847290853,3,2,5
eigen,31.5033699721,2.66422721034,8,6,14
zarinax,31.5032835388,4.31912721488,4,2,6
althalous,31.5022439153,4.17671338069,4,2,6
trap,31.5011517297,3.58860137847,4,3,7
bomb,31.5006611095,2.91789255894,9,5,14
impx,31.4942958477,3.34958028329,8,4,12
kalimari,31.4901054021,3.5866547761,5,3,8
quig,31.4880920244,2.87755103673,7,4,11
mums,31.4860742259,3.1231991106,9,6,15
poopmaister6000,31.4689654313,2.22736461002,16,10,26
aniolas,31.4664943407,2.16770306073,12,8,20
wobblepot,31.4647099523,3.28286086666,4,3,7
crescent monkey,31.4641177537,3.65505272431,5,3,8
ceephax,31.4610333351,1.92889788376,16,13,29
vzakat,31.4575115886,3.48789446094,4,3,7
calta,31.4518537085,3.57081611758,5,3,8
capem,31.4491540602,3.54534857231,5,3,8
treetz,31.4418195927,3.11804843529,5,5,10
mr.anderson,31.4415480336,4.24246691662,4,2,6
radar,31.4410295051,4.11866922208,4,2,6
amazerommu,31.4377697436,4.20233363714,5,2,7
catastrophe,31.4360119408,4.36872901449,2,2,4
wamsa,31.4355868252,4.27431137301,2,2,4
justin,31.4296669982,2.77923557071,7,5,12
corgi gucci wolf,31.4275896902,3.54873239853,5,3,8
slug,31.42659759,3.25550096881,6,4,10
kyle bananasak's left nip,31.4183898701,3.93278055254,4,2,6
mpfuture,31.4152264231,3.65197284172,4,3,7
tenshi,31.41467691,3.63877765525,5,2,7
hdbryan,31.4113711111,3.28262157736,4,4,8
jaggedcole,31.4099787379,2.85525974929,7,5,12
ace,31.406448848,2.11797971721,11,9,20
knight,31.3970141814,3.56843869889,5,4,9
law,31.3943437764,1.73014823919,19,17,36
hank,31.3896173349,2.23942463292,13,7,20
beans,31.3869350038,3.91796060349,4,2,6
nut,31.3827151923,3.58590775519,5,3,8
nokes,31.3772488479,3.70535837854,4,3,7
+ultra,31.3767439178,3.40767420613,4,3,7
helmet,31.3707237884,3.07736018472,7,5,12
soda,31.3574687298,3.63301518305,4,3,7
b flat,31.347953149,3.70454761207,4,3,7
farko,31.3438788353,4.11378498281,3,2,5
whatisfear,31.3432854655,2.95484038537,7,4,11
mom?,31.3431362094,4.43164024545,3,2,5
viktoralsos,31.3424848555,3.95627210269,5,2,7
bliutwo,31.3391898388,2.95804257443,7,5,12
baconpancakes,31.337722888,4.32552296316,3,2,5
snap,31.3364945823,3.26217431013,5,4,9
gongfactor,31.3325867766,3.54570677093,4,3,7
m3k,31.329711226,4.29340922937,3,2,5
oli,31.3245667777,3.56458020015,5,3,8
krevlar,31.3238580502,3.20019499828,5,4,9
quint,31.3207821458,4.25560281495,3,2,5
krkkvpl,31.3203950643,4.34030027653,3,2,5
aperture,31.3195665934,2.08177872599,14,10,24
ironpiggy,31.317031431,4.1956269276,3,2,5
barrakir,31.3164420455,4.23777040796,4,2,6
jip,31.3141126813,3.88346369072,3,3,6
kid,31.3126110177,3.17664664387,7,5,12
jaxin,31.3120227627,4.29051522308,3,2,5
fugu,31.3086694197,4.40808667388,3,2,5
r.o.m.,31.3086379988,2.78242753872,7,6,13
king fedora,31.3067896892,1.61926772604,24,17,41
spades,31.3023144588,4.35290198247,4,2,6
mouse shampoo,31.3013158171,2.92892231349,5,5,10
ambition,31.2983046133,2.62483918632,8,7,15
doom,31.2853512562,3.99892346094,3,2,5
bbq,31.2791032445,4.03004570555,4,2,6
weston,31.2776093419,3.67007552324,4,3,7
bestfriendjohn,31.2771757438,3.39712359,5,3,8
b3n,31.271207893,4.19346485476,3,2,5
sassmaster,31.2706406718,3.3956714144,5,3,8
dayman,31.2694829418,3.55577440231,6,4,10
logos,31.2662460144,2.57111346258,8,6,14
rih,31.2640559136,3.57325156703,5,3,8
spot,31.2622066726,4.5115494807,2,2,4
root3,31.2621356511,3.06909653232,9,4,13
bork,31.2617724217,3.51565493181,5,3,8
chibo,31.2552400487,3.73018238478,4,3,7
l crimson,31.2512939753,3.18134218864,7,4,11
puncayshun,31.248783999,3.75305217655,3,3,6
geruyop,31.2465227965,2.80570063638,6,5,11
not.brian,31.242594336,4.32576610716,3,2,5
xtal,31.2374325633,4.31910441355,3,2,5
miyagi,31.2313261234,4.25109397956,3,2,5
cipher,31.2289147402,3.67942256735,4,3,7
ecto,31.2194309709,4.07950889579,4,2,6
noremac,31.2165375202,3.72671923621,4,3,7
cmac,31.2115744904,4.37657659533,3,2,5
donkey kong main,31.1880482133,3.60451232357,5,3,8
cera,31.1871993617,3.72170135794,4,3,7
golf,31.1827303133,2.75249980677,8,6,14
brand,31.1753529522,3.73154319011,4,3,7
compton,31.1719172579,4.18400898936,2,2,4
riff,31.1700560464,3.90144581096,4,3,7
shady,31.1689468613,3.38502431553,6,4,10
gndy,31.167531196,3.87850501774,5,3,8
zato,31.1647878289,3.57807127427,3,3,6
kalzu,31.1629584554,3.18576835538,7,3,10
woogity wu,31.154635766,2.81073223999,7,5,12
will,31.1535037217,2.87698366638,6,4,10
xiivi,31.1495936407,1.4897216185,30,22,52
beegs,31.1492683078,2.94085770529,6,5,11
sharp,31.1444505346,3.92208788201,6,2,8
dmg,31.1367655347,3.29281555036,4,4,8
puffmaster420,31.1324210982,3.97935367307,4,2,6
plum,31.1256587854,4.6510840703,2,2,4
hoodcash,31.1192548436,3.86328491707,3,3,6
aria,31.1186938483,2.84807849689,8,5,13
grandshrimp,31.1167053685,4.01068184375,4,2,6
joseidon,31.1117909055,3.58057429698,5,3,8
foxcapacitor,31.1020185965,2.81926789487,8,6,14
davis,31.0915459112,2.8523549112,7,6,13
alien,31.0892097663,3.69455375946,4,3,7
shwa$bb,31.0835757329,3.89502373828,4,2,6
the box ghost,31.0833902692,4.46876879492,3,2,5
sneker,31.083076201,3.98828948639,3,2,5
tk$,31.0742376057,3.87368201571,4,2,6
baise,31.0701076115,3.74845657803,4,3,7
blizz,31.0666463549,3.19005751078,6,4,10
datsun,31.0605791216,3.71894075712,4,3,7
krunkled,31.0605275558,2.75172756461,9,5,14
ted,31.0602972405,3.18343729474,5,4,9
little,31.0535743549,4.18106686728,4,2,6
ardent rage,31.0512479933,4.4826102345,3,2,5
blu-j,31.0435087137,4.13185445675,4,2,6
chango,31.0394402177,2.57340966052,10,6,16
bluecheez,31.0387501324,2.94775245894,7,5,12
jzhu,31.0368819001,3.54750799542,3,3,6
poomoj,31.0366186414,3.947620086,3,2,5
yamham,31.0328166731,2.92455596848,8,5,13
papa john,31.0319899553,4.4546203517,3,2,5
jbomb,31.0274732691,4.14251444728,4,2,6
fro,31.0258644785,4.5667014799,3,2,5
habilecho,31.0252532456,2.44946535445,10,8,18
gemini,31.0236070345,2.51808785876,9,7,16
skyreon,31.0212518649,4.03102941577,5,2,7
kirbstir,31.0203618911,3.1459269221,6,4,10
sgt5,31.0157064937,3.72664662942,4,3,7
malcodafalco,31.0093295532,2.69673402058,10,6,16
yingling,31.0067644164,3.59296109693,5,3,8
momoraine,31.0062787033,3.76739666397,4,3,7
samate,31.0039253,2.78950291887,7,5,12
plz,30.9998005155,4.03553762842,4,2,6
raoul,30.9966642671,3.47502165066,3,4,7
apeduden,30.9962899118,4.05032948804,5,2,7
razor ramon,30.9915056897,3.77829045896,4,3,7
kulczak,30.9889925691,3.27268908345,4,4,8
morpha,30.987999418,3.95405689043,4,2,6
maximus,30.9845268378,2.4231343599,13,8,21
hommsar,30.9776804668,2.88300556602,7,5,12
shriekin' desparado,30.9728487525,4.44860790404,3,2,5
yung zunga,30.9710765228,4.36238451426,3,2,5
argo,30.967930586,4.10227179171,3,2,5
beeftip,30.9634957322,4.07644383705,4,2,6
dbk,30.9624510069,3.92782653542,3,2,5
ctl,30.9608045168,3.7167998413,4,3,7
ja-fraud,30.9602867077,3.75341855652,4,3,7
wingleborg,30.9579494416,3.21771991918,7,4,11
mk.ii,30.9573942026,3.90762402872,3,3,6
deja,30.9519131164,3.57930352466,4,3,7
0kay,30.9499564015,3.67997674168,4,3,7
baj,30.9466880901,3.71226301815,5,4,9
glory,30.9458631167,3.34650843009,4,3,7
zeus,30.9445475793,4.5378235635,3,2,5
snorlaxes,30.9402999272,4.64969613647,3,2,5
boomstick,30.9377264784,3.43076193658,4,3,7
rice,30.9375091252,2.4000223495,10,8,18
joatguy,30.9355638548,3.63141402976,5,4,9
jaywalker,30.9236622058,3.3818857544,4,3,7
realdingoes,30.9184381178,3.60357157558,4,3,7
mado,30.9141903536,2.8530333986,9,5,14
bobby big ballz,30.9132925235,4.36565631986,3,2,5
burgerdon,30.9100234572,2.23198204419,11,10,21
stockholmsyndrome,30.9061747503,4.78791583166,2,2,4
booteking,30.8978461968,2.20920415977,13,9,22
kaiser-gl,30.8962972093,2.94943782632,5,5,10
shadowzw,30.8961078884,4.1270627564,3,2,5
therocketinyourpocket,30.8930235022,4.06610526025,4,2,6
lafungo,30.8918714997,3.67383978894,3,2,5
wjang,30.886240169,4.27583921699,2,2,4
schlag,30.8820717391,2.49847487424,8,8,16
braixen,30.8818700064,3.78898681235,4,3,7
crazydude,30.8769629321,3.82366063404,4,2,6
xest,30.8761509938,2.54730938729,8,7,15
emento,30.8676013698,3.19025580813,6,5,11
the fury,30.8669391512,3.48468722071,5,3,8
the lil d that could,30.8647364703,2.6630698151,8,5,13
ec_joey,30.8635230069,4.63655672935,3,2,5
ringler,30.8626885674,1.74468028287,21,15,36
a4foot1giant,30.8558536226,3.57345262828,5,3,8
the mole,30.8552705469,3.4434752448,4,3,7
tipper,30.8530716899,4.36493809051,3,2,5
yogi backair,30.8512753849,3.11537464184,4,4,8
pk_fired,30.8509801414,3.77257396399,4,3,7
phidx,30.8470787462,3.60672238018,5,3,8
stax,30.8437319449,2.92901354826,8,7,15
general tso,30.842720098,3.12817127641,5,4,9
erik reeds,30.8344486049,3.62269241469,5,3,8
cava,30.8337071737,3.02970514015,5,5,10
glitchbird,30.8306023515,3.77376988865,4,3,7
master,30.8297533467,4.45253178085,3,2,5
saiyan,30.826574748,3.80124592973,4,3,7
krizski,30.8233845326,4.32803241459,3,2,5
tyrø,30.8232124335,2.30052424275,12,10,22
igneous rock,30.8134845171,4.78868642953,3,2,5
tess,30.8080043648,4.35544484931,4,2,6
ginta,30.804546862,3.07145616323,5,6,11
smuv,30.8032871473,4.21167918664,3,2,5
dr. chekhov,30.8028451717,3.96114436708,4,2,6
zaf,30.8018425282,2.86322563359,10,6,16
runwithit,30.7890820356,4.08051238028,3,2,5
kaddy,30.7876960149,3.71650045822,4,3,7
wrackle,30.7847962087,3.33356384635,6,4,10
ganobrator,30.7842377649,3.01642849834,5,5,10
ryse,30.7798093065,2.73586567434,6,5,11
b-boy anakin,30.7758834862,4.06553405435,3,2,5
free,30.7723490938,3.81153631568,4,3,7
dizney,30.7708055635,3.95877136698,4,2,6
nagate,30.7675987668,4.32161020931,3,2,5
kal,30.7664110057,3.82997653853,3,2,5
carnage,30.7655146609,3.5913540998,4,2,6
slurex,30.7636153344,3.12953860739,4,3,7
rjw,30.7619539545,3.24114709888,6,4,10
deliciouskale,30.7575354633,4.5522898084,3,2,5
ungiven,30.7570696649,4.08906298238,4,2,6
gart,30.7458880102,2.51256655512,9,6,15
chomper,30.7407729781,3.79652263893,4,2,6
kingquiggles,30.7403022123,3.92533305049,3,3,6
jada,30.7373074163,4.41866751383,4,2,6
stickman,30.7372118435,4.33637337949,3,2,5
tse,30.7337915051,3.74457670221,4,2,6
krumm,30.7328081329,2.20139333028,15,13,28
clyvedaddy,30.7320700674,3.85714333887,4,2,6
volume,30.7320535639,3.59790467184,4,4,8
og swaglord,30.7314059871,2.56346083719,7,6,13
bawstin,30.7281770879,3.48356482181,6,3,9
billz,30.7260216824,3.79087840203,4,3,7
passion,30.7181969367,1.89915198116,17,11,28
greener,30.7177539593,4.72589770964,3,2,5
ryf1sh,30.7112387525,2.50601188058,10,7,17
slayr,30.6911248783,3.42024538918,4,3,7
badnewsbeta,30.6878047749,4.58015749377,3,2,5
borp,30.6822668516,4.12748155521,3,2,5
sacredtwin,30.6746989979,3.90327422441,3,2,5
remolinoferoz,30.6715981654,2.57852977244,10,7,17
joka,30.6711191656,4.10751439038,3,2,5
malex,30.6707216676,3.8899443227,4,2,6
ajax,30.6649617301,4.24247242411,3,2,5
rektangle,30.6631246171,4.06954304827,4,2,6
ibc,30.6594502537,2.33215148596,11,8,19
_milktea,30.6592802151,3.22486041526,6,4,10
braev,30.6568536899,1.91462617133,16,11,27
chetter,30.6431916579,3.01526132347,7,4,11
christ himself,30.6429784246,3.95121765043,3,2,5
uma,30.6359198326,4.42389341508,3,2,5
stoned toddler,30.6332479701,3.88265348137,3,3,6
ludvig4,30.6327486851,4.0069077265,4,3,7
unit,30.6317274477,3.89681265851,3,2,5
om,30.6284308044,2.29145893754,11,8,19
h3aderon,30.6273045679,4.11315835015,4,2,6
naota650,30.6256724275,3.23248969171,5,4,9
marche,30.6239699836,4.31960982386,3,2,5
fitz,30.6008607793,3.33511765696,5,4,9
regular chris,30.6004251047,4.17770287845,3,2,5
hacky,30.5987354514,2.96553827139,9,5,14
d.m.,30.5965884491,4.14983700622,4,2,6
lilo&stitchface,30.5958349895,4.43798069435,3,2,5
moriarty,30.5926377992,2.40490699957,12,6,18
4serial,30.5889643571,3.26536527148,6,4,10
glitched,30.5883657719,4.34493137545,3,2,5
phatcat,30.578784185,4.15419092571,4,2,6
toiya,30.5783314242,4.09408163907,4,2,6
n3z,30.5707433959,4.41525914932,2,2,4
snax,30.5686022414,3.08338823333,6,5,11
jedijake,30.5614390682,4.0244710761,3,2,5
calzum,30.56001041,4.24832884805,4,3,7
scrub$,30.5578086807,4.13127437459,4,2,6
force,30.5578086807,4.13127437459,4,2,6
jbvh,30.5558469771,4.15375926487,4,2,6
epic!,30.5543112376,3.43962205848,4,3,7
chzy,30.5509210809,3.60236955444,5,3,8
sans,30.5468559062,3.67123569695,3,3,6
snow wiener,30.5427963941,2.78499637604,6,5,11
bloke,30.5388441197,3.78596516691,4,2,6
icy,30.5356482827,2.98057576671,6,5,11
myfishcantswim,30.5347705853,4.27662812008,2,2,4
tanooki,30.5343718924,4.00383560672,4,2,6
shuffle,30.5339819153,2.80016645513,8,5,13
ragingcherry,30.5309445011,2.63883664232,9,6,15
zela,30.5296927298,4.47323501003,3,2,5
siddartha,30.5291937739,2.94996427725,7,5,12
timestop,30.5266109916,3.1537210584,6,4,10
andy,30.5247896816,3.72496706653,6,2,8
exbanditzero,30.5230801278,4.12040677623,4,2,6
bonsaiwarrior,30.5228647918,4.22997798921,3,2,5
g1ft v2.0,30.522771476,3.98656732692,4,2,6
ryku,30.520776568,4.15847843103,2,2,4
riddy,30.507926322,3.75059988895,4,2,6
cruz control,30.5066204955,4.38005076217,3,2,5
grognar,30.5048827025,4.68995952754,2,2,4
qtip,30.504638348,2.55463026312,9,6,15
shuckle,30.5019773086,2.61960519339,9,6,15
mar,30.500576746,3.9329695002,4,2,6
zhea,30.49922779,2.19524670627,11,10,21
btp,30.4933696812,4.03991531204,3,2,5
pyro,30.4888458904,2.41405167889,10,8,18
slush,30.4868014476,2.21096935941,11,11,22
nintendork,30.4834142667,4.84588647584,4,2,6
mair,30.4818205917,3.7262556456,3,3,6
bernal,30.4774358726,3.77765008739,3,3,6
r & r,30.4769647441,4.2016786677,3,2,5
vesetnet,30.472370604,2.16566575463,13,8,21
the___cheese,30.4720824743,3.75514026025,4,3,7
shameless,30.4683037205,3.2576597961,6,4,10
liban$,30.4649378937,4.25581650512,2,2,4
capitainemitaine,30.4607322435,3.15481012033,6,4,10
kellen,30.4552381791,3.07848000493,6,5,11
fortefreak,30.4551432741,2.98494666322,6,5,11
mikek,30.4514751541,4.1200192246,3,2,5
zap101,30.4437951059,2.32967451805,10,9,19
memo,30.4406891687,4.35772168491,4,2,6
mr. kabuki,30.4396873002,4.11342268845,4,2,6
yirumi,30.4365727286,4.07497732043,4,2,6
| b-war,30.4309146941,4.31843783403,3,2,5
evan,30.4294216255,2.68301013905,7,6,13
わっち(watch),30.4278883893,4.0224145205,3,2,5
tlo,30.4253619719,2.88107769095,6,5,11
red rice,30.4250341613,4.09944669783,3,2,5
mantis,30.4248687219,2.75482679947,6,6,12
quasar,30.4227716099,2.31915177703,10,9,19
dayge,30.4222202998,4.34504128555,3,2,5
o'boy,30.4216026782,4.32021994661,3,2,5
m00nshoez,30.4210010012,4.29588646626,3,2,5
zannthemann,30.4170578154,4.43918386945,3,2,5
maruku,30.4169507665,4.27373142984,3,2,5
zmby,30.4158518236,3.61738784186,5,3,8
dang,30.4154818792,4.12479113366,3,2,5
kidlink,30.4076751391,4.17963104761,3,2,5
zachy,30.404701831,4.11165579819,4,2,6
bloodbowler,30.4046373111,3.77841993089,5,3,8
cottons,30.4001261735,4.25811581682,4,2,6
mijo,30.3886167707,2.65998703369,8,7,15
dingus,30.3857659697,1.89188664982,16,13,29
gocutiego,30.3797593443,4.17425491841,4,2,6
pr0tein,30.3752796544,3.60421679839,5,3,8
krazy kev,30.3746968593,4.54104151417,3,2,5
pablobear8,30.3736981857,3.14026726291,5,3,8
third strongest,30.3712697694,2.91463346294,8,5,13
keon,30.3685493395,4.58023587056,3,2,5
carrierpig,30.3659822296,4.06194069403,3,2,5
simian,30.3649433826,2.79783831547,9,5,14
visualwatch,30.3644722352,2.8550937145,7,6,13
blue jay,30.3641958834,2.88132902442,6,5,11
cobbler,30.3639224763,3.79445712653,4,3,7
yocus_pocus,30.362806552,3.66395041421,4,3,7
c_rez,30.3621968434,4.10159012402,4,2,6
ecco,30.3525761364,4.04489432023,4,2,6
69%,30.3517318581,4.16504158929,3,2,5
trl,30.3516176544,4.05078277109,4,2,6
captain falco,30.3480836181,4.36108533482,3,2,5
mocha,30.347151497,3.56235560574,4,3,7
armo,30.3468465747,3.24300858393,5,4,9
loota,30.3459823455,3.78933459633,5,4,9
ol' dirty smashtard,30.336204764,3.23473692335,4,4,8
janet,30.3319041681,4.36691000909,3,2,5
firebolt,30.3286637172,3.4204736007,4,4,8
high-c,30.3278803928,2.70098928917,7,6,13
mossgarden,30.3247128645,4.36010323614,3,2,5
dashdancedan,30.3228480889,3.72387722726,4,4,8
bugatti,30.3206856707,3.58836001595,4,3,7
lockerific,30.3103529782,4.47489295569,2,2,4
c0xx,30.3037614798,3.16210541587,4,5,9
pwrup!,30.2934169144,4.36736869087,3,2,5
web,30.292111815,4.08442367115,4,2,6
saron,30.2766665153,4.47015610299,3,2,5
sambr,30.2744302989,2.47075425992,8,6,14
heliodoxy,30.2626523392,3.5194490274,5,3,8
ryuker,30.2570265115,2.76031499093,11,6,17
nintnt,30.2559578738,2.0781910615,14,11,25
flamingo,30.2550695017,3.79163455116,3,3,6
youma,30.2508314755,4.12606110772,4,2,6
pax,30.2503952084,4.19825695239,3,3,6
drynanigans,30.24982829,4.07226072736,3,2,5
ploopy,30.2433339042,4.1256046313,3,2,5
zlazher,30.2361321352,3.38291030891,7,4,11
littlebuster,30.2348053127,4.22299113645,4,2,6
drewzey,30.2320066319,2.28112502898,11,10,21
net1234,30.2306676589,4.37082881261,3,2,5
henrius,30.2256600327,3.30393039458,5,4,9
dj. dickdown,30.2208462438,3.56155215358,5,4,9
androyd,30.2144947037,4.45092970823,3,2,5
mariopartywbeer,30.2136492636,3.36858001205,6,4,10
sedimentary rock,30.1962799295,3.6242489483,4,3,7
darkwizard123,30.1845958268,3.50302069813,4,3,7
marshdog,30.1813342612,3.88593086456,3,2,5
cake,30.1808836503,3.81228983409,3,3,6
jonas,30.1765582496,4.33144574669,4,2,6
foolz,30.1744779942,4.3411278382,3,2,5
cuno,30.16906171,3.52941029059,4,3,7
runescape,30.1628056593,4.36951980347,3,2,5
near,30.1576783778,3.05765220881,6,5,11
ac_anon,30.1540907493,4.34014351455,4,3,7
d,30.1466789161,3.1125785196,5,5,10
captain schfifty,30.1454523416,4.35573696218,3,2,5
moonpanda,30.1427262983,4.39138479086,2,2,4
danil,30.1422977577,1.67182701045,25,17,42
rain,30.1363029235,2.75481986963,7,6,13
semi,30.1334561968,4.45012267632,3,2,5
toshi,30.1263917565,3.65190537602,3,3,6
vavez,30.125004115,3.80360158121,3,3,6
dirty mike,30.1248748517,3.92564113282,4,2,6
jecht,30.1204812339,3.38661695979,4,4,8
trixter,30.116148196,2.49446693562,9,7,16
jakespeare,30.1157438554,2.1876023007,12,10,22
madtsunami,30.1156326768,3.50135247684,5,3,8
mvzy,30.1130042493,3.56200162066,5,3,8
saint driven,30.1127832035,4.17711126288,4,2,6
cortex,30.1118128366,3.31244374419,5,4,9
yih,30.111743419,4.07270759544,4,2,6
mc david,30.1103682327,3.41975939388,6,4,10
aguos,30.1014886965,4.24874801225,4,2,6
got em,30.1013456782,4.05298977803,4,2,6
taba81,30.0970299872,4.76028232572,2,2,4
dynamic,30.0902606448,3.97747118985,3,2,5
dingo,30.0894514073,2.60006234786,8,8,16
niklas2912,30.0893513691,3.92242611095,5,2,7
hadoken,30.0861732578,2.77370331381,8,4,12
asura,30.0849830216,4.40022476963,3,2,5
cdoe,30.0800697982,4.33673386692,4,2,6
insomnia,30.0765738609,4.64486606564,3,2,5
timesink,30.0754256268,2.84266036458,5,5,10
k27,30.0715001219,3.08819108445,5,5,10
dep,30.0709538138,4.12910569848,4,2,6
birdlordmasterbeak,30.0671290248,4.01330309175,4,2,6
pride,30.0589331085,3.16218232009,6,4,10
gayluigi,30.0550193809,3.32740358625,6,4,10
noghrilla,30.0518498421,4.82419308975,2,2,4
khadia,30.0499797596,4.32980647015,3,2,5
agi,30.0458309584,4.40075436229,3,2,5
joebigs,30.0456808566,2.92225852156,7,6,13
magicalhatsdx,30.0410897863,2.82469522255,6,5,11
jackets,30.0345126048,3.78302792073,3,3,6
ragnarock,30.0344045815,4.1934958666,3,2,5
infernalcolonel,30.0207703268,4.33499021493,3,2,5
941cs,30.0197284748,4.3777020004,3,2,5
asl,30.0186052502,3.53145906792,4,3,7
samjacobs1,30.0179417885,3.60442436554,3,3,6
linksta,30.0135244942,4.49420051415,3,2,5
the end,30.0110608869,4.19985526258,3,2,5
p.body,30.0028451833,3.87405102295,3,3,6
wind,30.0011780385,2.40365305523,9,9,18
eg0r,29.9990423759,4.4531884873,4,2,6
jonny gumball gamble,29.9977009693,3.37736535294,3,3,6
shrip,29.9965624567,4.34497031795,3,2,5
wezl,29.9911293752,5.15677625034,2,2,4
idk,29.988816758,4.36216372456,3,2,5
hondafoo,29.9872222099,3.32001306219,5,4,9
ryze,29.9766364506,4.34237331863,3,2,5
mordicon,29.9741279382,3.89932008795,4,2,6
stormtrooper,29.9667705759,4.29738935308,3,2,5
adamkex,29.9666032313,3.02365379291,7,5,12
perryg45,29.9603729505,4.37535939435,3,2,5
prosmashertim,29.9581666843,3.71089062523,5,3,8
big dick bandit,29.9553616224,3.25324443958,6,4,10
cup,29.9507528923,2.60667626657,8,6,14
aubfox,29.9448231535,2.95481810036,7,5,12
enderdxg,29.9447556257,4.31060182125,3,2,5
emz,29.9350401025,4.31319601672,5,2,7
irish,29.933890547,4.37690691061,3,2,5
soapsuds,29.9303634622,4.26044831481,4,2,6
rivers,29.9249354647,2.38488798299,10,9,19
jays on my feet jordan,29.9187693483,4.61573798813,3,2,5
spoonfullofpasta,29.913222482,5.17716150043,2,2,4
crip,29.910567443,3.63469145687,3,4,7
pav nasty,29.9102850821,4.59465889898,1,2,3
foxnard,29.9078552746,3.70901055648,3,3,6
hg-swizzlesnacks,29.9052010625,3.30934307419,6,4,10
ten,29.9039029038,2.15496763909,11,11,22
941,29.9016223016,3.99875901617,4,2,6
southballz,29.8986291103,5.04201063656,2,2,4
remioli,29.8864558291,3.1482260907,7,4,11
paintman,29.8798792119,2.87280366568,7,5,12
wonder,29.8793542521,4.1809611055,4,2,6
saba,29.8777788276,3.10252941711,6,5,11
ch0ice,29.8672859819,4.73525066521,3,2,5
fooly,29.8647057946,3.59964685631,3,3,6
nard dogg,29.864676521,2.35502754129,13,7,20
odderon,29.8611665783,3.86295975476,3,3,6
irs,29.8606588798,2.99092026169,8,5,13
jp,29.8587420475,2.93351550161,6,7,13
sebovich,29.8499768647,3.89909283174,5,3,8
tauvalian,29.847244123,4.52934629405,3,2,5
purple sku,29.8472168667,4.28064051686,3,2,5
xyk,29.8460681099,4.65146758179,2,2,4
nomad,29.8420188938,2.57003642194,7,6,13
smirked,29.8392793914,3.45281940951,5,4,9
slik,29.838998117,4.26040660705,4,2,6
2dollarslices,29.8356333755,4.38375711418,3,2,5
lahti,29.8276665521,4.08975902711,3,3,6
veggietales,29.8258937832,4.26289935906,3,2,5
bbc,29.8242685265,4.48477925335,3,2,5
keo,29.8229076073,3.37973252827,6,4,10
fliinchy,29.8223145365,3.74485393323,4,3,7
kyza,29.8215410546,3.95882245027,4,2,6
shmeetah,29.8205347724,3.70710423051,4,3,7
grim,29.8204394132,2.87876123929,6,6,12
fancey,29.8180950892,3.98662144179,4,2,6
redcoat,29.8159156665,3.57134235463,4,3,7
kelly,29.8153986933,4.32278524015,3,2,5
5-1,29.813191368,1.99750391593,14,10,24
risen,29.8130079859,3.35563911123,4,3,7
docmo,29.80510595,4.41968115391,3,2,5
lldl,29.8043022016,4.21128912264,3,2,5
orange,29.8015153163,4.88809947194,3,2,5
jiggy,29.8004146189,4.18981270417,3,2,5
konati,29.7969776927,3.13598351576,6,5,11
stereotypicalmexican,29.7952371726,4.26891882814,3,2,5
leet,29.7942462093,3.48466282764,4,3,7
jib,29.7913509885,1.82335322412,19,14,33
timpz,29.7878839023,4.3583023981,2,3,5
c-bass,29.7876134984,4.16631276901,3,2,5
cobby,29.7796064878,4.21421086808,3,2,5
dracula,29.7793197796,4.38994890406,3,2,5
valioes,29.7779081899,4.29739039517,2,2,4
draz,29.7762975569,4.5252466575,4,2,6
heartbreaker,29.7755746929,4.2518357909,2,2,4
jbluray,29.7742037208,4.12926796641,4,2,6
toodee,29.771934648,4.59837028825,3,2,5
ctm,29.7712591363,3.06427134586,6,5,11
kape,29.7692962474,3.06362128358,7,4,11
suezo,29.7672008924,2.4611479198,10,8,18
pots,29.7639712249,3.13124487834,6,7,13
pimp jong illest,29.7619835989,2.84058805989,7,6,13
shadow,29.7591243732,3.99962971174,3,2,5
big t,29.7571344728,4.75564513889,2,2,4
duo,29.7565386614,3.48362520964,4,4,8
rfs | | the  cheat,29.7530111493,4.35145907437,3,2,5
anthony,29.75134247,4.22326004605,3,2,5
dzd,29.7511072286,4.35814595264,4,2,6
drew2king,29.7508419064,3.12544397773,5,5,10
hive,29.7506437396,4.03200946669,2,2,4
typhoon,29.7492785364,4.12649999275,4,2,6
gus,29.7318521876,4.25340160427,3,2,5
eradicator,29.7294250501,3.19686528661,5,4,9
issi^,29.7293266109,2.98924226658,8,7,15
krut,29.7235337153,4.23912181759,5,2,7
ego,29.7158535683,4.71317694049,3,2,5
nintendoking,29.7118216621,3.55506072679,3,3,6
brandingo,29.7106406121,4.52155858213,3,2,5
jakx,29.7043443672,4.58282757172,3,2,5
haiyaku,29.702742388,4.09751684269,3,2,5
rusty shacklefurd,29.7004979646,2.78826436279,6,5,11
mongoose,29.6862545705,2.25009052132,11,8,19
blueguy,29.6832445616,4.39799392802,3,2,5
zeppx,29.6818891776,3.32491113976,6,5,11
munch,29.6715299448,3.18394608711,5,4,9
macgruber,29.6638596147,3.91627364964,5,3,8
dain bramage,29.6628687381,3.34985132355,5,4,9
k,29.6560770514,1.9827507787,12,13,25
answer,29.6490081239,3.33402666364,6,4,10
ringedge,29.6486990383,3.38705475483,3,3,6
tehpinkemobunni,29.6467891665,2.63453671209,9,7,16
memory,29.6386279209,3.88507704909,3,3,6
thebigopness,29.6369511326,4.40870813848,3,2,5
mt. crushmore,29.6272855371,4.523887689,2,2,4
ghidra,29.6271675378,4.2123036236,2,2,4
tippered,29.6264407463,4.30520721151,3,2,5
2shotko,29.6248277695,3.37665489713,5,4,9
tee knock,29.6248126923,3.28387759135,5,4,9
pusheen queen,29.6184241127,4.78493411086,2,2,4
goo,29.6126802034,4.46441483825,3,2,5
thecivilyoshi,29.6094266438,2.96052950799,6,5,11
kwik,29.6050901079,4.32009892943,3,2,5
dannypaguiao,29.604657158,4.3599435698,3,2,5
fancy,29.602258357,3.0934903915,5,4,9
grabsomeeyes,29.5888882637,4.75600866295,3,2,5
hert,29.5841313426,5.29423046587,3,2,5
sudo,29.5783844348,3.92915522992,4,2,6
hrctypo,29.575572837,2.88600885278,7,6,13
killablue23,29.569283155,2.55711220112,9,7,16
gh0st,29.5686152303,3.42151399714,5,4,9
yeroc,29.5613556319,1.88276170343,14,15,29
one_trickpony,29.5611564545,4.3349322479,2,2,4
ryko,29.5568522084,3.43911677006,5,4,9
kestrel,29.5540078993,4.4383629222,3,2,5
pikablu,29.5501760144,4.2582350755,3,2,5
mind assassin,29.5483401628,2.60170823141,7,5,12
grandma's cleavage,29.5294518431,3.45833865223,4,4,8
ron paul,29.5272923143,3.6364611845,4,3,7
kore,29.5257838796,4.01317055663,3,3,6
emil,29.5237857801,2.65273095444,8,6,14
zamma,29.5232027521,4.24156231804,4,2,6
lots,29.5210818313,4.42346758864,2,2,4
kamiyazaki,29.5196322171,4.14452852561,4,2,6
enemy,29.5184736552,4.86296367775,3,2,5
don,29.5163416027,4.128889109,4,2,6
matthijs,29.5108573573,3.13586663144,5,4,9
rob$,29.5061402343,4.71368013113,3,2,5
death arcana,29.5040671032,3.12572710794,6,4,10
wndy,29.5034263835,2.08579785823,13,10,23
marquee,29.5026288529,4.42898157201,4,2,6
kvn,29.4996591137,3.17135168789,6,6,12
cwhit,29.4872228454,5.53005211141,1,1,2
forerunner,29.4868794365,4.86242928249,2,2,4
ozumi,29.4853902981,4.41203853561,3,2,5
magikarp,29.4852509844,4.34505598355,3,2,5
mr. manager,29.484412242,4.46254464953,3,2,5
travioli,29.4821473143,3.48754291447,3,4,7
lion,29.481233347,3.18440143321,6,5,11
burnt out ninja,29.4795987474,4.25606817444,3,2,5
spy,29.4794682755,4.34281679405,2,2,4
joel,29.4763323776,4.46651894907,3,2,5
narps,29.4744745879,3.86273300291,4,2,6
nuckels,29.4687916132,4.30274174139,3,2,5
ambisinister,29.4652223445,3.53512891646,4,4,8
wobbaduck,29.4627313195,4.19552630954,2,2,4
bun,29.4599346695,4.74669886325,3,2,5
raisin,29.4553728096,4.17330510379,4,2,6
dublin,29.4501307096,5.08666733185,3,2,5
karils,29.4464444146,3.49104638477,5,4,9
beanwolf,29.4453960621,4.461251525,3,2,5
darkgenex,29.445003525,2.33540547122,12,8,20
kuhls,29.4447517712,3.85802772147,5,3,8
schmep,29.4396100185,4.16113906915,4,3,7
reggie,29.4342105379,4.36643124041,3,3,6
elu,29.4276998277,4.49808244343,3,2,5
gimr,29.4212847298,4.60220303075,2,2,4
wawa,29.4186547227,2.9924907578,6,6,12
roma,29.4180317428,3.29656926452,6,4,10
kickpunch,29.4160874338,4.16546758872,3,2,5
toastrider91,29.414037573,4.45046654492,2,2,4
hotline,29.4098488823,3.7530812472,4,3,7
nala,29.3986506806,4.13024071061,3,2,5
joanna dark,29.3976598361,2.47490103305,11,8,19
big d,29.3959650956,2.81597805456,7,5,12
uncle onion,29.3957302793,4.45555042213,3,2,5
lildemon,29.3949715023,4.04704744421,4,2,6
davemon,29.3890504126,3.42015997322,5,3,8
king potato,29.3760867169,3.08122817627,7,6,13
b vu,29.3710293368,4.34637640838,2,2,4
magitech,29.3697642746,4.19466776605,3,2,5
kratos,29.3628281541,3.07991810328,6,4,10
mithos,29.3615272633,4.49741958376,1,2,3
mexx,29.358549325,4.80518989994,3,2,5
saucytho,29.3558408882,4.63581891874,2,2,4
bluefalcon,29.3514209183,3.47600997348,5,4,9
tenwa,29.3407764393,3.40986088458,7,4,11
koschka,29.3388486988,4.46046200393,3,2,5
ooshii,29.3386324044,4.32088181624,3,2,5
50 quid,29.3379909885,4.22812505074,3,2,5
greenwalk,29.3376614645,2.50974671103,11,7,18
eight oh eight,29.3355073749,3.00278563644,7,4,11
socks,29.3302407408,4.3438899175,4,2,6
alliecat,29.3266772702,2.35829632837,13,8,21
thimo,29.3233513056,4.52740772946,3,2,5
egman,29.3218097914,4.5826356173,2,2,4
dansofree,29.3209285777,4.28310031684,3,2,5
sheep,29.3195837348,1.72449882248,18,17,35
freessbm,29.3144764001,4.31362105682,3,2,5
ansuke,29.3144188184,3.11461831436,6,4,10
jopri,29.3132000831,4.61764064796,3,2,5
sapoc,29.3027690604,3.86897929034,5,3,8
hunt,29.294162256,1.83601056323,16,14,30
dreams,29.291737371,3.2732134988,6,4,10
null,29.2768695127,2.76617911197,6,6,12
seabass,29.2760356195,2.13542994148,11,11,22
ludderix,29.2745181017,3.83736035791,4,3,7
wolfeye,29.268684615,3.18622724309,6,4,10
bagelz,29.2684220762,3.72614576378,3,2,5
drjwns,29.2683051773,3.52635593641,4,4,8
deku,29.2639109944,2.24094956428,14,8,22
jakpox,29.2607845297,3.01335836184,7,4,11
rpg,29.2574313448,4.67168047354,4,2,6
tonight we feast,29.2533989167,4.32530511987,4,2,6
slag,29.2516603958,3.12827034263,6,4,10
chaitea,29.2477623396,4.28531506936,3,2,5
citius,29.2434399897,3.72600551339,3,3,6
sabelan,29.2430514899,2.40585119839,12,8,20
kid fantastic,29.2410550444,3.98189202812,3,2,5
mrboffo,29.2376313128,3.90208717635,3,4,7
gunhaver,29.2310322486,2.95633361963,7,5,12
petery,29.2285502334,4.45625774145,3,2,5
krusty kurt,29.2268331528,4.6046817042,2,2,4
sonofashepherd,29.2267965712,4.76643963525,3,2,5
freky,29.2255583056,2.5367204071,9,9,18
hoogie,29.2223024674,3.68272346407,4,4,8
captain neckbeard,29.2213535204,3.98963962021,3,2,5
thomdore,29.2148769096,2.78897622948,10,7,17
manny2bukakke,29.2140441115,4.10962907909,4,2,6
bernz,29.2088414449,2.85541830872,7,5,12
mama's little baby,29.2011367399,3.4390342008,5,4,9
metallix,29.2000745633,3.70450442221,5,3,8
super fang chan,29.1949705331,2.67641913627,7,6,13
ahmad,29.1906571018,4.44055492145,2,2,4
locke,29.1885356381,3.99488058977,3,2,5
liva,29.1866916156,3.89163338015,3,2,5
sith lord sauce boss,29.1864486322,4.04763643906,3,2,5
notmitch,29.1828351058,4.10076529189,3,2,5
cronus,29.1762379895,3.5090390939,5,4,9
rileyreads,29.1710016547,4.64763334678,2,2,4
mcswanky,29.1703737512,4.64206752726,2,2,4
wonderbread,29.1700973291,4.42086257865,3,2,5
zhawntiger,29.1698715705,4.02254538232,3,2,5
spitzy,29.1690830941,3.67101530521,6,4,10
gman,29.1478670924,3.48413108673,5,4,9
jury,29.144168494,4.35568413004,2,2,4
triple c,29.1428851415,4.51866162974,3,2,5
relno,29.1397491133,4.33998277627,3,2,5
full metal jarod,29.1389547376,4.37709335839,2,2,4
charlie,29.1366410304,3.24815713876,4,5,9
kdbt,29.1365602704,4.78827425455,1,2,3
tas,29.132259976,3.85322203468,5,2,7
roko,29.1308979308,4.4704508332,3,2,5
krax_,29.1202654948,4.45655160923,3,2,5
phenoz,29.1135001958,4.34623853524,3,2,5
panduhz,29.1100744689,4.35441870797,3,2,5
luxy,29.1086021382,2.58402504956,9,6,15
dimsum,29.1067997567,3.49503332577,6,4,10
wisely,29.0998248769,3.54285465659,5,4,9
real dingoes,29.0995836793,4.05334140376,4,2,6
pog0,29.0990942529,3.18576287795,6,4,10
beefcake,29.0941597492,3.44793212874,5,4,9
kal-el,29.086484221,2.74857919941,8,7,15
drugfreechu,29.0846978784,2.73094083611,6,5,11
homestar,29.0817204561,4.12202814719,4,2,6
kenpachi,29.0786257115,2.23777354163,8,11,19
rooster,29.0760381928,2.10059399423,12,11,23
ybot,29.0749923801,3.21698573169,5,3,8
citizen snips,29.0746113646,3.36715606129,5,4,9
zemcitrus,29.0681780997,3.31220763028,6,4,10
juna,29.0676905976,3.47022345272,3,4,7
xanmor,29.0575647538,3.81933736476,4,3,7
quantum_x,29.057511678,4.77910503644,2,2,4
marlwolfe,29.0539191314,4.42134914682,3,2,5
sebson,29.0504036164,3.05129192533,7,6,13
akt,29.0499810425,4.45132093334,3,2,5
dax,29.0496190859,4.21908841939,3,2,5
scoopy,29.0475782931,3.06207715846,7,4,11
kfj,29.0451799889,3.68031461879,4,3,7
2 johns,29.0446935042,4.04292954054,3,3,6
sway,29.0446096467,3.64271698507,3,3,6
fizzi,29.0434050831,2.45959797692,10,8,18
akiva,29.0416895805,3.20776530501,5,4,9
mr.watchandlearn,29.0407165461,3.392484832,4,4,8
sealand,29.0360743274,4.3159807083,3,2,5
el pollo flaco,29.030063667,4.47450102004,3,2,5
hea7,29.0271217144,4.52302441006,3,2,5
seal,29.0253758119,1.95911081949,12,11,23
mw,29.0205992084,4.69185647531,2,2,4
jesus,29.0193441234,2.87997285859,7,6,13
matticus,29.0163989855,4.62685456631,2,2,4
omadon,29.0149102697,4.1428088557,4,3,7
hara,29.0111471503,4.23412595334,4,2,6
glaikit,29.0103220651,2.83302056405,7,6,13
yohobojoe,29.0054193505,4.02163039976,4,3,7
mf mike,29.0035667514,4.47513872565,2,2,4
panic,29.001679299,2.49802255911,9,8,17
starman,29.0011155204,4.50754391822,3,2,5
childishsensei,28.9991549313,4.26291401442,3,2,5
polar,28.9932445989,4.2969010749,3,2,5
reslived,28.9895950852,3.63540356768,3,4,7
shlomer,28.9862695736,4.27720897215,3,2,5
ders,28.9790776509,3.49461912262,5,4,9
macintosh,28.9772643266,4.41951752707,3,2,5
andonuts,28.9754574315,3.22599884236,6,4,10
orbit,28.9646856981,4.53154585415,2,2,4
treble,28.9622248263,3.16850463206,5,4,9
genoblast,28.9589861836,2.92044953365,5,5,10
asuka!,28.9576809238,4.42625674355,3,2,5
thef,28.9548105571,4.401032544,3,2,5
babybird,28.9511706898,4.35320637938,3,2,5
brizzy,28.9458961446,3.43079664496,5,4,9
capone,28.9458656181,2.60984843643,8,7,15
ewd444,28.9431420489,4.59193958005,2,2,4
wavy j,28.9415590232,4.16694372354,3,2,5
f.lux,28.9401385377,4.64669317859,4,2,6
breachin,28.9393160974,1.73949661578,17,14,31
renke,28.9390063225,4.60932431338,2,2,4
mgmg,28.9386413655,4.70442492445,2,2,4
wizard,28.9357668305,3.37582027107,6,4,10
krispysmooth,28.9356036613,5.19476369882,2,2,4
zan,28.9334800368,3.10803890311,6,5,11
vite,28.9326800593,3.6469471518,3,3,6
the yak,28.9273649508,3.93441631364,3,3,6
kev$,28.9263115104,4.1796976157,3,2,5
metric,28.9241506541,2.72382843524,7,7,14
tangmang,28.9218880684,2.81522339429,7,6,13
burlap,28.9216521028,4.30461228607,3,2,5
pip,28.9209100567,2.76289030665,8,6,14
1grabman,28.9202406787,4.28365960436,3,2,5
toa,28.9187754353,3.57906748997,7,4,11
yohosebastion,28.9152672293,4.51503214893,2,2,4
sir illiam,28.914963409,3.1250414082,6,5,11
cucco puffs,28.9116907579,3.78672657443,4,3,7
coda,28.9085651043,4.25135627034,3,2,5
smoe,28.908020683,2.47680683692,6,8,14
toy,28.9015325221,3.92710270612,4,2,6
ovenn,28.8977263383,4.5124554262,3,2,5
jerem,28.8945459827,3.62965886456,2,4,6
kunai,28.8941401425,4.06961744422,3,2,5
pureevil,28.8902497837,3.73284537329,2,4,6
light,28.8894393894,2.21120894966,13,11,24
gwabs,28.8885193785,4.38656148548,3,2,5
super,28.8868006767,3.45695091821,5,4,9
pokno,28.886334059,4.39146738507,3,2,5
eru,28.8843997853,4.69001920362,3,2,5
animeh,28.8830937526,4.28456133206,2,2,4
snivy102,28.8818797874,4.45699465678,3,2,5
k8a,28.8806666963,4.31467499618,3,2,5
slow,28.8802065228,4.43997926569,3,2,5
vomjom,28.8753757172,3.03618694729,6,5,11
jackie,28.8707032407,2.77458842531,10,6,16
xeno,28.8695123411,2.75206756558,6,6,12
tron,28.868727188,3.09879316668,5,5,10
bozo the fox,28.8683538986,5.23959202607,2,2,4
strega,28.8652813055,4.41294108031,3,2,5
yung bones villain,28.8651128225,2.87061068349,6,5,11
santa,28.8629774289,2.60939217938,9,8,17
kyo,28.8541083455,3.82032043306,3,4,7
truckasaurus,28.8539100978,4.31015956787,3,4,7
wheels,28.853604593,4.05417672227,3,2,5
hex,28.8513594283,3.03394939346,4,6,10
figment,28.8503905906,4.77800277494,2,2,4
disciple,28.8454026713,3.87381115793,4,4,8
iycewynd,28.8425772667,4.81434461471,3,2,5
goobershadow,28.8425328251,2.06345537711,13,12,25
g~man the cosmic destroyer,28.8387056502,3.88301590873,5,3,8
cniu,28.8298746151,4.33245415872,3,2,5
100 grand,28.82703569,4.63833890922,2,2,4
urbanlime,28.8235493411,3.5834857957,4,4,8
nth,28.8140722453,4.49013832301,3,2,5
sickolas,28.8089803427,4.26917618426,3,2,5
rebaz,28.8048309845,3.72736228919,4,4,8
trevman,28.8034936302,4.36485471378,3,2,5
para,28.8008517992,3.87459152724,3,3,6
zeta,28.7999307625,1.95865472224,16,14,30
cranberry,28.7944051944,4.62227656948,2,2,4
drinkingfood,28.7933952982,4.63971486589,2,2,4
jwalker,28.7901148298,3.50146258391,6,4,10
supahot,28.7895646796,4.58241854008,2,2,4
$nooze,28.7859036104,3.53271625871,5,4,9
tdp,28.7768343608,4.30231378046,2,2,4
sephyrate,28.775139277,3.94024051099,4,2,6
kneedoking,28.7731081662,3.9856539218,3,3,6
gosu,28.7719281315,3.09750927699,6,5,11
deep c. squid,28.7663508919,4.44253929838,3,2,5
dapper,28.7658406912,5.64790317696,2,1,3
phrigid,28.7642171183,3.33179275037,4,5,9
bottle opener guy,28.7595139437,3.5307052564,5,4,9
taze,28.7554536312,4.79887904078,1,2,3
marriott moy,28.7522887587,2.05607714049,11,12,23
nugget,28.7504281267,2.65015302685,9,6,15
c j,28.7492947437,2.97117444757,4,5,9
syphichan,28.7464322238,4.42520824891,3,2,5
dahl,28.7460708676,3.3710382652,7,5,12
parcheesy,28.7432807603,5.40660207222,2,2,4
dlos,28.741748246,3.54271112264,5,4,9
avarice,28.7414460979,4.57638222942,2,2,4
absolome,28.7368369773,4.46504802505,2,2,4
freeshampoo,28.7360585368,4.30575005576,3,2,5
seen,28.7347381383,4.38017638142,3,3,6
haffaz,28.7338976663,4.49057053509,2,2,4
dickey,28.732024518,4.86637073091,2,2,4
belgish,28.7308319174,4.98193305958,2,2,4
gaz!,28.7217865609,3.11528231244,5,6,11
neal,28.7209343571,4.25012966638,3,2,5
sir skaro,28.7201129742,3.42177715056,5,4,9
d. disciple,28.7189699136,2.31173392909,13,9,22
madman,28.7168036169,3.3994644274,6,4,10
wakka,28.7149108671,4.45229700969,3,2,5
p2thedr,28.7059116134,4.4452890399,3,2,5
thane,28.6998219483,4.00910754855,4,3,7
flerr,28.699052227,4.38287227577,3,2,5
jake peskin,28.697694793,3.15828337812,3,5,8
zbet,28.6953666356,3.90653759944,3,2,5
g pipes,28.6859051736,4.15063685347,3,4,7
x,28.6848670881,3.50590814166,5,4,9
noodleincident,28.6840644191,3.85503438232,3,2,5
halzyn,28.6810714794,4.4431574077,3,2,5
kilo2dxx,28.6798456954,4.39169071558,3,2,5
pants,28.6755430052,2.88759126249,7,6,13
unoriginal,28.6702606877,2.14935452989,12,12,24
trapsloth,28.6684925819,3.50888941737,4,5,9
schnurb,28.6667146012,2.47183934502,8,8,16
2shadez,28.665622049,2.0822963628,13,11,24
pdk,28.6639868974,3.45752142368,4,4,8
):,28.6604279784,3.13611668797,5,5,10
bair,28.6581634524,2.79696322431,7,4,11
sir z,28.6568794656,3.87395770624,4,2,6
yink,28.6550886092,4.24300603923,3,2,5
fathertime,28.6507305176,4.43853966318,3,2,5
daddy's milk,28.6474398894,2.99216959417,7,5,12
wryr,28.6363904694,4.48043568105,3,2,5
hoogsen,28.6355928752,4.69507665397,3,2,5
purps,28.6355557894,4.29382905823,3,2,5
klutzy klutch,28.6348723458,4.9463554375,2,2,4
jazzawockee,28.6327758031,4.45531380802,3,2,5
yami,28.6306907795,4.6191274019,2,2,4
soju,28.6297548879,3.18500143132,6,5,11
bevan,28.6258369491,3.37548931858,5,4,9
vt stickman,28.6219192482,4.1184794908,3,2,5
jagz,28.6149210335,4.66511652859,2,2,4
riff [harpster],28.6146156621,4.44352248079,3,2,5
isafestrafe,28.6126770303,4.46620032838,3,2,5
miqi,28.6111872633,4.32495225844,3,2,5
wok,28.6105445626,4.54805862196,2,2,4
nigo,28.606594072,4.8647357537,3,2,5
nair-b,28.6048269562,4.38428023339,3,2,5
chiefcherry,28.6033920537,4.43735706952,3,2,5
chrisrn,28.600130485,4.33596977041,3,2,5
cakeassault,28.5969979859,4.51995049981,3,2,5
yark,28.5935245826,4.48506845967,3,2,5
darkwolf,28.5923039618,3.83371732102,4,3,7
cubansandwich,28.5908476374,4.92433224204,3,2,5
thoobs,28.590068566,4.30393926244,3,2,5
seaghost,28.5886468901,2.2630888605,11,9,20
squeg,28.5863623951,3.81416122688,4,2,6
sass,28.5850512184,5.6880356262,2,1,3
iamcreditcard,28.584499034,3.48241517382,5,4,9
brail_l2k,28.5839517175,4.4764629891,3,2,5
jiichan,28.5806412942,3.81686781911,4,3,7
pinkfluffycuddlebunny,28.5769772869,4.41533739955,2,2,4
nb2,28.5762727267,4.37580605875,3,2,5
rudo,28.5755532692,3.56864373871,5,4,9
suntherion,28.5750830234,4.0909794534,4,3,7
red sheik,28.5724100357,4.27411935372,4,3,7
shk shk,28.5698812231,2.96449633995,7,5,12
zeal,28.5573552635,1.76366437562,19,16,35
batterybird,28.5537112803,2.94690999173,6,5,11
zuluking,28.5518373477,4.34949067409,3,2,5
night,28.5492168421,4.28624321587,3,2,5
lyme,28.5481559437,3.33169800802,5,4,9
cola,28.5466670588,3.50187961534,5,4,9
moe,28.5450472533,4.12597401752,4,2,6
tangerine,28.5440204836,4.37096343109,3,2,5
ant,28.5436695314,2.95881413662,4,5,9
dodge,28.5410602426,4.32296375725,3,2,5
bunbun,28.5400325001,4.49516453655,2,2,4
fish$auce,28.5341630532,4.37555170369,3,2,5
p0pe,28.5265598393,4.96583934299,2,2,4
volton,28.5240931656,2.16900969735,9,10,19
dano,28.5237346819,3.08327032723,5,5,10
skywalker,28.5234308771,2.70171136155,8,7,15
wumpus,28.5179611862,3.56287398997,5,4,9
pepsi,28.5175261094,2.04467501802,13,10,23
rabbit,28.5093297306,2.71665596435,6,7,13
phax,28.5078899705,4.53021780159,2,2,4
burr,28.5069402055,4.35645773559,3,2,5
mister dawson,28.4999359628,3.38331537963,6,4,10
jaybird klutz,28.493875194,3.35305692352,6,4,10
dinowulf,28.4907495347,3.23905452565,4,4,8
banyoshi2015,28.489285577,4.4728620475,3,2,5
nomis,28.4867353822,3.81480210165,4,3,7
mpk,28.4794536459,4.03542823017,3,3,6
lil brown,28.4766817658,4.98620574155,2,2,4
jedi master kushala,28.471019358,4.00953662312,3,2,5
clubs,28.4695235478,3.47336104719,4,4,8
dragedo,28.4677937152,3.10452547575,5,4,9
villain,28.4670321258,3.64559670037,3,4,7
sartoris,28.4645500239,5.04036412489,2,2,4
spire_fan,28.4617207091,3.03362191322,5,4,9
skylan,28.4616549069,4.38547334144,3,2,5
rayburn,28.461638223,4.50992995254,3,2,5
phantom,28.4598522108,3.85295165967,5,4,9
22k,28.457557611,4.36758993198,3,2,5
aqux,28.4573734376,4.81488717884,2,2,4
picofarad,28.4567529749,3.55436800099,5,4,9
eastea,28.4479709313,4.47492476915,3,2,5
nml,28.4462286669,4.49863420645,2,2,4
tree,28.4459901675,3.10643718449,5,5,10
hestoned,28.4458813299,2.0627174582,15,10,25
nav,28.4445630426,3.19575327737,7,4,11
japf,28.4394619076,3.02349085798,9,5,14
poskii,28.4366032527,3.10774869533,7,6,13
atrioc,28.4327997952,3.10953528241,5,7,12
melpyx,28.431216872,3.82024376565,4,4,8
oh,28.4304148521,3.68788752791,4,3,7
josniff,28.4136564151,3.12400653375,7,5,12
aaronscaring,28.412698999,4.40220107342,2,2,4
soswaggie,28.4106099684,4.29175422565,4,2,6
jahanni,28.4087641764,2.9037915901,6,6,12
squil,28.4065691572,4.74673241682,2,2,4
scoback,28.4024327695,4.56859077825,2,2,4
picassu,28.3960215664,4.40803807582,3,3,6
n1ck,28.3893510817,4.43623218282,3,2,5
dojo,28.3804605659,4.61374366167,2,2,4
babycakes,28.376180271,3.82135629423,5,4,9
life,28.3760624513,1.96286991808,13,14,27
steiner,28.3728422196,4.51383793119,3,2,5
goldman snacks,28.3703385301,3.19585869242,4,5,9
tarchwood,28.3689001359,2.47372565914,9,8,17
parmsib,28.3650576574,4.8672122177,3,2,5
cross,28.3642867379,4.28001999619,3,2,5
zíng,28.3636954157,2.41541326677,9,10,19
tootmoses,28.3583761975,4.44813057501,3,2,5
shabman productions,28.357275923,3.45736968783,5,4,9
altodor,28.3564541031,4.35159588395,3,2,5
di guy,28.3520135738,4.34534213085,3,2,5
phobos,28.3472699369,3.71006452242,4,4,8
zepherz,28.3471676273,4.59849699527,2,2,4
unlucky,28.3415869538,4.09745279631,3,3,6
zander,28.3302354125,3.37037424641,5,4,9
kamikaze,28.3191530575,3.54438093778,4,4,8
nice climbers,28.3183315319,1.66611167895,18,19,37
wiseclown,28.318045583,4.64902992505,2,2,4
rarik,28.3169328038,4.78258948081,2,2,4
super ginger,28.3141456185,3.25492676203,5,5,10
iroh,28.3124215947,4.66814126823,1,2,3
szapat,28.3110079795,3.52801960425,5,4,9
karenradish,28.3108913881,4.30164764615,2,2,4
glaz,28.3084403291,4.73431086683,3,2,5
charlezard,28.3068058727,3.13287651237,6,4,10
asianson,28.3062473386,3.24919838744,4,4,8
hype!,28.3050996801,4.43933491835,3,2,5
tenshii,28.2980505156,3.39812481275,4,4,8
inspector waffles,28.2956942348,4.19240650179,3,2,5
yanyan,28.2938493441,4.56494045811,3,2,5
luckyshoot3r,28.2872892907,4.15969975228,2,2,4
thorne,28.2811106064,2.86861557747,7,5,12
kingly,28.2759025653,3.36274557484,6,4,10
lightning,28.2739543721,3.27976689295,6,6,12
booty bandit,28.272155392,4.56501471773,1,2,3
unsure,28.2719696337,2.13412226869,11,11,22
jordo,28.26984496,4.04319435153,3,2,5
j$727,28.2630087526,4.77664209373,2,2,4
pawl,28.262362595,4.45646868786,3,2,5
speedy,28.2623169079,4.07649791921,4,3,7
slim,28.2591367067,4.2760116749,3,2,5
et,28.2587152916,4.40750477974,3,2,5
sirreginald,28.2586186351,4.70386262521,2,2,4
havok,28.2528534917,3.70625777532,4,4,8
dhoho,28.248869641,4.68479951571,3,2,5
wowzers,28.2477085271,2.0226369005,14,12,26
milk,28.247076731,2.27883491678,12,10,22
joba,28.2430872188,4.1627956797,3,2,5
mr fluffles,28.2409984231,3.56088875125,5,4,9
i-dog,28.2406303676,4.7972569368,2,2,4
skullkid,28.2378304339,4.30265117326,3,2,5
seeze,28.2368473053,3.01643896365,6,6,12
raffaele,28.2362698249,4.40477399948,3,2,5
hvac,28.2362391994,3.24302402108,5,6,11
pogopeanut,28.2352926134,4.51866525233,3,2,5
epikfaal,28.2274085627,3.7800578812,3,4,7
nihlus,28.224403034,3.27205242477,5,4,9
drage,28.2181974025,4.20143515026,4,2,6
birdo,28.216516137,4.32778570767,3,2,5
didact25,28.2153092109,3.42505386523,5,4,9
splish,28.214331524,4.39739205533,3,2,5
kaizen,28.2132746245,4.72176268213,2,2,4
s-man,28.210656582,4.88439481554,2,2,4
bunsunkun,28.2103831141,4.86954915245,2,2,4
krzy8,28.2067360514,4.41296412653,3,2,5
rs,28.206399529,4.37847957036,2,2,4
watch,28.2051013067,4.79632993429,2,2,4
the grime reaper,28.2044343526,3.44114824341,4,5,9
husbrann,28.2010211458,3.18440852245,7,5,12
stelios,28.2009159813,4.82066659002,2,2,4
big kid,28.1988617009,4.22337144811,3,2,5
heroc7,28.1967589473,5.45502531182,1,1,2
kaese,28.1951158677,3.00579142335,6,7,13
dmr,28.1950188846,4.7076151511,3,2,5
rootbeerfloat,28.17888764,4.42079861096,3,2,5
tails,28.1767812831,3.09210562799,5,6,11
critius,28.1747338514,5.1696416331,2,2,4
scyzel,28.1675827976,4.43706606379,3,2,5
microwaveyourhead,28.1671273183,4.78602933683,2,2,4
zelazon,28.1660259925,4.36360659833,2,2,4
krusty,28.1588694325,4.66511301604,2,2,4
buttlet,28.1547375104,4.29120145133,2,2,4
gabezilla,28.1489815707,4.46191002496,3,2,5
steamfriedasian,28.1489815707,4.46191002496,3,2,5
kone,28.1462760743,3.99516932644,4,3,7
undies!,28.1447989951,3.29616792599,5,4,9
e,28.1441314568,4.95091348628,2,2,4
spree,28.1422643062,4.59119039724,4,2,6
kneeper,28.1419273491,4.16662512988,3,2,5
silentwah,28.136340857,4.32625878824,3,2,5
pad,28.1356920867,4.09227527777,4,3,7
kooper,28.1342781008,4.62093970937,3,2,5
fear,28.1300483269,2.98827973936,7,6,13
connor,28.1214712317,2.92553304012,6,6,12
shroudedone,28.1211682213,3.1117826204,4,5,9
aeoluxar,28.1199806152,3.46922819429,4,4,8
solarbear,28.1197753017,3.08802066877,6,5,11
lucifer,28.1146747991,4.5434918485,2,2,4
fantomenk,28.1120609335,3.95383765668,4,2,6
marvel,28.1111825042,3.70346518521,4,3,7
merts,28.1090322812,4.2642386049,3,2,5
dortmunder,28.0996420354,3.77990797564,4,2,6
slickah,28.0962130661,4.30034940894,3,2,5
kim,28.0922305924,4.53373620047,3,2,5
f s u,28.0922305924,4.53373620047,3,2,5
thegtree,28.0922305924,4.53373620047,3,2,5
deg,28.0920191704,3.53105146735,5,5,10
slumped,28.0916736776,4.4494426372,3,2,5
perhapsman,28.0898643917,4.40495243145,3,2,5
aero,28.0877625609,2.53444372991,7,8,15
pyntarn,28.0806191323,4.0075816616,4,3,7
lean,28.0803604406,4.3235733192,3,2,5
ltigre,28.0745727545,4.63604441721,2,2,4
nipunn,28.0720718984,3.24214407745,6,4,10
oujia,28.0686510216,4.40500193982,3,2,5
moat,28.0666691452,4.23033993752,2,3,5
nami,28.0661766744,4.535747741,2,2,4
arpah,28.0659053421,4.46504921658,3,2,5
commanderkool,28.064000471,4.38307120147,3,2,5
doogless,28.0596703657,4.53644796623,2,2,4
potentis,28.0584446845,3.31097153862,6,4,10
blanky,28.0551522905,3.65764922631,4,4,8
frostbyte,28.053955391,3.2445415571,5,4,9
stitchface,28.053805574,1.99024591024,14,12,26
xeon,28.0514060192,4.05579884264,2,2,4
c4d,28.05064665,3.73478225787,3,4,7
zombiecat,28.0497650198,4.28315351041,3,2,5
mew2queen,28.0493353837,3.32062417852,6,4,10
sephy,28.0452651973,5.04519504203,2,2,4
oldiz,28.0400482455,2.72777316854,9,8,17
nastynard,28.0383083153,4.40752675837,3,2,5
morgneer,28.0360720341,4.44501341015,3,2,5
el jefe,28.0355857074,4.46370427572,3,2,5
blackjack,28.0330591336,2.72144050338,8,6,14
lonefire,28.0260844528,4.04787049596,4,2,6
yrex,28.0251552202,4.53881743396,3,2,5
infin,28.0251552202,4.53881743396,3,2,5
dmw,28.0251552202,4.53881743396,3,2,5
hi im mikey,28.0228991362,4.53572460678,3,3,6
luxus,28.0191292246,4.5502571563,3,2,5
smith,28.0163983465,4.19316336136,3,2,5
knitl0rd,28.0049509665,4.66904142222,2,2,4
flyingwaffle,28.0022957664,4.68172294486,2,2,4
jbash,28.0013597934,2.65019445353,9,8,17
stroker,27.9989938855,4.27075887567,3,3,6
ot eric,27.9931529587,4.95513775679,2,2,4
izek,27.9923382383,4.91535170731,1,2,3
ulsi,27.9911742635,3.44669744685,5,4,9
fearturkey,27.988549429,4.25245822372,3,2,5
young love,27.9862484682,3.9890482873,3,3,6
sun,27.9857451317,3.25869158469,5,4,9
rh1thmz,27.9817751207,4.92687293352,1,2,3
random norcal fox,27.980277586,4.45008994754,3,2,5
jedwreck,27.979623699,2.75545669137,6,7,13
eight%,27.9772452547,5.01848109812,2,1,3
oven,27.9767975799,2.83900726834,6,6,12
waves,27.9763359335,4.39440731218,3,2,5
action master,27.9711398479,3.32564846537,6,4,10
maku,27.9669718913,4.11295189038,3,2,5
raptor,27.9634417423,4.8294901961,2,2,4
h2o,27.9613893371,4.49998148563,3,3,6
zettavolt,27.9606533603,4.75137144628,2,2,4
trout oracle,27.9598300808,4.72248640704,3,2,5
art,27.9531371701,4.75583337267,2,2,4
pizza,27.9415968144,2.4751690676,10,9,19
oats,27.9398005475,2.56260937292,6,7,13
dz rei,27.9394885011,4.40113076237,3,2,5
sk_jynx,27.9322972075,4.48935550018,3,2,5
larfen,27.9302795635,4.44174496065,3,2,5
zofrea,27.9286509637,4.78010463468,2,2,4
log,27.9225547098,3.62016146461,4,4,8
3huna,27.922494135,3.28750995237,6,4,10
dr. bread,27.9160546947,4.18049217103,3,2,5
gragledump,27.9104176547,4.60094573513,3,2,5
jerry,27.9100992869,2.7009329505,8,8,16
studebacher hoch,27.9078525305,3.50540954508,5,4,9
youngster joey,27.907167817,4.41302489136,3,2,5
lvvn,27.9058986834,4.3887846573,3,2,5
mooseeatsbear,27.9035561429,3.39809394955,6,4,10
bok choy,27.8997034909,4.22352568364,2,2,4
rumble,27.8993888162,3.58002499327,4,4,8
lew lew,27.8991713869,3.7486338146,4,4,8
patrick,27.8977377938,1.86762443819,17,15,32
kcg,27.8956605081,4.17784952432,3,3,6
dove,27.8955118026,3.35175212062,7,5,12
turnip4what?,27.8947641704,4.43416784147,3,2,5
stacky mcbears,27.8947641704,4.43416784147,3,2,5
ghettotastic,27.8947641704,4.43416784147,3,2,5
chi,27.8947641704,4.43416784147,3,2,5
pillowmaker,27.8947641704,4.43416784147,3,2,5
dubs,27.8940281304,4.36652958353,3,2,5
jntabeast,27.8939262442,4.92249453003,2,2,4
votega,27.8936317012,4.44882195466,3,2,5
rawk,27.8907524623,3.17761313339,5,5,10
mikehaggarssbm,27.8867805105,2.82893815911,7,6,13
sat,27.8865971091,4.90457468232,2,2,4
boner,27.8824413294,4.64071669851,2,2,4
royce,27.8823828358,3.31196656518,6,4,10
k.i.d ace,27.8738865735,4.94030173639,2,2,4
diabound,27.8656632377,4.64151380992,3,2,5
jofj,27.8651870354,4.56388605567,3,2,5
grrg,27.8640277583,3.59444362605,5,4,9
ein,27.8617577383,4.77988822673,2,2,4
.fb,27.8596979662,4.418079017,3,2,5
wphp,27.8561987482,4.54073840355,3,2,5
bgsatchel,27.8557057012,4.6406877898,2,2,4
jet,27.8528481586,2.40629742025,9,9,18
funk doctor,27.8518869734,4.44651354328,3,2,5
kiwigivi,27.8513599743,3.30147728075,7,5,12
wumbologist,27.8500990547,4.2033630195,3,2,5
salt mine,27.8490892662,4.52083737983,2,2,4
padre,27.8479414029,3.28460031451,5,6,11
argonaut,27.8432789174,4.5001704255,2,2,4
bb,27.8432669352,4.34614735905,2,2,4
jacob,27.8366930548,3.56439367939,4,3,7
acid fuccboi,27.8341532778,2.57986057108,10,8,18
a$ap p0cky,27.8287004705,3.39926359787,5,4,9
young $,27.827454255,3.69447350966,4,4,8
benneh,27.8273144564,4.43714975797,3,2,5
muttnik,27.8263838774,3.39292731508,6,4,10
jeppegryn,27.8227360767,4.26022453889,4,3,7
jobes,27.8165307859,2.61537043698,9,8,17
game,27.8162256927,3.1216463512,4,4,8
jwinks,27.8160108068,5.00624335223,2,2,4
purpleburd,27.8159839123,4.62887452134,2,2,4
crucible,27.815456581,4.31459350105,3,2,5
artist,27.8143868693,4.90753719676,3,2,5
vasili,27.812096825,4.15962510634,3,2,5
microsoft j,27.8109044458,4.48992515555,3,2,5
dair raid,27.8090502473,4.7044250733,3,2,5
hunter,27.8081998473,4.68217256954,2,2,4
cfh,27.8002617684,4.31254643117,2,2,4
darkhero,27.7960871394,4.49167516126,3,2,5
inu,27.7951108135,3.61775672392,4,4,8
smokey meat sweats bbq,27.7915651669,4.5120082151,3,2,5
jlo,27.788722762,3.68927290108,5,4,9
aiya,27.7886145569,3.44365253711,6,4,10
moss,27.7837510358,4.27053660843,3,2,5
epsilon,27.7831008559,4.45168870291,3,2,5
dna,27.778366985,4.32826025695,3,2,5
sourdough,27.7777969132,4.01030448044,3,2,5
theredsock,27.7761789715,2.69803115769,8,8,16
alex kidd,27.7715508346,4.19439131933,3,2,5
sled,27.7714995684,4.52348624482,2,2,4
zuppy,27.7700866308,3.8517581537,2,4,6
origamisalami,27.7685510785,5.09946275143,3,2,5
kort,27.7646851263,3.66441836701,4,4,8
you,27.7621087451,4.1124794822,3,2,5
lugia,27.761535058,3.42797748977,5,4,9
truth,27.7565630507,3.49292689519,5,4,9
nachloride,27.7540480889,4.30331949475,2,2,4
treyvon tustronk,27.7534117776,3.18583083472,6,6,12
valor,27.7491744192,3.66482018051,5,4,9
lord chin chin,27.7487981309,4.51774635205,3,2,5
puzzle,27.7431933227,4.54996015227,3,2,5
commissioner gordon,27.7394156612,4.50733412873,3,2,5
ta wolf,27.7312858589,4.81461793176,3,2,5
thomas the legend,27.7282560682,4.15612729133,3,2,5
mombacat,27.7280923302,3.94301346419,3,4,7
raves,27.7245084941,3.24290889386,5,4,9
4bs,27.7240832512,4.45143744893,3,2,5
blargh257,27.7203892259,3.90610172535,4,4,8
superultradx,27.7162254765,3.77308934791,4,4,8
coin,27.7141054142,3.36325201676,5,4,9
justin white,27.7083386768,3.22198571923,5,4,9
azureflame,27.706857785,4.25216459243,3,2,5
supadice2,27.6894908297,3.17755493372,6,4,10
skoopdish,27.6879320198,4.53742945414,3,2,5
duhssert,27.6854807145,3.43096737442,5,4,9
fly sloth,27.6830167191,4.53861969424,3,2,5
zaik,27.6775436243,2.65742948578,8,9,17
deep fox,27.6720193286,3.45694888744,5,4,9
arm & hammer,27.6716427695,3.15449778732,5,4,9
biscuittricks,27.668088194,4.43995534765,3,2,5
prozak,27.6676113651,4.53099894768,3,2,5
triffle,27.6673597598,4.5022081088,3,2,5
sgt flow,27.6668345941,4.52601335567,3,2,5
jabs,27.6658057535,4.79143254438,2,2,4
regi,27.6651548886,3.55620350027,3,4,7
arán,27.6620191947,5.98649744946,1,1,2
cream,27.6620191947,5.98649744946,1,1,2
kokichi,27.6617983897,3.63338491418,4,4,8
toptierdad,27.6605458117,2.36828342528,10,10,20
risky,27.6600174437,4.83652009639,2,2,4
bob-omb,27.6598521224,3.68157129454,5,4,9
shotzo,27.6594758902,3.8991291819,3,4,7
chrome,27.6498217513,4.23269617425,3,2,5
senn,27.6444509976,3.56780889389,8,4,12
genesis,27.6402731897,4.6446218217,3,2,5
russy,27.6398662166,4.08284391552,2,2,4
jjjlad,27.6398562547,4.9051530852,2,2,4
mags,27.6379640298,4.45014625877,2,2,4
juicen,27.6322330078,4.54681099871,3,2,5
x-rey,27.6322330078,4.54681099871,3,2,5
gooley,27.6316988313,4.1927185598,3,2,5
killjaykill,27.6301049664,4.48769922716,3,3,6
vyn,27.626894401,3.52461033653,4,4,8
spider,27.6258496242,3.23244103984,6,5,11
gamba,27.6255997946,3.92922453601,3,3,6
alexisstarving,27.6220730841,4.27439285988,3,2,5
oyako,27.6219595411,4.4552142955,3,2,5
phil collins,27.6173544534,5.05213630901,2,2,4
jelly,27.6155917539,3.43177681852,5,4,9
rice climbers,27.614479878,3.42519671169,4,4,8
scale,27.6131579432,4.73123696532,2,2,4
dirt,27.610066199,2.95163781694,5,6,11
goya beans x,27.6095662803,4.75713746685,2,2,4
just jason,27.606110616,4.93966119441,2,2,4
quixotic,27.6037174859,4.54386005913,3,2,5
ocifer,27.6037174859,4.54386005913,3,2,5
soil,27.6033494712,4.26116088124,3,2,5
pod,27.6011848147,3.22972541892,4,5,9
arcana_force,27.5990978944,3.79340348954,3,4,7
pandawasp,27.597661998,4.27493130879,3,2,5
rhyme,27.5955635901,3.53669690695,4,4,8
spood,27.595089259,4.29914968676,2,2,4
sizzling solzo,27.5943689828,4.46923169071,3,2,5
kalas,27.5925063434,4.32939795562,2,2,4
smilotron,27.5916855068,4.86432054302,2,2,4
cigs,27.5913892079,5.06263955749,2,2,4
praxis,27.5912500907,5.10149772472,2,2,4
quiteballin,27.5863554244,3.47237787798,5,4,9
hack,27.5857802652,4.36861039409,5,2,7
@ashkon_,27.5846400673,4.7869758974,1,2,3
frikky,27.5790921249,3.28946814902,7,5,12
peachy keen,27.5777311225,4.69190912465,2,2,4
kota,27.5741267523,4.71109200711,2,2,4
supergoomba,27.5739418234,4.47141092371,3,2,5
slim jesus,27.5631696584,4.65047199239,2,2,4
m00nbarker,27.5626459894,4.00153296735,3,2,5
kmol,27.5622659629,4.58714767992,2,2,4
ryou,27.5612440685,3.74945412932,4,4,8
zenaga,27.5537350443,4.49757353327,3,2,5
pipsqueak,27.5516434887,5.02357025864,4,2,6
kablooey,27.5506273909,4.64006417584,2,2,4
mothra,27.5505738194,4.67809325344,2,2,4
vudoo,27.5500373443,4.50577280312,2,2,4
benx,27.5481827089,3.57598052191,5,4,9
stew,27.5458656882,4.43636212255,3,2,5
icefang,27.5444750375,4.40251773306,3,2,5
jose ole,27.5441083386,3.38104260213,5,4,9
saggystardust,27.5377246842,4.5077032244,2,2,4
limjoker,27.5359484854,4.49895081015,3,2,5
walrus,27.5356674153,2.36456442053,9,11,20
schwiebs,27.5356199313,4.4836214626,3,2,5
ccdm,27.5356199313,4.4836214626,3,2,5
rca,27.5356199313,4.4836214626,3,2,5
~20%,27.5318400753,3.49776797701,5,4,9
tauntz,27.5291163106,3.74139852728,4,4,8
pastabilities,27.5216195645,4.3332132823,2,2,4
pops,27.5201993997,2.48066899869,9,8,17
ride,27.5136805695,4.55919416507,3,2,5
nayeem,27.5126732653,5.14598663036,2,2,4
adknight,27.5096981647,4.23867318817,3,2,5
beachmaster,27.5076275164,4.65001904828,3,2,5
jcpwn,27.4999985406,5.09938414825,2,2,4
xin,27.4999399339,4.5825216422,2,2,4
dunkchai,27.4996062675,5.16869141957,2,2,4
jayson,27.4991514643,4.36003237566,3,2,5
simon,27.4987243485,4.58990902804,3,2,5
blahguy,27.4935148325,2.22520487097,11,12,23
cloud805,27.482593402,4.19891815473,2,2,4
lange,27.4801665488,3.56614082219,4,4,8
scarjo,27.4773041132,4.95472193533,2,2,4
mop,27.4703569234,4.81012117614,2,2,4
iron,27.4652352409,5.127802464,2,2,4
ari,27.4650569308,4.54163577033,3,2,5
m,27.4650569308,4.54163577033,3,2,5
nathansandwich,27.4637219689,3.60210907147,4,4,8
paper tiger,27.4629805908,2.98836679662,7,6,13
skiddy,27.4625908997,4.36312116967,3,2,5
mm720,27.4623031388,3.19174996416,8,5,13
omd,27.4598996529,5.07447233105,2,2,4
forge,27.4598057569,4.76420062005,3,2,5
sylar,27.4587375682,4.52572431805,3,2,5
minz,27.4430326224,4.43247701259,3,2,5
bashking,27.4402006316,4.53775327084,3,2,5
jorge,27.4313018128,3.43118565298,4,4,8
papanojohns,27.4275293121,4.63894651141,3,2,5
divinius,27.4243488788,4.67082164077,3,2,5
cowhunter,27.4242883175,4.22640264694,3,2,5
kabbage$$,27.4176667302,5.04570343836,2,2,4
boga,27.4141213639,5.13638237072,2,2,4
pogo,27.4124827062,4.2948205497,2,2,4
pretzl,27.4115595311,3.54351803708,4,4,8
xtreme,27.4109085248,3.78999785192,4,4,8
nbs,27.4106025412,3.7687395048,3,3,6
scooby doo gucci jacuzzi,27.4104317097,3.73511637154,4,4,8
binary clone,27.4102487201,3.98257792678,4,3,7
worldstar,27.4099062729,4.54421963836,3,2,5
papa nooch,27.3965671058,4.59758810499,2,2,4
w3emdream,27.3926956346,4.5690236832,2,2,4
yung dactyl,27.3885902465,3.46590175995,5,4,9
ryan mercado,27.3880915173,3.09080294088,6,4,10
langkow,27.386549526,4.85333727355,2,2,4
bread,27.3847526591,3.3322032838,5,5,10
5ive,27.3796152307,6.24053979892,1,1,2
clius,27.3795911957,4.84251560792,2,2,4
mars,27.3781677261,2.60646448172,8,8,16
kilo,27.3740130786,3.69969248224,4,3,7
xtrooper,27.373091497,4.46969459455,3,2,5
faheid,27.3705581191,4.87946433,2,2,4
tastygoldfish,27.3654978005,5.26049319348,2,2,4
dru2,27.3643096632,5.35623982436,2,2,4
gin,27.3629354888,2.19277361858,12,10,22
burritowolf,27.3627958451,4.3351966306,3,2,5
bensw,27.362277281,2.6057790337,8,7,15
dokmomo,27.3591620112,4.45225239602,2,2,4
mojo8675309,27.3526109635,3.37883139649,5,4,9
siren,27.3525754643,3.37542732796,5,4,9
gars,27.351508849,4.51325465923,2,2,4
linder,27.351173065,4.46895566644,2,2,4
puddle,27.3507810805,3.7047702379,5,4,9
t1s,27.3503005273,4.76782633215,3,2,5
dr.shots,27.3498097908,4.85287078084,2,2,4
pdub,27.3493303836,4.54808227584,3,2,5
greenjinjo,27.3491242733,4.29031552776,2,2,4
gentlefox,27.3476158934,4.50877954195,3,2,5
davidcanfly,27.3460933299,4.51529718613,3,2,5
tuna,27.3422150853,3.09103143431,7,6,13
thesuslur14,27.3357282725,5.14167804454,2,2,4
phalanx,27.335497414,3.36346597417,6,4,10
milf,27.3350329118,4.37426532495,3,2,5
harvey,27.3344853378,3.96922941665,4,4,8
pale chub,27.3319640858,4.64780030279,3,2,5
fizz,27.322959778,3.18337085287,4,6,10
jussy,27.3199807837,4.55264518936,2,2,4
royal flush,27.3197012726,3.49955642007,5,4,9
noodle,27.3191079057,2.17399207725,8,13,21
schmav,27.3151009084,4.61928941892,3,2,5
kull,27.3146253898,4.32137459058,3,2,5
king,27.3097418138,5.47183701302,1,2,3
shady pyro,27.3077208239,4.60879501535,3,2,5
tonymalone,27.3049748547,2.77162009323,10,9,19
diaper,27.3040419083,4.48834940175,3,2,5
clorox,27.2988828023,3.53717652012,5,4,9
dog,27.2987130965,3.55242200725,5,4,9
mediocre,27.2979588197,3.55353178025,4,4,8
shiki,27.2976039889,4.11794559644,3,2,5
leaf,27.2963930117,2.37730408148,10,10,20
2a4t,27.2939956759,2.35962815926,10,7,17
mewwy,27.2937354949,3.70442784723,3,4,7
tace,27.2914565204,4.40433208417,3,2,5
thechocolatelava,27.2863700527,3.78838808597,4,4,8
yuji,27.283841064,4.30760468882,3,2,5
goatlink,27.2811240133,4.60754765854,3,2,5
spamgeorgio,27.2782119873,4.06452893395,3,4,7
tbd,27.2770272892,4.23787181093,2,2,4
webs,27.275180148,1.67610980318,15,21,36
wii-kai,27.2740765927,3.6849476913,4,4,8
sajeel,27.2723512555,4.52647250182,3,2,5
dank,27.2681999399,2.6244672829,9,9,18
pbf,27.2602452472,2.47661697849,6,9,15
craig,27.2576103838,4.67814132278,2,2,4
jab [fritz],27.2558002951,4.78808937073,2,2,4
coxmccox,27.2548920253,3.60252413636,4,2,6
gigglyfart,27.2534465376,4.85321206171,2,2,4
maximo,27.2498282435,3.4039868227,5,4,9
kman,27.2488761432,3.77542535989,4,3,7
rap!d,27.2467815664,4.38202851586,3,2,5
donaxi,27.2431500973,4.27756941158,4,3,7
clever nevers,27.2393026504,4.30789783027,2,2,4
nogget,27.2376982741,4.10012082986,3,3,6
marky,27.2375135958,4.41788932629,2,2,4
typo,27.2309440963,2.86049081796,7,6,13
coldtoasty,27.2274485339,4.29957430496,3,2,5
donutgames43,27.2243057232,3.48009486024,5,4,9
cdub,27.2240018696,3.76467887229,5,3,8
bench,27.2212211895,4.5647898857,3,2,5
goad,27.2194360759,4.52448257292,3,2,5
moo,27.2135926433,2.88173036142,7,8,15
birdybirds,27.210918572,4.82437476332,2,2,4
rudmarker,27.209836428,4.140063426,3,3,6
femto,27.2094249697,4.82822029331,3,2,5
trogdor,27.2011439396,4.53464165665,3,2,5
jemz,27.1952173681,4.51395371126,2,2,4
letsduet,27.1911571518,4.7049601151,2,2,4
dutch,27.1897135981,3.14754073567,5,6,11
stacked,27.1897040084,3.48917889488,4,4,8
jwolf,27.189064617,3.32681008093,6,4,10
blooky,27.1881433279,4.71086796503,2,2,4
prison,27.1779873188,3.52009995306,3,4,7
subsuck,27.1718347061,3.86240494686,3,3,6
doghug,27.1702536071,4.98269726182,1,1,2
girthwormjim,27.1685212493,4.3888558037,3,2,5
pendragon,27.1676431975,4.48350546988,2,2,4
ryanxe,27.1670412765,4.54248466702,2,2,4
kaygee,27.166116206,3.72133282419,4,4,8
crupyo,27.1659768033,3.23758454875,4,4,8
wei,27.159680941,5.10322794784,2,2,4
cheez,27.1586488288,5.30250152605,2,2,4
nost,27.1537140834,3.62677794257,3,4,7
pineapple,27.1520695442,4.87138578642,2,2,4
tah.,27.14919903,4.92083891487,2,2,4
twunt,27.1488444851,3.68004897149,4,4,8
indy,27.1487238489,4.60082523938,2,2,4
tucker,27.14834195,3.98246380067,2,4,6
rose,27.1470080024,3.66640584242,4,4,8
cab,27.1466418545,4.05536973886,3,3,6
golly,27.1420206194,4.13884488103,3,4,7
dysfunkti0nal,27.1416708887,2.94432607201,7,7,14
rannulf,27.139470959,4.5541732911,3,2,5
splendid,27.1368772786,4.69983459921,2,2,4
el duderino,27.1325591119,3.54505709535,5,4,9
bird,27.1281840026,3.03709525295,5,6,11
tuff,27.1280723067,4.88543575083,2,2,4
han,27.1280723067,4.88543575083,2,2,4
lada,27.1280723067,4.88543575083,2,2,4
tranmobile,27.1280723067,4.88543575083,2,2,4
kingofleaves,27.1280723067,4.88543575083,2,2,4
cryo,27.1280723067,4.88543575083,2,2,4
mr baninawi,27.1277875768,3.39448017065,5,4,9
boo,27.1218111334,3.71884145259,3,4,7
toss event,27.1161445293,4.93521185911,2,2,4
dz,27.1125000119,3.0818779985,4,7,11
kali,27.1094420569,4.87779989142,2,2,4
surfero,27.1094420569,4.87779989142,2,2,4
christhenoob,27.1094420569,4.87779989142,2,2,4
nastynate,27.1094420569,4.87779989142,2,2,4
gangly,27.1089924346,2.60271945891,9,8,17
ashortbuspileup,27.1089625161,5.24289438338,2,2,4
attrition,27.1048393506,4.10258432772,3,2,5
weirdo dunno,27.1043177995,4.9800455221,2,2,4
daddy,27.1040759738,2.68115396789,7,8,15
masterdong,27.1038767967,3.93824448941,4,4,8
kevin,27.1031583581,3.84206891049,3,4,7
money,27.1013465979,3.57137632792,4,4,8
blake,27.1012081047,4.6248823158,2,2,4
hatcrab,27.0969330269,4.72261505492,2,2,4
xf awkward,27.0946780656,2.90804851716,6,6,12
fout nl,27.0900674467,4.67708562938,2,2,4
warui,27.0891756039,5.18681266164,1,2,3
bad horse,27.0882517147,3.62466277947,5,4,9
zluchs,27.0878743693,4.48794002853,3,2,5
invinceabull,27.0877175947,4.28447368155,3,2,5
jupiter,27.0876687248,4.70182907957,3,2,5
no love,27.0854397002,3.65531000105,4,4,8
lookalike,27.0839233446,4.87617346704,2,2,4
swag,27.0801472506,4.48965183943,3,2,5
carcosa,27.0795409312,4.59420143624,3,2,5
iron_narwhal,27.0777891876,4.79848076003,1,2,3
squeakie,27.0760924612,3.10423871842,6,5,11
lostluggage256,27.0713151222,4.68288310826,2,2,4
louie.exe,27.0713151222,4.68288310826,2,2,4
rucksack,27.0712212155,3.74909878513,4,4,8
rabit,27.0700556611,4.86439110799,2,2,4
d-frog,27.0634852205,2.96105353251,7,7,14
chong,27.0621842698,4.23652662033,2,2,4
milkmuffinman,27.0553986595,4.52340891528,3,2,5
neil,27.0494111477,4.95648450306,2,2,4
pataflafla,27.0467897899,4.35911408,2,2,4
spoodbeest,27.0414033261,4.86718203443,2,2,4
shiftybadger,27.0338714325,3.91425676285,4,4,8
and1,27.0266998823,4.86597323228,2,2,4
e102y,27.0266998823,4.86597323228,2,2,4
winslo,27.0226372427,3.53912374744,3,4,7
voltampt,27.0184908276,5.04388165529,1,2,3
teo,27.0184700179,3.68601460155,4,4,8
flakes,27.0170857222,5.10425275817,2,2,4
aqua,27.0145576674,4.09619395206,4,3,7
pebble,27.0134499986,2.48615320835,7,9,16
lucidity,27.0110493156,4.62818793582,3,2,5
jnasty,27.0093781913,4.77126821833,2,2,4
official slime,27.0084116389,4.87252275194,2,2,4
glaze,27.0084116389,4.87252275194,2,2,4
aeiou,27.0080535526,4.90331299362,2,2,4
lecceo,27.0003098729,4.69223552378,3,2,5
v$,26.9990973512,4.87123723711,2,2,4
god!tucksinthesheets,26.9984353149,4.68788283115,2,2,4
hot_dogg,26.9984353149,4.68788283115,2,2,4
weo weo jax,26.9918807737,3.25720592356,5,4,9
hobbes,26.991504859,3.24777384048,5,6,11
ejuice,26.9899040413,4.19401919223,2,2,4
badbones,26.9842456652,3.32463703368,4,4,8
dre,26.9818365473,3.56297378707,4,4,8
kasparv,26.9803434138,4.55816312651,3,2,5
amilk,26.9771865258,5.43128465428,1,2,3
narfanator,26.9717953575,4.74774073279,2,2,4
dogma,26.9712473691,3.35153164374,4,3,7
drasil,26.9706534536,4.38724884682,4,3,7
kuroyuki,26.9665072768,3.96685638688,3,2,5
viridian,26.9648554193,4.84992273956,2,2,4
jus,26.9635137593,3.73932055345,4,4,8
mexray,26.9617247715,3.61828013935,4,4,8
connorasada,26.958933504,3.54362582415,4,4,8
utto,26.9571765082,4.42152141846,3,2,5
kale,26.9569773603,3.80349112804,4,4,8
prospekt,26.9554165689,4.6538490926,2,2,4
lilypad,26.9494756329,3.35977407587,5,5,10
peggle master,26.9406357862,4.84183815203,2,2,4
stane,26.9394462382,4.53771164712,2,2,4
sundark,26.939055966,4.85826298916,2,2,4
scrums,26.9268488409,4.67692705631,2,2,4
breakfast,26.9245322958,4.30662243038,3,2,5
rm,26.9219752654,2.80572363823,6,6,12
erisez,26.921696165,4.76525069031,1,2,3
dr. wa,26.9201398199,4.87334755385,2,2,4
raccoon wizard,26.9199829751,5.25960839468,1,2,3
tom,26.9194780121,4.85940754145,2,2,4
holo,26.918372441,4.70729706914,2,2,4
bird jesus,26.9141813776,3.9245264716,5,4,9
puresalt,26.9095243203,4.34839798157,2,2,4
empale,26.9030279014,2.84646413609,7,6,13
bliss,26.9023010375,4.87181345514,2,2,4
the moutai prince,26.9023010375,4.87181345514,2,2,4
taternator,26.9023010375,4.87181345514,2,2,4
bman,26.8975424356,4.83748270427,2,2,4
core,26.8945843177,2.80921682284,8,6,14
bluemarine,26.8915255681,3.7047318646,4,4,8
ober,26.890454077,5.07469323964,2,2,4
colony,26.8888566997,3.25116626257,6,6,12
littleone,26.8853404317,3.50754014396,5,4,9
ben zed,26.884494612,3.01254733234,5,6,11
lectril,26.8798774653,3.07456389469,5,5,10
scarph,26.8775505271,4.58860013307,2,2,4
luke,26.8755777019,5.04721146472,1,2,3
brgod,26.8735847817,3.65596731036,4,4,8
mr.stabz,26.8716966677,4.92424510444,2,2,4
turnup_xd,26.8707466028,3.77245877467,3,4,7
short-hoppe,26.8689172139,4.45409758721,2,2,4
yung fuccboii,26.8678799222,4.76362606811,2,2,4
11 - 9 grabs,26.8603696731,4.5667846216,2,2,4
starlight,26.8581942424,4.27201137655,3,2,5
tainted,26.8560409728,4.61931747628,2,2,4
samyboy03,26.8558587967,5.17866501509,2,2,4
michaeldouglas,26.8553464191,4.80264505081,3,2,5
gale,26.8553464191,4.80264505081,3,2,5
halfjack,26.8519628529,4.95729014749,2,2,4
floss,26.8455644126,4.87716467076,2,2,4
spikeymike,26.8451217266,5.20714123543,2,2,4
ync,26.8436361048,4.86796023558,2,2,4
loading...,26.8427919433,4.51258794313,2,2,4
tariqdx,26.8371362625,4.98317879254,2,2,4
mtl-wizards,26.8356849116,4.41915749855,3,3,6
karma (jp),26.8336578635,6.07503637703,1,2,3
rymo,26.829790584,3.6107667289,3,4,7
solariiii,26.8290902569,4.83249103573,2,2,4
swissmiss,26.8288813509,4.58000012587,2,2,4
toxcic,26.8282341051,4.95710068172,2,2,4
thebourgelispig,26.8237500487,3.34252928973,5,4,9
captain black,26.8223435435,3.29070920855,4,4,8
abulize,26.8218200222,4.87628914934,2,2,4
mole,26.8192112451,4.78830093497,2,2,4
mr. biz,26.8078498765,4.82217272749,2,2,4
millsipan,26.8054957761,4.78456425902,3,2,5
krump,26.8049314602,4.41347346572,3,2,5
rush,26.8013466576,2.48337652497,7,11,18
kendrick lamarth,26.8006607758,4.08414458249,3,2,5
next,26.7944386556,4.64312421858,1,2,3
pixel,26.7941094158,2.87760189609,6,7,13
ciroc obama,26.7937655339,3.42309421006,3,4,7
jxc,26.7857178411,4.05571758613,2,2,4
rawnoodle,26.7807094939,4.25374852616,3,2,5
tapiney,26.7803907363,3.62024152731,4,5,9
intern,26.7758796823,3.80125412263,4,4,8
conix,26.7689557685,3.3568355375,5,4,9
peyto,26.76841819,4.31496537505,3,2,5
rudyshadow,26.7676467243,4.97024243753,2,2,4
popehat,26.7589789335,4.61048688941,3,2,5
carlito,26.7565462816,4.85881525002,2,2,4
ako,26.7475171062,2.95383457096,8,6,14
wills,26.7437190987,4.68584418857,3,2,5
wyzdm,26.7432517688,5.02394725493,2,2,4
shanahan,26.7415580309,3.42533235338,5,4,9
hypnotoad,26.7402266277,4.80890672904,2,2,4
kieran,26.7399527231,3.06678587684,6,5,11
plufball,26.7348149501,4.36747804446,4,3,7
nscyte,26.734567962,3.80710431112,4,4,8
trickyjeff,26.7341940021,4.69515708287,2,2,4
magnetic salt,26.7333940367,3.82523156259,4,4,8
flappypenguin,26.7331802522,3.92840684119,4,2,6
owls,26.7289360314,5.84987141163,1,2,3
smashdad,26.7287803285,4.78362984344,2,2,4
feelings,26.7263942497,4.79137507955,2,2,4
kennybuchi,26.725624526,3.46933735067,4,4,8
metallic,26.7177860389,3.62374969409,5,4,9
stif,26.7161602797,3.18342328818,6,4,10
turtle,26.7143397711,2.3696151269,11,10,21
kaptinkillem,26.7094959217,2.80129061063,7,8,15
happy,26.7025615775,4.93142858257,2,2,4
dr. drew the dragon,26.6995723174,4.68159322642,2,2,4
johsyjam,26.6986921939,3.33720290203,7,5,12
telechubby,26.6969692526,4.4772283502,2,2,4
j-bear,26.6953366507,4.99868210193,2,2,4
racer,26.6941390246,4.7613895752,2,2,4
mak,26.692578171,4.6305904985,3,2,5
gargito,26.6882809208,5.17834357244,1,2,3
xiii,26.6872240316,4.22760559621,3,2,5
herm,26.6847564919,3.63360652142,4,4,8
joelie polie olie,26.6765338913,3.96719304848,3,4,7
stanky,26.6757897415,3.94691344799,3,2,5
tetsu,26.6757403993,4.58533394024,3,2,5
just tyler,26.671570166,4.52317890464,2,2,4
mr.stitch,26.6663614485,4.83174103875,1,2,3
jzee,26.6622872055,4.92907588232,2,2,4
o,26.6616760573,3.57465747118,4,5,9
herman,26.6604163223,5.26274440931,1,2,3
cyan,26.6528745339,5.05093841227,2,2,4
lethalturtle,26.6505437571,4.91793169829,2,2,4
iron chief,26.6500837108,4.50291091785,3,2,5
ptet,26.6487751676,4.62263120289,2,2,4
bees?,26.6444764677,2.65139951436,7,8,15
stus,26.6418318066,4.67217206658,2,2,4
mr.ii,26.6395051654,4.55676880737,2,3,5
calzone,26.6352853349,4.14631919572,3,2,5
jcreans,26.6324006558,4.60799007091,2,2,4
vanilla coke,26.6321536538,4.94995809248,2,2,4
glee,26.6320138277,3.55971198872,4,4,8
dragos,26.6263642001,4.96886919247,3,2,5
a.i.,26.6208447013,3.20798331237,6,6,12
miggy,26.6194365403,4.78152470055,2,2,4
schoom,26.6176284273,4.78419674336,2,2,4
rolin,26.6169913822,4.27230025009,2,3,5
anathema,26.6125598392,4.8250467399,2,2,4
yungbitch,26.6125481865,2.66685656518,7,7,14
fingerblast,26.6113850064,4.61624571526,2,2,4
lysozy,26.6096838114,3.90700628908,4,4,8
raish,26.6093162218,4.8580696268,2,2,4
mr. bean,26.6073374037,4.80310928013,2,2,4
floppy,26.6068331416,3.69550846923,5,4,9
calvin,26.6057297981,2.26720706783,10,13,23
buu,26.6057029229,5.02064361861,2,2,4
scrapmettle,26.6028089153,4.32927645111,3,2,5
kezzup,26.6023139812,3.57328412722,4,4,8
worth,26.5996505853,4.58088104782,2,2,4
#rekt,26.5969460167,4.29746242191,3,2,5
batsox,26.5961504883,4.69286891205,2,2,4
eleven,26.5943178389,4.8182435357,3,2,5
kwaniza,26.5918541738,3.61087872362,4,4,8
rowan,26.5917913996,5.10625698185,1,2,3
severian,26.5915200694,3.27760176211,5,4,9
arvi,26.5871318955,4.51940266727,3,2,5
toez,26.5823973812,4.96958022909,2,2,4
jekyll,26.5819970341,4.8209695395,2,2,4
radiowar,26.581239772,4.93116550648,3,2,5
fredricoswe,26.579501391,4.35676696027,3,3,6
the salty smasher,26.5748379478,5.1691157613,2,2,4
celesti,26.5624290635,4.40211170433,3,2,5
ahampster,26.5614736242,4.16431488094,3,3,6
foodmanchew,26.5581484876,4.85702751868,2,2,4
papa zondo,26.5561287215,4.53081248561,2,2,4
merlisker,26.5554160585,5.04863572198,2,2,4
kuma,26.5503908508,4.06067966517,3,2,5
raggebe,26.5498083246,2.91784463668,6,6,12
koopi,26.5435128396,3.80999432586,4,4,8
fro fo sho,26.5427635523,4.91688802991,2,2,4
tts,26.5352688565,4.2825019919,3,2,5
j.p,26.5349149401,4.83027358871,2,2,4
huggermugger,26.5349149401,4.83027358871,2,2,4
info,26.5341700606,3.49555602003,4,4,8
fil,26.5317896296,4.83851508088,2,2,4
doctor x,26.5295276649,5.37758712983,1,2,3
void,26.5288861975,2.44672639744,9,10,19
mrpbody,26.5209228798,4.25568000576,2,2,4
hero,26.5207665454,5.02039185293,2,2,4
stemu,26.5182688057,4.9183821533,3,2,5
gifflarn,26.5180680502,3.6440773396,3,4,7
shy,26.5177297423,3.54404372125,4,4,8
f0xx #009,26.51653425,4.58012562002,2,2,4
dyno,26.5107273865,4.93997376352,2,2,4
kpopoppa,26.5094118471,4.9724202005,2,2,4
etai,26.5065244991,4.85414152144,2,2,4
rapatap,26.5043729861,4.24134522496,3,2,5
bick.trip,26.4997425379,4.77492986447,2,2,4
solharath,26.4958479899,3.74963265437,4,4,8
uchihascar,26.494430297,4.62695304836,2,2,4
istock,26.4934204093,4.04011932245,3,2,5
jamesconquest,26.4896864762,4.01525524242,3,3,6
riko,26.4847963517,5.01175298531,2,2,4
vanna,26.4847881884,4.91821367796,2,2,4
sweetwilly,26.4833264106,4.67468485899,2,2,4
seshy,26.4807124979,3.6251050526,4,4,8
squelch,26.4803245241,4.90090410571,2,2,4
sinon,26.4771267225,3.65014575967,3,4,7
cardinal,26.4710333761,4.64691432182,2,2,4
darksim,26.4608046215,4.94865662589,2,2,4
peliq,26.4573110992,3.22686017679,6,5,11
milhous,26.4551446858,4.91832122231,2,2,4
tpwn,26.4525166394,4.18349735514,4,3,7
raisin bran,26.4514037722,4.89345218732,2,2,4
wende,26.4501343468,4.63994809152,2,2,4
smoom,26.4444626222,3.73836929536,3,4,7
pinkman,26.4381674174,5.20573433698,2,2,4
sooyoung,26.4363809803,4.35530902757,2,2,4
dark_evil_prince_955,26.434504596,2.67787858398,7,8,15
larryt,26.4330924154,4.45151131862,2,2,4
ritaverdronk,26.429126356,4.92840410178,2,2,4
paco,26.4216512754,3.0651332307,7,6,13
mugifi,26.4135637189,5.02561082952,2,2,4
cyberdelic,26.4129110907,3.52756176779,3,4,7
mang0jr,26.4128729278,4.72073756298,2,2,4
housewife,26.412623265,3.61821981386,4,4,8
danger doggo,26.4123446334,5.28559633934,2,2,4
hikenviken,26.4039912574,3.47665645717,4,4,8
hud,26.4030540289,4.92890346794,2,2,4
adair,26.4008987873,3.17923088904,6,4,10
clam,26.3986392605,3.56094745887,3,5,8
rato,26.395607363,4.7264904549,2,2,4
laser thunder,26.3949527627,3.08680464198,6,6,12
bpna,26.3934087889,4.89969917516,2,2,4
rope,26.3885048814,4.04032340199,3,4,7
duckslayer,26.3845978777,3.29098955115,6,5,11
ycj,26.3830256373,4.38089873097,2,2,4
kenz,26.381917202,4.96317126971,3,2,5
hylian reaper,26.381917202,4.96317126971,3,2,5
arson (aka mc sweden),26.381917202,4.96317126971,3,2,5
noizeeh,26.381396359,3.7833246587,4,4,8
hindawg,26.3812711805,2.30990773532,6,11,17
blues,26.3763358048,3.64579894251,4,4,8
kayko,26.3745493548,4.4440876977,3,2,5
dad,26.3733418657,2.2767331945,11,12,23
lama,26.3673951664,2.92519995069,7,6,13
gibs,26.3670048719,5.41296724435,2,2,4
grizzly,26.3661119688,3.93087731264,3,4,7
dirty lasagna,26.3657886981,4.90377249676,2,2,4
whatever,26.3635585507,5.08508344412,2,2,4
super^nova,26.3586891478,5.06066728392,1,2,3
w1ng,26.3579481743,4.80671521565,2,2,4
supermegawalrus,26.3551085737,4.72383663426,2,2,4
rundmx,26.3551062522,4.78725103302,2,2,4
themaik,26.3532553253,4.1666961636,4,3,7
fats,26.3488685568,3.86128996467,4,4,8
habi,26.3421267641,4.86201865604,2,2,4
elili,26.33937454,4.30637848454,3,3,6
young mitch,26.3345465391,4.30290017229,2,2,4
spaceghost,26.3290095626,4.05139156781,3,4,7
mixit,26.3272504238,3.80773454279,4,4,8
aghi,26.3219082928,3.2526960972,4,4,8
timtempor,26.3134668664,3.61986150668,4,4,8
despair,26.3076995455,4.46894253367,3,3,6
topher,26.3062499044,4.48793809576,3,2,5
anime,26.3028269515,3.64891206529,3,4,7
table,26.2999002465,4.93716913088,2,2,4
aray,26.2994056459,4.60503369302,2,2,4
shiv,26.2984211109,4.79075072443,2,2,4
blayd,26.2914411087,4.21343521457,3,3,6
mellamo,26.2912321531,2.17478330246,9,12,21
theperfectname,26.2826910628,3.57277188994,4,4,8
seigehyland,26.2817428965,4.65316200883,2,2,4
prem,26.2773458752,4.76316354342,2,2,4
odb,26.2752931585,4.4191376505,2,2,4
swigo,26.2751900448,5.29968258344,1,2,3
bison.m,26.2711743945,4.78048321457,2,2,4
trusty bag,26.2664856605,2.40523649988,9,9,18
rickshaw,26.2655170867,3.51635630585,4,4,8
dragmire jr,26.2647122644,2.64977529267,10,8,18
dasboot,26.2644820097,4.82414714136,2,2,4
scrandino,26.2638409785,2.97530352716,6,6,12
drew,26.256151297,3.4656490124,5,4,9
general heinz,26.2537035346,4.50669105333,2,2,4
stylo ren,26.2531575088,4.2095359712,3,2,5
dovler,26.253141724,4.78925370253,2,2,4
branchamp,26.2525078823,5.02640517743,1,2,3
notsocrazy,26.2502671052,3.15964427673,4,6,10
emilywaves,26.2391283312,2.41985376874,10,10,20
flimwad,26.238375222,3.90988502171,3,4,7
wabunga,26.2378630409,5.02762608518,2,2,4
ram,26.2298842148,5.90584556789,1,2,3
ggdoe,26.2278712035,2.4411913466,6,11,17
harriet tubman,26.2154842316,5.39579405379,2,2,4
sabz,26.2139458539,2.74356650701,9,8,17
yusuf,26.2136231966,4.86170096115,2,2,4
the lizard king,26.2128691755,3.97126972619,3,4,7
abcactus,26.2116328297,5.01980465494,2,2,4
monopenisguy,26.2107891136,4.03972276971,2,4,6
bubs,26.2072280261,3.27930375738,6,5,11
die go,26.2062491472,4.64501036764,2,2,4
linus,26.2061127835,2.70947696649,7,8,15
igge,26.2054020916,3.80480922343,3,2,5
dot,26.2037586562,3.2665150556,5,6,11
kokingpin,26.2027002426,4.82199422068,2,2,4
andu,26.1951076729,4.89889993014,2,2,4
taichou,26.1945385627,4.67907087265,2,2,4
dr eggman,26.1921899192,4.86967467128,2,2,4
arsi,26.1911219557,4.96250386269,2,2,4
masterbravo,26.1865117423,4.50499349908,3,2,5
yeniths,26.1780121676,3.96287519886,2,4,6
symes,26.1687525439,4.8792450315,2,2,4
contra,26.1680311251,2.8419658308,7,7,14
kaizon,26.167041015,4.79747150391,2,2,4
flo$,26.1632403104,4.86637152245,2,2,4
dboi,26.1594615368,4.64872171182,2,2,4
brohad,26.1560662147,3.98277558791,3,2,5
luigi master tae,26.1558907171,4.30168711242,3,2,5
spidermad,26.1531447685,4.27774114046,3,3,6
phrez,26.147926397,3.43854835046,5,4,9
azianraven,26.1478193864,3.90079809707,3,4,7
corleone,26.1446003284,3.65132611007,4,4,8
jonson,26.1430831471,2.57348500768,7,7,14
joaco,26.1412757105,5.03848070545,2,2,4
angryfalco,26.1345932784,4.47219922637,2,2,4
myko,26.1345802927,3.65558054573,3,4,7
grainless,26.1320673959,4.97526894469,2,2,4
the_cucumbuh,26.1299315729,5.24888883268,2,2,4
troy,26.1287719003,4.92623916666,2,2,4
spoked,26.1266368587,4.28018233197,3,3,6
pkp,26.1253528978,3.47256146394,4,4,8
crustl0rd,26.1196240599,5.13520890897,1,2,3
cobab,26.1193739733,3.55095054182,4,4,8
theoneburger,26.117871579,5.04267550001,2,2,4
2jayys,26.1171785233,5.20483720282,2,2,4
pisces,26.1170051522,4.40193536648,2,4,6
hungdaddy12inches,26.1161641368,4.69976636688,2,2,4
morale,26.1160454559,4.91514203671,2,2,4
npv,26.113213573,4.01566552328,3,3,6
inzane,26.1087899632,4.8199085984,2,2,4
roshi,26.1077918074,2.79143011379,5,8,13
padoki,26.1068163586,3.67234495436,4,4,8
krad,26.1019813918,5.03637396298,2,2,4
moros,26.0986459393,3.71828614639,4,4,8
momspaghetti,26.094983693,3.67533717743,5,4,9
brandermeer,26.0924398761,5.08983834139,2,2,4
waifu,26.0920109001,3.10387751687,5,6,11
empire,26.0898199546,4.87841394922,2,2,4
autarck,26.0867274392,4.05068341327,3,4,7
deep,26.0758151597,3.55042010862,4,4,8
gliphy,26.0757862349,5.0398036392,2,2,4
nicthekiwi,26.0751082689,4.59295955917,2,2,4
kobe,26.0726240477,2.99989456513,5,6,11
arstneio,26.0695445764,5.04478023768,2,2,4
cocothunder,26.069344747,3.79170438642,4,4,8
mejonat,26.0615037723,4.9155745576,2,2,4
k-tel,26.057337394,3.98825826983,4,4,8
pilldemon,26.0560076059,4.16618989912,3,2,5
glibbyglobby,26.0546082255,4.53696578173,2,2,4
taycen,26.0510587355,6.25614033836,1,1,2
smatty,26.0504126255,4.52714903334,2,2,4
big cat,26.0502059186,3.66996441185,2,4,6
flotsam,26.050021304,5.18469682474,1,2,3
chezz,26.0408215489,4.6646222175,2,2,4
old$,26.0377760883,5.03125829362,2,2,4
sweetdee,26.0363731343,3.51123914711,5,5,10
buttons,26.0325863926,3.14872721116,4,6,10
skm,26.0305854098,5.08130024158,2,2,4
melon,26.0301060624,4.79826082369,2,2,4
young traplord,26.0280025704,4.72004022479,2,2,4
captain m.,26.0258904007,4.91651063803,2,2,4
cweb,26.0183783144,4.88238091686,2,2,4
tgrass,26.017431354,5.09821870968,2,2,4
brennan,26.0169441234,4.42039290537,2,2,4
sak,26.0036990548,3.00538641727,7,6,13
vrudssbm,26.0025947097,2.75378752348,7,8,15
g,25.9987632029,3.32139662855,5,5,10
ancient genesis,25.9981898344,5.15354609495,2,2,4
westbreezy,25.9976196813,6.06664144458,1,2,3
pappa,25.9885691217,4.37868317273,4,3,7
dr. poonanny,25.9882105623,4.87291841075,2,2,4
pancake mix.,25.988013054,4.68409173671,2,2,4
lunar,25.9861383572,3.63201905047,3,4,7
vondo,25.9846089627,4.91746964055,2,2,4
gark,25.9815809111,4.40586622046,2,2,4
ochoa_97,25.9789765758,4.58756855923,2,2,4
dirty,25.9778914479,4.20207962787,3,2,5
the_superiortaste,25.9728459061,3.61775001736,4,4,8
urn the cowpoke,25.972603838,2.71087662473,5,9,14
poefire,25.9679315084,4.1154117563,3,2,5
gre,25.9575364416,3.66988804448,3,4,7
globe,25.9560334577,3.07362885453,6,6,12
jon jones,25.9559875947,4.75404910763,3,2,5
deepfriedtickles,25.9555549921,4.8951507222,2,2,4
veranibbles,25.9523277962,4.9125757185,2,2,4
mrhappy,25.9445282872,3.65484443119,3,4,7
tips,25.9436242402,4.54880928605,2,2,4
bloop,25.9408143735,4.82140969169,2,2,4
big red,25.9380429158,5.91212269132,1,1,2
paf,25.9312728704,3.2912164907,6,6,12
kzm,25.9275163187,3.55016712187,3,3,6
ikkitrix,25.9253260144,3.34192878608,4,4,8
skeleton man,25.9249216809,5.79440034702,1,2,3
rust,25.9230962106,4.78348596468,2,2,4
qt,25.9201023114,5.04292830973,2,2,4
arsholino,25.9192386223,4.51659548755,3,2,5
ezra,25.9184666668,4.81080765595,2,2,4
radicalfox,25.9149298227,5.24330162725,2,2,4
thea,25.9134033675,3.47698899653,3,4,7
cruz,25.9068673057,4.11251159038,3,3,6
edd,25.906388778,3.62745677127,3,4,7
whitekneegrow,25.9032938533,4.92362350617,2,2,4
xrunriot,25.9031416213,5.04598812548,2,2,4
reverb,25.8963134865,5.20541053028,2,2,4
yoder,25.8948429273,5.02565381348,2,2,4
maher,25.8862372712,5.00643938174,2,2,4
questcake,25.8799830026,5.03818232926,2,2,4
burns,25.879619055,4.04402230246,3,3,6
airfair,25.8795978393,4.92183020054,2,2,4
8oz,25.8701624232,2.49121245924,9,11,20
tjd,25.869361051,5.42403424384,1,2,3
trekt,25.8675217969,5.82996073846,1,2,3
never,25.8566020667,4.8956013972,2,2,4
cardd.sd,25.8532465678,4.87717030396,2,2,4
alaskan bull worm,25.8522960737,4.13753000612,3,2,5
wohlgey,25.8480223327,4.62310175759,1,2,3
flab,25.8464332222,4.2535180345,3,3,6
epengu,25.8417466144,3.65660400068,3,4,7
nars,25.8376497848,4.97876220169,2,2,4
olbus,25.8361741255,4.65277053374,2,2,4
mova,25.8348865627,3.78590144304,3,4,7
remy,25.832592141,4.85126907476,2,2,4
1frame,25.8269056032,2.40441725309,7,12,19
curlyq,25.8243983383,4.86490465838,1,2,3
simba,25.8228824624,3.24470782097,5,6,11
papyrus,25.8186124615,5.17095960948,1,2,3
wonderbean,25.8167919778,3.47061819685,5,4,9
miles,25.8126001583,1.82848048868,14,19,33
mkan,25.8105524259,5.03550322432,2,2,4
final,25.8071627601,3.68329874226,4,4,8
nibbity,25.802701175,4.67259516626,2,2,4
reubthedoob,25.7988725144,4.96771285802,2,2,4
sickroy,25.7957677362,5.72130419674,1,2,3
vorpal,25.7893380674,5.01409992653,2,2,4
burrito mobile,25.7889810147,4.61911031066,2,2,4
pbz,25.7828729977,3.58586244386,3,4,7
lars,25.7827328084,3.89578628368,3,4,7
weez,25.7818856232,4.96151338148,2,2,4
lgt,25.7788991842,4.78413217506,2,2,4
nack,25.7767383043,4.75815120016,2,2,4
smillzor,25.7754630156,4.3730688359,3,2,5
mari,25.7730367023,4.80373265722,2,2,4
2framez,25.772138149,4.50371495679,3,2,5
slacks,25.7687843309,3.63946463455,4,4,8
moistbruh,25.7679081693,3.70067319901,5,4,9
toast,25.7670186671,5.86653932641,1,2,3
freestylin,25.7666538391,3.53947069499,3,4,7
mindlessperson,25.7593741932,4.83577597411,2,2,4
whoopiecow,25.7592818187,4.87527767931,2,2,4
sunshinestatefishing,25.75815169,5.83451147477,1,2,3
mdm,25.7556890748,4.8247849331,2,2,4
dinosaur29,25.7515529711,4.55307601147,3,3,6
maskproducer,25.7504765198,4.87708981355,2,2,4
ross,25.7494083716,4.03739062692,3,4,7
wingie,25.7493160374,4.10368481224,3,4,7
darkstorm,25.7407382069,4.21275829294,3,3,6
jayfro,25.7406078512,2.69710397943,7,8,15
breeze,25.7345337374,5.04622128997,2,2,4
biff$$$$,25.7342622817,3.92033082105,4,4,8
teach,25.7330172924,5.90042521159,1,2,3
gobi,25.7273678054,4.86805548259,2,2,4
dr. gg,25.7251587064,3.56568508592,5,4,9
pewter,25.7227337131,4.64530414081,2,2,4
pillars,25.7227102746,5.17745194127,1,2,3
chuck lee,25.721404734,3.66946417024,4,4,8
steven,25.7189818768,6.23983584333,1,1,2
ben123dx,25.7189818768,6.23983584333,1,1,2
yamcha,25.7189818768,6.23983584333,1,1,2
sharkboi,25.7161222923,5.15044624577,1,2,3
bungwipe,25.7155872453,4.29537706454,2,2,4
jr,25.7131282751,2.8200832459,6,7,13
salt,25.7107908562,2.3101600971,10,16,26
yankee,25.705945099,2.13148382462,12,15,27
lillbaskern,25.7046105962,3.13532984431,6,6,12
moms regretti,25.7037214581,4.75269357851,2,2,4
suds,25.7033200131,3.76199560546,3,4,7
flock,25.7002481274,5.09305344445,2,2,4
slacker,25.6992732383,4.16504551459,3,3,6
exit,25.6917353971,3.5002439217,4,4,8
afb,25.6903628665,4.95776916219,2,2,4
kelan,25.6805095418,3.36299992282,4,4,8
lightlybaked,25.679569064,4.83485171199,1,2,3
yungwavedash,25.678395121,3.63895324123,4,4,8
nfreak,25.6746689347,2.44710316925,10,10,20
mox,25.6744217709,3.42236537404,5,5,10
napz,25.6739875129,5.09420136591,2,2,4
grapefruit,25.6715681962,3.37698952672,4,6,10
bund,25.6711147198,3.81277107111,3,4,7
corn,25.6695964807,4.85472355655,2,2,4
captain love,25.6690053521,4.06624622504,3,2,5
kaenzune,25.6648008482,3.88684667636,2,3,5
stormchicken,25.663831317,4.86046755824,2,2,4
plasticlaces,25.6581834124,5.34037481003,1,2,3
mamu,25.6567928239,4.86681099437,2,2,4
slapchopchamp,25.6537753313,4.24499124642,2,2,4
vi,25.6536386328,3.33555776853,4,7,11
12yearsdungeon,25.6526206643,4.76758065925,2,2,4
whiskeyd,25.6514772162,4.85404401533,2,2,4
sage,25.6488556071,3.03545824625,6,6,12
moonsloth,25.6456117474,4.9400501537,1,2,3
sick_bastard,25.645592343,4.9724276662,2,2,4
g.i. moe,25.644919534,4.45490267794,3,3,6
joseluisasdfg,25.6425392944,4.33845413191,3,3,6
agud,25.641517394,4.4483790401,3,2,5
bapmoney,25.6391728354,4.1909029068,3,4,7
zed,25.6371511348,5.01289918792,2,2,4
boosy,25.6327650535,3.78833263504,3,4,7
octobear,25.6281659171,3.80557388996,3,4,7
jmyl,25.6260681812,3.81238752517,2,4,6
pootthebox,25.6239773151,3.34550212292,4,6,10
arsenals,25.6204089087,4.53930711143,2,2,4
oldmankarp,25.6200289715,4.66351607293,2,2,4
koala,25.6180487614,2.66856724674,8,9,17
tm75,25.6143302289,4.30777272426,3,3,6
downaironly,25.6109468322,4.91184094547,2,2,4
gtea,25.6109371933,3.90653927067,4,4,8
peen,25.6076504782,5.27292228161,1,1,2
fulltilt,25.5950467098,3.9773217149,3,4,7
juice,25.5934471318,2.44140799269,10,10,20
miwa,25.5883678496,5.39487502784,1,2,3
hashi,25.5837876714,4.47706614639,2,2,4
savage,25.5793097858,2.9952832356,4,7,11
batistay,25.578462514,5.20692511643,2,2,4
sino,25.5746205219,4.80357956739,2,3,5
funkymacgee,25.5710046129,4.96722899341,2,2,4
double rainbow,25.5678925264,4.8504128983,2,2,4
tieske,25.5662374101,5.22090010563,2,2,4
big guy,25.5599757722,4.88289683721,2,2,4
beej danger,25.5582983741,4.90152217027,2,2,4
dro,25.5508117701,4.94636209272,2,2,4
poe,25.5494435495,5.02147726688,2,2,4
tfec,25.5454456743,4.92530382364,2,2,4
vegas,25.5448427209,3.77176269991,3,4,7
maestro,25.5442595652,4.6443946503,1,2,3
cooper,25.5409507102,4.79462259033,2,2,4
lac,25.5400015731,5.00655410872,2,2,4
fractal,25.5399908966,4.39115720053,3,2,5
blade runner sucks,25.5316041732,4.89965928563,2,2,4
229,25.5298978499,4.95256200267,2,2,4
howie,25.529563645,4.54758622171,3,3,6
scoot,25.5289335765,3.47734638217,5,4,9
aerodet,25.5248815669,4.12390235574,2,2,4
rawdrigo,25.5233055537,5.07981304467,2,2,4
zamassus,25.5187059778,4.60733450256,3,3,6
flippy,25.5147491949,2.67709201355,9,8,17
big time rush,25.5124862376,4.70441661381,2,2,4
hung,25.5108131929,4.22726802773,3,2,5
relish,25.5082985801,4.84822841085,2,2,4
quist,25.507110856,3.25554390623,4,6,10
shybagger,25.5061732846,5.01909636491,2,2,4
girony,25.5041065993,4.75830335146,2,2,4
zelpher,25.4953586333,3.82122253831,4,5,9
thundrio,25.4952964712,4.65574885591,2,2,4
robm,25.4935827135,4.01908190093,3,3,6
sexy,25.4906633459,4.9577269243,2,2,4
darksilence,25.4869699807,4.0219021922,3,4,7
kingu,25.4866833516,4.85446654914,2,2,4
batterydc,25.4860124396,3.36905851332,5,5,10
overground,25.4852795796,4.28149883964,2,2,4
sweetyjesus,25.4823223584,4.65239992111,2,2,4
blazingsparky,25.4798816342,4.78923196952,2,2,4
strider,25.4783897008,4.9155043594,2,2,4
robb,25.4767552874,4.90111132546,2,2,4
leftover rice,25.4754871327,5.01190753657,2,2,4
sangho,25.4708822444,4.80243715313,2,2,4
crashman,25.4697419246,4.26017571995,3,3,6
scrambled,25.4656424289,5.0585197093,2,2,4
affirmative action,25.4647118438,4.65423928671,3,2,5
heketzu,25.4644340777,4.74114139024,2,3,5
cop crusher,25.4623011765,5.04757608849,2,2,4
slickis,25.4618793697,4.79885256667,2,2,4
aquamelen,25.459791837,4.95022004649,2,2,4
shel,25.4551442223,4.98940043963,2,2,4
papay,25.4535854338,5.28981581477,1,2,3
onepunchman,25.4516200186,3.20974941305,5,7,12
bananashark,25.448413044,4.40006735007,3,2,5
blink,25.4453176473,5.49427265794,1,2,3
anto,25.4451246846,3.1949546899,3,6,9
rbag,25.4396454878,5.77954372088,1,2,3
r4rice,25.4368495454,5.00816242877,2,2,4
izze,25.4309029838,2.02138351398,12,16,28
aymen am,25.4297005931,4.14505717456,3,4,7
ph$,25.4278553631,5.47304751028,1,2,3
whiskey milk,25.426250917,3.96685748136,3,4,7
pvc chris,25.4260573359,5.10087630775,2,2,4
sleeptalky,25.4239535564,5.72032945407,1,2,3
boosted,25.4217994436,4.8331565949,2,2,4
pono,25.421739616,4.86792099188,2,2,4
wyne,25.4208943,3.80089654498,4,4,8
rgb,25.4182874115,4.88815718407,2,2,4
briscoe,25.4178233334,4.58497850938,2,2,4
cyber,25.4124600393,5.5360041238,1,2,3
the k.i.d,25.4096639776,5.75529019843,1,1,2
maru,25.4079407279,4.86258451092,2,2,4
tyle,25.4062864143,4.98701446424,2,2,4
loid,25.4033054109,6.44721208934,1,1,2
electroswoosh,25.4019863045,4.73814203284,2,2,4
old mcjonald,25.3997686381,4.60237977192,2,2,4
joelypoleybigbelly,25.3968979489,5.47869703663,2,2,4
fate,25.3964101092,3.70018508473,4,4,8
nuggetz,25.3957280161,4.84714887313,2,2,4
dwreck,25.3821376231,3.86415326445,3,4,7
geekliftus,25.3794817177,5.28969060244,1,2,3
straight,25.3794817177,5.28969060244,1,2,3
theroyalwe,25.3730402092,5.62123394756,1,2,3
riviolli,25.369684553,2.62463976139,6,9,15
kaz,25.3672407131,4.88994656366,2,2,4
tack,25.3665495331,4.50587300558,3,2,5
mr.h,25.3636767128,4.83453290898,2,2,4
nickelsclam,25.3617769153,4.75989705542,2,2,4
hibbityhoopla,25.3609427863,5.10238206002,2,2,4
slock,25.3591976586,4.10325151505,3,4,7
af,25.3557108993,4.72670833393,2,2,4
neth,25.349731385,4.75338350275,2,2,4
josesanmansquito,25.3478326956,5.53855794872,1,2,3
yam4,25.3459463343,4.39193207494,3,2,5
sleeves,25.3457493164,5.1035874048,2,2,4
destruben,25.3439140742,3.85141907429,3,4,7
supbro,25.3428077075,4.84471439319,2,2,4
lay,25.3423834084,3.81334601636,3,4,7
wolff,25.3421325986,5.45350305532,1,2,3
jsun,25.3418067025,3.83160818878,4,4,8
r2,25.3387031008,5.82104381048,1,2,3
kappatainhs,25.3378644442,5.14289779239,2,2,4
dingding,25.3295467198,4.72345199055,2,2,4
xlax,25.3286388609,3.66513138248,4,4,8
pcgbones,25.3272636347,4.86314997433,2,2,4
pascetti,25.3267625769,6.08924942075,1,2,3
horus,25.32479044,5.67372497205,1,2,3
loafers,25.3238077674,5.00127179338,2,2,4
item,25.31869547,4.09457582453,3,4,7
rarebitfiend,25.3169795058,5.23150905287,2,2,4
elites,25.3167865793,4.93146880803,2,2,4
nonsense,25.3119198382,2.74403438468,5,9,14
ken2,25.3110345059,4.67842162263,2,2,4
blues clues,25.3106126615,4.79172811204,2,4,6
gay falcon,25.3090638639,4.33318402156,3,2,5
durgh,25.3071927978,4.34339285435,2,2,4
kjon,25.3067553586,4.76349163471,1,2,3
spell,25.3061703509,4.91910321844,2,2,4
jepr,25.3044573906,3.54299881472,3,4,7
yungbami,25.3035030345,4.91502448026,2,2,4
abadango,25.3007170093,5.27620523974,1,2,3
tdude51,25.2961345291,3.85793556287,4,4,8
sukou,25.2960993594,3.33800677551,6,6,12
pest killa,25.2938413648,5.78483335764,1,2,3
berry,25.2922955465,3.80149070352,3,4,7
nickysea,25.2921377017,4.66430533819,2,2,4
saucetin,25.2920047788,4.95188747225,2,2,4
the d,25.2854151276,4.40662360299,2,2,4
tino joe,25.2846891432,4.76528145999,2,2,4
disk0,25.2810698567,4.91479414831,2,2,4
tanner,25.2804360407,5.68414178689,1,2,3
balatee,25.2783992918,5.92587699257,1,1,2
trev,25.2766124262,4.35580592757,2,2,4
lamb,25.2715265639,4.86219532088,2,2,4
slob on my knob,25.2689689047,5.00327966041,2,2,4
northstar,25.26688223,4.15495677262,2,4,6
modgy,25.2593175094,4.40160672215,2,2,4
koleslawing,25.2582426616,4.58457255846,2,2,4
metlwing,25.2559766449,4.6870525643,2,2,4
method,25.2540556461,4.9265753216,2,2,4
ironblock,25.2540556461,4.9265753216,2,2,4
boandrew,25.2540556461,4.9265753216,2,2,4
meh,25.2540556461,4.9265753216,2,2,4
jt,25.2540556461,4.9265753216,2,2,4
machinegungeek,25.2540556461,4.9265753216,2,2,4
branchan,25.2540556461,4.9265753216,2,2,4
jacobyf,25.2540556461,4.9265753216,2,2,4
readbarren,25.2523478535,4.9311056959,2,2,4
barry,25.252173221,3.88616549203,3,5,8
pleb,25.2509412764,4.90148571597,1,2,3
whisky wizard,25.249345031,4.8378489582,2,2,4
minymidge,25.2482391222,4.61271513642,2,2,4
vorpalstorm,25.240063276,3.66037868934,3,4,7
coffeemug,25.2392864759,3.79713232335,3,4,7
independent,25.2361364412,4.90412279177,2,2,4
chimera,25.2337897694,4.84529723261,2,2,4
cho,25.2301541969,2.40473399853,8,12,20
gelp,25.2249156648,3.23502241645,6,6,12
chinchilla,25.2216503245,3.60774731362,4,4,8
plasmius,25.2205383559,3.33352848187,5,6,11
torp,25.2169802338,4.31813698073,2,3,5
nuro,25.2157735667,4.56956042039,2,2,4
helix,25.2109930758,5.19887747811,2,2,4
hot toddy,25.1959564626,4.3398720495,2,2,4
sweattypad,25.1922651801,4.45483124217,3,4,7
pizzamaster,25.1922113196,5.03674806322,2,2,4
exotonic,25.1865961572,4.68169038818,2,2,4
berk,25.1844680651,4.99773163864,2,2,4
employee,25.184330058,5.02624762068,2,2,4
db,25.1837508937,5.02772680045,2,2,4
iorissbm,25.178904587,4.69351580773,2,2,4
enduro,25.1774985263,4.87428361163,2,2,4
dream,25.1770972822,5.10062328554,2,2,4
frame$,25.176002332,4.90767299178,2,2,4
flatline,25.1721693883,3.92745855718,3,4,7
slappy,25.1692673901,4.9035725701,2,2,4
cuda,25.1681982168,4.92281019612,2,2,4
elemental,25.1664673094,5.68380612776,1,2,3
animal control,25.1661145036,5.20294305083,2,2,4
arm,25.1650268808,4.80951102397,2,2,4
gradymac,25.1635454176,4.67449851109,2,2,4
mega,25.1633634722,4.57200004341,2,2,4
james landino,25.1523074929,3.79483505213,4,4,8
butt zone,25.1516029238,3.41765822727,5,6,11
thatnastypasta,25.1503491112,5.05298215659,2,2,4
ddasd,25.1452268018,4.76422559442,2,2,4
argyros,25.1395919037,4.88048177123,2,2,4
fonzie,25.1395919037,4.88048177123,2,2,4
chewy,25.1389426107,4.82736297447,2,2,4
td,25.1286371787,3.80739950425,2,4,6
impact series,25.1277625863,3.69722476681,3,4,7
sauce,25.1274522851,2.54798791708,8,12,20
fiercekyo,25.1257493202,4.91426923128,2,2,4
ilskowa,25.1255330202,5.74882452225,1,2,3
doctor hu,25.1217597937,4.47766080217,2,2,4
silenceghost,25.1103380349,5.5785774963,1,2,3
soy,25.1048946009,3.72722071197,3,4,7
thatoneperuvian,25.1009713284,3.75006343146,3,4,7
gildo,25.0972255819,3.4469899805,4,3,7
n7,25.0952912874,5.29483726707,2,2,4
desolation,25.0946456859,4.90886016686,2,2,4
donny p.,25.0944371937,4.73746441213,2,2,4
dla,25.093502934,2.24004491186,7,11,18
808,25.0921610587,5.11004221937,1,2,3
bees!,25.0916495597,3.89326641264,4,3,7
in progress,25.0862392615,3.74274738243,3,4,7
zzz,25.0817978973,4.08921786147,3,4,7
amdrew,25.0783061609,2.82334343551,7,8,15
adust,25.0774950171,4.65843175234,2,2,4
zookie,25.0749541563,4.21384370368,2,4,6
pipes,25.0719238823,4.0070941039,3,2,5
siegfried,25.0629583335,3.81882245163,3,4,7
ramrow,25.0603929131,3.66872232126,4,4,8
sveet,25.0590857261,2.18321245584,7,13,20
jules,25.056806044,2.71983170899,5,13,18
dre peng,25.0517963805,5.3003531061,1,2,3
mr._hui,25.0509780367,3.81990249059,3,4,7
osully,25.0456697232,4.71792698048,2,2,4
mrsa,25.0424011403,3.71950066172,3,4,7
jekku,25.0423774497,3.22226529282,5,7,12
squire,25.0417860092,4.85820136478,1,2,3
curlydave,25.0368845237,4.71181362529,3,3,6
dankyou,25.035279965,4.87248327784,2,2,4
r-1,25.0333437514,4.94995906503,2,2,4
frogman,25.0284666593,4.83231345257,2,2,4
condor,25.0251361157,4.93970276262,2,2,4
liz,25.0236141751,5.03661252716,2,2,4
miggs,25.0220650526,5.0796308829,1,2,3
other guy,25.0186655441,5.08369019624,1,2,3
snacks,25.0147378355,5.26495876283,1,2,3
b,25.0105445262,3.9855611697,3,4,7
fehrar,25.0066412789,5.80012657397,1,2,3
yogurt,25.0036470545,5.03694537239,2,2,4
kai,25.0033267741,5.62302563889,1,2,3
smokin' penelope,25.0021167033,4.83701880978,2,2,4
exembe,25.0018095167,5.04416304239,2,2,4
darkdragoon,25.0013689462,5.29098105199,1,2,3
dr. avis,25.0,8.33333333333,0,0,0
hayatoxx,25.0,8.33333333333,0,0,0
notorious,25.0,8.33333333333,0,0,0
milk $$$,25.0,8.33333333333,0,0,0
johnjohn,25.0,8.33333333333,0,0,0
richard,25.0,8.33333333333,0,0,0
charon,25.0,8.33333333333,0,0,0
a4nd,25.0,8.33333333333,0,0,0
pistallion,25.0,8.33333333333,0,0,0
oldmiat,25.0,8.33333333333,0,0,0
nuisance,25.0,8.33333333333,0,0,0
idris,25.0,8.33333333333,0,0,0
dankasswondergimps,25.0,8.33333333333,0,0,0
wiggin,25.0,8.33333333333,0,0,0
fury,25.0,8.33333333333,0,0,0
brett3,25.0,8.33333333333,0,0,0
lordtoko,25.0,8.33333333333,0,0,0
octomom,25.0,8.33333333333,0,0,0
freeze!,25.0,8.33333333333,0,0,0
nguyenning,25.0,8.33333333333,0,0,0
thelake,25.0,8.33333333333,0,0,0
germ,25.0,8.33333333333,0,0,0
mr.e [rohr],25.0,8.33333333333,0,0,0
angelaanaconda,25.0,8.33333333333,0,0,0
the amazing busterino,25.0,8.33333333333,0,0,0
mr. clean,25.0,8.33333333333,0,0,0
tapez,25.0,8.33333333333,0,0,0
thecrimsonblur,25.0,8.33333333333,0,0,0
weon-x,25.0,8.33333333333,0,0,0
papa,25.0,8.33333333333,0,0,0
walta,25.0,8.33333333333,0,0,0
nishi,25.0,8.33333333333,0,0,0
boback,25.0,8.33333333333,0,0,0
up-besus,25.0,8.33333333333,0,0,0
louis dk,25.0,8.33333333333,0,0,0
ryfish,25.0,8.33333333333,0,0,0
zane,25.0,8.33333333333,0,0,0
renshai,25.0,8.33333333333,0,0,0
ytry,25.0,8.33333333333,0,0,0
kittymw,25.0,8.33333333333,0,0,0
dosrogers,25.0,8.33333333333,0,0,0
silentswag,25.0,8.33333333333,0,0,0
shken,25.0,8.33333333333,0,0,0
awsmsean,25.0,8.33333333333,0,0,0
chrim foish,25.0,8.33333333333,0,0,0
hondo,25.0,8.33333333333,0,0,0
one punch van,25.0,8.33333333333,0,0,0
fluffylemons,25.0,8.33333333333,0,0,0
nwa,25.0,8.33333333333,0,0,0
tryceblazer,25.0,8.33333333333,0,0,0
vist,25.0,8.33333333333,0,0,0
carpenter,25.0,8.33333333333,0,0,0
twentytwo,25.0,8.33333333333,0,0,0
mom [jamerson],25.0,8.33333333333,0,0,0
jnew,25.0,8.33333333333,0,0,0
unvalued,25.0,8.33333333333,0,0,0
tommy,25.0,8.33333333333,0,0,0
indie_dave,25.0,8.33333333333,0,0,0
fde,25.0,8.33333333333,0,0,0
makno,25.0,8.33333333333,0,0,0
candlefire,25.0,8.33333333333,0,0,0
kfp,24.9969655976,4.02605721496,3,3,6
cpn,24.9921813691,5.60905309488,1,2,3
honeybaked,24.991337683,4.99282205647,1,2,3
drlight,24.9884705755,5.29475617174,1,2,3
outthecuts,24.9880219045,5.03509317079,2,2,4
corruption925,24.9872089401,3.69945418487,4,4,8
ijiz,24.9846810628,5.12321696121,2,2,4
vice,24.9841502586,4.27542669959,3,4,7
man,24.9836172286,4.22498543588,3,2,5
skate,24.9786319097,1.81852993065,15,18,33
watrboy,24.9780255257,4.5473043016,2,2,4
cottoncandy,24.9779866711,4.89891334508,2,2,4
griff the jiff,24.9779866711,4.89891334508,2,2,4
semen demon,24.9779866711,4.89891334508,2,2,4
howdoismash,24.9779866711,4.89891334508,2,2,4
jazz,24.9779866711,4.89891334508,2,2,4
burman,24.9749033163,3.55615175533,4,6,10
yert,24.9734269151,5.40276953242,1,2,3
whitefiction,24.970136152,5.28727850418,1,2,3
robohobo,24.96864444,5.04163581391,2,2,4
vitamind,24.96864444,5.04163581391,2,2,4
saucy pirate,24.96864444,5.04163581391,2,2,4
themagnumdragon,24.96864444,5.04163581391,2,2,4
palm top,24.96864444,5.04163581391,2,2,4
lupoor,24.96864444,5.04163581391,2,2,4
tönt,24.96864444,5.04163581391,2,2,4
spookyman,24.96864444,5.04163581391,2,2,4
imnotgood,24.96864444,5.04163581391,2,2,4
gerryog,24.96864444,5.04163581391,2,2,4
$haqtus,24.96864444,5.04163581391,2,2,4
lev,24.96864444,5.04163581391,2,2,4
tid,24.96864444,5.04163581391,2,2,4
steph curry,24.96864444,5.04163581391,2,2,4
ezpz,24.96864444,5.04163581391,2,2,4
thespymachine,24.96864444,5.04163581391,2,2,4
glenjamin,24.9657390723,3.86036881788,3,4,7
crispy,24.963518152,2.95357003367,6,6,12
deathpie,24.9634160644,5.09344014841,2,2,4
austine,24.9630465442,3.62521940248,4,4,8
cosman,24.9628212754,5.39942490898,2,2,4
shakedrizzle,24.9620400294,4.66452228364,2,2,4
boxes,24.9600540252,4.92316779276,2,2,4
panny,24.9589718645,4.87561290988,2,2,4
maus,24.9584653261,5.77972296505,1,2,3
silentakuma,24.958162842,5.04079240374,2,2,4
mo,24.9568134962,2.92862627149,5,9,14
veku,24.9542466833,6.26500222621,1,1,2
r0cket_wizard,24.9542466833,6.26500222621,1,1,2
vonfancy,24.9542466833,6.26500222621,1,1,2
aaronn,24.9542466833,6.26500222621,1,1,2
lauerman,24.9542466833,6.26500222621,1,1,2
argonaut1,24.9538271454,3.08638083639,5,6,11
admj,24.9522053703,5.46093132357,1,2,3
hubes,24.9505395901,3.23186560643,3,4,7
envelope,24.950181302,3.68927001112,4,4,8
sempaikush,24.9484681104,5.03323177565,2,2,4
arakune,24.9482794958,4.21158435612,2,4,6
mertoxiac,24.9454658001,4.91679976595,2,2,4
d-tek,24.9454658001,4.91679976595,2,2,4
e.t.,24.9454658001,4.91679976595,2,2,4
icactusdog,24.9445852623,4.90137957897,1,2,3
npc,24.9431112808,4.754911724,2,2,4
perrilox,24.9425830517,5.03999449386,2,2,4
krazie,24.9419642269,5.60909730385,1,2,3
nipples,24.9379324367,3.29563388763,5,6,11
$wank,24.936844148,2.13022954792,11,13,24
whitemike,24.9333180079,4.81755646252,2,2,4
ziggy,24.9257565556,4.02556237039,3,3,6
piramid,24.922384211,4.78996063861,2,2,4
randy,24.920613388,3.69710687607,4,4,8
yos,24.9122770525,4.51123544324,2,2,4
ryanlightman,24.9116714937,5.0313706179,2,2,4
flashboy,24.9096716352,3.6507493396,3,4,7
paragon,24.898901331,3.57801199467,3,5,8
solithic,24.8953898758,5.02060426962,2,3,5
ezmoney,24.8952111075,5.04057799836,2,2,4
cat wrestler,24.8934721839,4.9430709275,2,2,4
lildragon,24.8910256749,5.07210219943,2,2,4
alday,24.8877980792,5.05094903204,2,2,4
hopscotch,24.8859013715,3.99811270498,3,4,7
dach,24.8837992496,5.45448102553,1,2,3
mcnutly,24.8751376946,5.02882109051,2,2,4
hard reid,24.8751376946,5.02882109051,2,2,4
daicko,24.8751376946,5.02882109051,2,2,4
dabvillefl,24.8751376946,5.02882109051,2,2,4
eiyuu,24.8751376946,5.02882109051,2,2,4
manny,24.8751376946,5.02882109051,2,2,4
enterthekiwi,24.8751376946,5.02882109051,2,2,4
armor,24.8751376946,5.02882109051,2,2,4
d4c,24.8751376946,5.02882109051,2,2,4
jzhao098,24.8751376946,5.02882109051,2,2,4
skaterdude,24.8711175555,5.37400129207,1,2,3
heck,24.8690551012,3.01978798281,7,8,15
guava,24.8660893078,4.57500721361,3,2,5
le toucan,24.8646214269,5.47410113551,1,2,3
bad graphics ghost,24.8581642457,5.37835707874,1,2,3
stringbean,24.8493789609,4.11811515673,3,4,7
tr0y,24.8459508938,4.84624532082,2,2,4
jove,24.8446230079,4.8068354777,2,2,4
ziggawatt,24.8431877102,4.6257348144,2,2,4
boat,24.8405882627,3.55404986524,4,6,10
seanye,24.8347337875,4.74933616775,2,2,4
yalungur,24.8318058098,2.94991514644,7,8,15
cyborgcarlsagan,24.8289111156,4.75196767736,1,2,3
pgd,24.8266225589,3.42636020565,3,6,9
dayz,24.8248358108,4.84902841549,2,2,4
fresh prince,24.8223342864,4.71770120897,2,2,4
gkinfinity,24.8210138324,5.03419233961,2,2,4
ai,24.8209407581,4.92533116434,2,2,4
bah-la-kay,24.8204291874,5.35722000577,1,2,3
emperor,24.816998866,2.52149199024,8,11,19
jimmypop23,24.8160309604,4.53512879125,2,2,4
wanderew,24.8156681114,5.05798528242,2,2,4
supreme,24.8145747657,5.03605455438,2,2,4
guavajuice,24.8145747657,5.03605455438,2,2,4
defiant,24.8145747657,5.03605455438,2,2,4
doubleo_tp,24.8145747657,5.03605455438,2,2,4
zaaa,24.8145747657,5.03605455438,2,2,4
slash,24.8145747657,5.03605455438,2,2,4
taxmoney,24.8145747657,5.03605455438,2,2,4
sizzler,24.8137156297,4.06354547885,3,4,7
furb,24.8136884565,4.92489732841,2,2,4
aspen,24.8111650085,3.975620505,2,4,6
j scott,24.8085847323,5.13164886872,2,2,4
boy,24.8038780134,2.7580006057,6,9,15
sag,24.8032936597,4.70995263658,2,2,4
bake,24.7979839672,5.51723263836,1,2,3
squawk,24.7977260616,4.73508135843,2,2,4
big koley,24.7933913652,4.88119823072,2,2,4
b.man,24.7933808057,4.02457746072,3,4,7
cdrc^,24.7922869588,4.89743102247,2,2,4
coco,24.7910814225,4.79268988745,2,2,4
camgirl,24.7907459685,4.86711097351,2,2,4
kolea,24.7878651879,4.8976278721,2,2,4
luish,24.7854989504,5.65186607873,1,2,3
madgood,24.7839747311,3.63947898018,4,4,8
hotboi,24.7832417746,4.67491697967,2,2,4
bruv,24.7803045933,4.64099122635,2,2,4
mystery,24.7769271531,5.01751833716,2,2,4
bikerknight,24.7767698078,4.40905967096,3,3,6
nilesly,24.7758423323,5.47625334653,1,2,3
bumble,24.7695556123,4.81587716788,2,2,4
hawk,24.7694496186,3.18655764998,6,6,12
canadianbank,24.7647112202,4.87683690848,2,2,4
silent,24.7641582793,4.95416253574,2,2,4
frodan,24.7615665446,4.54888951433,2,2,4
pinky,24.7580818586,5.29372280487,1,2,3
scuttles,24.7548884408,3.51822811263,3,4,7
kaetan,24.7524374698,4.57200030292,2,2,4
buttercup,24.7455898215,2.34925944835,9,12,21
arbeder128,24.7454007163,4.2012446653,3,2,5
bloodhank,24.7439608091,4.54196248224,2,2,4
buddybigtits,24.7439116772,4.86283608084,2,2,4
pilling,24.7418042977,5.48814618303,1,2,3
echopath,24.740679615,4.85796913303,2,2,4
shieldz,24.7357003274,2.87635212057,6,7,13
klemes,24.7343374298,4.94877122001,2,2,4
banana fiend,24.7337098157,4.04435667277,3,4,7
thatkawaiiguy,24.7255676668,5.57472335719,1,2,3
kitsune,24.718614006,3.9523133865,2,4,6
oro,24.7183936968,5.13744534735,2,2,4
flake,24.7164447974,5.02302320494,2,2,4
ez$,24.7151860698,5.27799732526,2,2,4
rob gambino,24.7126394305,5.62925992309,1,2,3
ron,24.7123443134,4.45234177807,2,4,6
mechanicalmarine,24.7122893896,5.30207832561,1,2,3
mr.bones,24.7103572083,5.45791066527,1,2,3
robot owl,24.7025251764,5.5369106843,1,2,3
bigredanimebike,24.7023493983,5.6978337011,1,2,3
scarb,24.700751026,4.42275452148,3,3,6
flytide,24.7000534494,5.04980964843,2,2,4
tuck dynasty,24.7000534494,5.04980964843,2,2,4
stoneyb,24.7000177304,5.60233466246,1,2,3
trustmeimblack,24.6991222212,3.95407225894,3,4,7
sev,24.6980098725,3.80887297117,3,4,7
rky!!!,24.695900265,4.40446909528,2,3,5
yung_life,24.6938774324,4.53171999644,2,2,4
stego,24.6894920008,5.32522800741,1,2,3
sebastian,24.6873724519,4.63168617066,2,2,4
naminker,24.685836826,3.7314805879,3,4,7
nka,24.6855073567,4.61838311197,2,2,4
big huge man,24.6832872387,5.02118010428,2,2,4
hq,24.6825237237,5.05470471075,2,2,4
blinkrider,24.681225022,4.84612921656,2,2,4
kcaz,24.6745740262,4.88829595549,2,2,4
robby,24.6745740262,4.88829595549,2,2,4
jax,24.6745740262,4.88829595549,2,2,4
jameson,24.6745740262,4.88829595549,2,2,4
pretty cool guy,24.6745740262,4.88829595549,2,2,4
ivan,24.6718295443,2.24235856053,8,12,20
tsuinami,24.6713105304,4.25042681288,2,4,6
skam,24.6666018092,3.96415922791,3,4,7
lucas,24.6659643251,4.98326047052,1,2,3
n,24.661827482,5.76738224469,1,2,3
snail6,24.6572158627,4.33999868718,3,3,6
rayd,24.6487585605,3.47502457287,4,4,8
seo,24.6487276357,4.89219276392,2,2,4
stevedode,24.6482394531,3.43013368732,5,4,9
bduke,24.6479791881,3.11188302383,5,6,11
neiled it,24.6463937358,5.03151514566,2,2,4
tars,24.6463937358,5.03151514566,2,2,4
crb,24.6451607557,4.93183724424,1,2,3
moosewad,24.6433182037,3.25180260158,5,7,12
mono,24.6424177217,4.88650439511,2,2,4
chaos,24.6389256833,2.67547254765,6,10,16
birdperson,24.6312638545,3.27870222586,5,6,11
vic vinegar,24.6273745675,4.76550655146,2,2,4
lo1ts,24.6234364168,4.90416703452,2,2,4
scotch,24.6136178088,5.58850975257,1,2,3
boba,24.612811375,3.95052543181,4,4,8
cuppajoe,24.6074939142,5.14451564615,2,2,4
beeyee,24.6009093798,4.65210409262,2,2,4
texas techer,24.597463554,4.85689833998,2,2,4
subsube,24.5973874663,4.71975742206,2,2,4
vesp,24.5945124727,4.26826363035,4,3,7
suplex city,24.5902396939,3.55143991296,4,5,9
bradendu,24.5887579327,5.01787447121,2,2,4
sharkskeepmoving,24.5874902114,4.70331114188,2,2,4
smitus,24.5845960593,4.60545198679,2,2,4
docx,24.5819079826,3.68944552863,3,4,7
oko,24.5797806752,5.61269625221,1,2,3
tiedyeguy,24.5770809447,4.87707806629,1,2,3
shab,24.5762157601,4.76186868463,2,2,4
grape ape,24.5709990361,5.87309554617,1,2,3
daz,24.5706525139,4.81920889572,2,2,4
arias,24.5691883852,4.97935968276,2,2,4
sambuddy5,24.5687116534,3.66795220881,4,4,8
jeffthecheff,24.5686124986,4.26773369098,3,3,6
dnaks,24.5674403815,4.65215729416,2,2,4
oleyy,24.567164489,3.86539838059,1,4,5
thedementedcube,24.5656213311,5.43109342472,1,2,3
stitch,24.5620046377,3.48297855156,4,4,8
wildcard,24.5597887096,4.51964771114,2,2,4
shyguy,24.5589069716,5.58533826324,1,2,3
phaedrus,24.5561938096,5.11867698843,2,2,4
rockhawk,24.556108561,4.23203761616,3,3,6
fred,24.5540435477,4.63241817827,2,2,4
nameless joe,24.5509220725,4.01357536659,3,4,7
sunshine,24.5496634958,2.47726459499,7,10,17
kingbowser,24.5480153126,4.96885472037,1,2,3
kerp,24.5479260532,4.84807772536,2,2,4
kho,24.5478769081,5.16229725447,2,2,4
maritlage227,24.5465521545,5.77305269175,1,2,3
tekk,24.5462106202,5.97477048656,1,1,2
spaghetti,24.5433174232,4.2268803318,2,4,6
peanutz996,24.5272939473,5.05346570348,2,3,5
loud,24.5267310498,4.33844649325,3,2,5
takedown53,24.5184432785,5.07695784332,2,2,4
harmonics,24.5176281972,5.50593138798,1,2,3
jett,24.5139509005,5.05912593127,2,2,4
raxomukus,24.511214696,4.19279005575,3,3,6
gaslight,24.5107838473,5.4850889438,1,2,3
easton,24.5035726511,3.705830213,4,4,8
fastestrock,24.5000742433,3.5054720288,4,4,8
air conditioner,24.4988490698,4.75497302155,2,2,4
sorzan,24.4977830617,5.10833022881,1,2,3
jabroni,24.4966086124,5.04505011462,2,2,4
frozone,24.4958499115,4.87770786702,2,2,4
grazi,24.491326248,4.92391593483,2,2,4
darv,24.490464809,3.66507554,3,5,8
gt,24.4896821263,3.42751190407,4,4,8
forbidden,24.4870169624,5.03557616936,2,2,4
axiom,24.4850412335,5.10528683333,1,2,3
zarlen,24.4847368968,4.9219262478,2,2,4
lōs,24.4799384429,5.41862388726,1,2,3
doodle dork,24.4787615969,4.79114872638,2,2,4
burnin taco,24.4787065391,4.06309226658,3,3,6
acsl,24.4785094534,4.9852303058,2,2,4
puddingpop,24.4639483011,3.36384997477,4,6,10
slugnasty,24.4622563974,4.77407286401,2,2,4
brr,24.4618285985,4.79913458574,2,2,4
kwote,24.4595847876,5.15038453974,1,2,3
cudr,24.4582480014,5.06356359914,2,2,4
bishop,24.4582480014,5.06356359914,2,2,4
eater,24.4582480014,5.06356359914,2,2,4
bluemonkek,24.4582480014,5.06356359914,2,2,4
bude,24.4582480014,5.06356359914,2,2,4
villeeh,24.4547588144,4.62415076789,2,2,4
hoverbootz,24.4530852283,5.50899961975,1,2,3
miamikey,24.4524958182,5.37821870054,1,2,3
weezy,24.4520606657,3.86918575953,4,4,8
crossie,24.4519427158,3.71610051404,4,4,8
lightningjg,24.4500462749,4.76360905095,2,2,4
bakon,24.4499163264,5.42846061934,1,2,3
angryhamburger,24.4481265142,4.88953174236,2,2,4
jwooff,24.4318445485,3.27196491159,4,5,9
princess bumble bee,24.426999537,4.02739460584,3,3,6
lardarius,24.4250203432,3.85982905408,3,4,7
d'comboz,24.4237777578,3.4258774625,4,4,8
cooran,24.417683056,3.41417928778,4,6,10
catzors,24.41765781,4.11259846873,3,4,7
uvve,24.4174898036,4.01900025511,3,4,7
gouf,24.4140709646,7.88704177872,0,1,1
boxer,24.4128344106,4.58187075603,2,2,4
gabytime,24.4107934774,4.43898302835,3,2,5
knocker,24.4089059188,5.04242979617,2,2,4
kity,24.4086575255,3.94006648623,2,4,6
mystic_mane,24.4072875118,5.93983016434,1,2,3
taggo,24.4051474889,3.29886098346,5,7,12
arcade,24.4033273921,4.97593154534,2,2,4
panda,24.4028103196,3.6110814371,3,4,7
tengu,24.4000818944,4.61026307241,3,4,7
ben-to,24.3984053177,4.97707114033,2,2,4
kaytoh,24.3983828368,5.54757888403,1,2,3
wisifox,24.3964134825,5.40538531405,1,2,3
rowsa,24.3949834097,4.182250568,2,4,6
_glook,24.3909677159,3.67196461164,4,4,8
airlines,24.3894315606,4.77807557237,2,2,4
toomanyboxes,24.3793756359,4.23862788443,2,4,6
banban,24.3748363535,5.9961311129,1,1,2
idkidc,24.3738560099,4.56372312081,2,2,4
b17,24.3733754369,5.23526993541,1,2,3
mattybfor3,24.3697708976,5.18504298488,1,2,3
get loose,24.3669585424,5.00341544859,2,2,4
birdup,24.3649082521,4.08083546606,3,4,7
corasaur,24.3622445267,4.76300244299,2,2,4
snowboardcat,24.3578622405,5.03402911414,2,2,4
led free,24.3557714148,4.62975166228,2,2,4
apples,24.352836381,3.83554420902,4,4,8
firenze,24.3477654171,5.90400724066,1,2,3
piggly,24.3474361303,5.00650023973,2,2,4
awol,24.3459527811,5.12137988475,1,2,3
eli,24.3447903543,3.81507233875,3,4,7
mucho,24.3423513391,5.28760762303,1,2,3
noxd,24.3415169422,4.98020341457,2,2,4
ferey,24.3400607661,4.72468452915,2,2,4
mercury,24.3375071443,2.90024555836,4,8,12
huckleberry dog,24.3345583523,5.2455412294,1,2,3
pchu,24.3318277176,6.03219540525,1,1,2
bestpie,24.3318153608,4.11088481484,3,4,7
seven,24.3283622006,5.04985079081,2,2,4
weis,24.326575096,3.34840878361,4,6,10
ncr0,24.3251905623,3.45219893074,4,4,8
shchoo,24.3198365068,5.01593242442,2,2,4
yam$,24.3195025017,3.29257338535,4,6,10
feynman,24.3164591881,3.80850581411,3,4,7
wevans,24.314721179,5.60038568376,1,2,3
0rah,24.3130718453,5.25368388513,1,2,3
dexteria,24.312737657,4.54928257555,2,2,4
lifeline,24.3126366398,4.04727132311,2,4,6
slaw,24.3098146012,5.57453891736,1,2,3
red,24.3052738001,3.10755153378,5,7,12
lkan,24.2997279797,5.34291939987,1,2,3
gold,24.2992553298,3.20080938802,5,8,13
samura1man,24.2992436999,4.64325759558,2,3,5
rev,24.2958978522,3.48989257019,4,6,10
quak,24.2916243387,5.54397856485,1,2,3
youtwo,24.2890824158,5.6407120281,1,2,3
snabbdjur,24.2819079649,4.40251377185,3,3,6
cartega,24.2782817401,4.94296930301,2,2,4
ship,24.2721884788,2.89759102711,6,9,15
sheepnado,24.2644767083,4.62210775921,2,2,4
sute,24.2572194776,5.27515566855,1,2,3
nuthingdude,24.2567382065,4.69343891704,2,2,4
quibsy,24.2500285211,5.06148181797,2,2,4
pilot,24.2493434596,1.85599851153,17,22,39
lemon water,24.2423729117,4.64705355139,2,2,4
jinra1,24.2421871024,5.12935435787,1,2,3
daga,24.2350185319,3.46672718585,5,6,11
njm,24.234969852,4.4733733858,2,4,6
milk$,24.2302882699,4.70158872727,2,2,4
deeper,24.2269088527,6.32856258326,1,1,2
ezreal,24.2211119175,5.36845248,1,2,3
mistasleepa,24.2171651572,4.70840291086,2,2,4
spooplord666,24.2149354864,4.9868601775,2,2,4
brophet,24.2121340744,4.89682387614,2,2,4
play4fun,24.2118476263,4.25406056607,3,3,6
stoked,24.2080104387,4.19620049454,2,4,6
papapaint,24.2079784626,3.9570223364,2,4,6
schis,24.2012837624,4.59840410413,2,3,5
helpmeherbdean,24.2003876181,5.81088574909,1,2,3
vertex,24.1983227472,5.12801247492,2,2,4
douhboi,24.1973108256,4.09458717299,2,4,6
stone watcher,24.1953208224,4.8803981922,2,2,4
rizner,24.1949792674,2.69776208162,5,8,13
broasty,24.1917113232,5.62227972283,1,2,3
nimbus,24.1905597851,2.52289685951,7,10,17
pang,24.1868506802,3.79656715222,2,5,7
smoof,24.1848909915,5.43869857548,1,2,3
dmac,24.1815780509,5.99410649601,1,1,2
deedaa,24.1790126106,5.85314998619,1,2,3
layabout,24.17880876,4.19569926676,3,3,6
ppp,24.1785519513,4.77761893709,2,2,4
deoxiclean,24.176650669,7.76636995385,0,1,1
childish landrito,24.1765960292,4.80080217053,1,2,3
cablebox,24.171420769,5.04701359499,2,2,4
xnpio,24.1683904746,4.94059699008,2,2,4
dabeazt,24.166574578,4.80969614053,2,2,4
buns,24.1659442157,4.05824172428,3,4,7
beto,24.1587501993,5.33748790564,1,2,3
tolerablezero,24.1546689085,3.92501253249,3,4,7
13uck5h0t,24.1537749336,5.17068587805,2,2,4
greeb,24.1514014064,4.36459335884,3,3,6
sn3aky,24.1479787915,5.46741996915,1,2,3
sunflowergirls,24.1454727005,5.79211336362,1,2,3
blitxen,24.145017642,5.12135540633,2,2,4
spunky,24.1398284782,5.05030354094,2,2,4
typicalbad,24.1387593977,4.681857868,2,2,4
danggan,24.1370000613,4.69214750308,2,2,4
fizzy,24.1340451571,4.93032866061,2,2,4
rok,24.1300298447,4.87590326944,1,2,3
ham_destroyer,24.1288172246,5.2789835938,1,2,3
djniinii,24.1287280262,4.79591003928,2,2,4
hotdogsafari,24.1265506261,5.79809672212,1,2,3
rubica,24.1245797605,3.33676346145,5,5,10
wsp,24.1206428316,5.15053622365,2,2,4
trash,24.1187790123,4.97777337868,1,2,3
lotus,24.1176958049,2.88538290542,6,10,16
jazzhands,24.1129715926,4.78489239911,2,2,4
viking,24.1117504603,4.03860451559,3,3,6
interfere,24.1114580853,5.89856307368,1,2,3
morphikkhan,24.1077460312,5.73300135502,1,2,3
chillheids,24.0994725803,4.78846949375,2,2,4
toptierramen,24.0975402785,4.02274860964,2,4,6
halqery,24.0972262305,4.82384090842,2,2,4
aroic,24.0945309016,5.20623076657,1,2,3
rentalizer,24.0930378676,5.79394763496,1,2,3
lago,24.0906322359,3.93906660192,2,4,6
savagebeast,24.0895630374,5.76144674906,1,2,3
nacl,24.0858018046,3.38911968336,4,6,10
matt,24.0826658019,3.76523453035,3,6,9
mattan,24.0781124714,2.56251289189,5,10,15
srd_javi,24.077747195,5.28230058633,2,2,4
#80pprr8,24.0755217712,4.51818162515,2,3,5
a.c surreal,24.0746866996,4.74341311828,2,2,4
lorenzo,24.0737716734,4.13932651529,3,4,7
kau,24.0715154939,5.74043447794,1,2,3
boji,24.0704283792,5.80035196033,1,2,3
72centimeters,24.0663003654,5.44127104945,1,2,3
azuleez,24.0642123473,3.72600910612,3,4,7
dr3am,24.0636079216,4.18652686857,2,4,6
ez,24.0622314982,5.36900086314,1,2,3
verthm,24.0603830491,5.54058619642,1,2,3
etone,24.0596151646,5.72101258289,1,2,3
papa johns,24.0594056496,4.40528882336,2,2,4
spacewaste,24.0593407488,6.13932879906,1,2,3
deluxe,24.0591911734,5.19205783182,1,2,3
bdoc,24.0573217138,3.50700464312,4,6,10
kong,24.056283838,5.7068963476,1,2,3
xhyrri,24.0560669232,5.04514624804,2,2,4
mom's spaghetti,24.0550843359,3.91508075726,2,4,6
icearrow,24.051959447,5.71030754499,1,2,3
viray,24.0506770324,4.31358470679,2,4,6
how2play,24.0485293546,4.78077510329,2,3,5
jdb!,24.0477739023,4.72883218467,1,2,3
kevocb,24.0456152363,4.11145088838,3,4,7
frisky fatty,24.0421120981,5.23976594423,1,2,3
anjel,24.0392176269,3.82923348902,3,5,8
toastkitten,24.0353875612,4.00052126587,3,4,7
linkedlex,24.0342837376,4.76048179161,2,2,4
brujo,24.0325158375,5.05035439798,2,2,4
dennis,24.0307184794,4.25350393147,3,3,6
jsal,24.0285118883,4.23248981789,3,4,7
kruel,24.0283973606,5.36175365212,1,2,3
four,24.0277978551,4.84556026844,2,2,4
captain flowers,24.0276502571,5.63387670998,1,2,3
hrsalt,24.0271030107,5.7490002016,1,2,3
vigge,24.0244471655,2.99424044118,5,8,13
grepstar,24.0240813813,3.54611749972,3,4,7
magnadx,24.0188378513,4.83828939648,2,2,4
evbgr_bird,24.0179245302,4.83225605296,2,3,5
dembo,24.0154287701,5.43720256607,1,2,3
destinyfan21,24.0121276634,5.11769380832,1,2,3
dyce,24.0119586207,3.82211455985,4,5,9
sylveon,24.0089045535,3.6007276029,3,6,9
kyball,24.004746427,5.21511124449,2,2,4
benjahls,24.0039513376,7.67208129868,0,1,1
jimmy rustler,24.0038339953,3.87722549081,3,4,7
ruslinjimmies,24.002974663,7.66552016672,0,1,1
vyq,24.0014958374,4.14512047,3,3,6
tusk,24.0014373642,3.74752206231,3,6,9
fatnomen,23.9992941508,4.86255178031,2,2,4
destroyer,23.9991242794,4.85182596827,2,2,4
exjordanary,23.992746436,4.87940576242,2,2,4
perrin,23.9913284563,5.08920246828,1,2,3
nestirr,23.9888027165,4.79588940415,2,2,4
butterjones,23.9882567594,5.62615373079,1,2,3
altamira,23.9867268374,5.6491742866,1,2,3
shoryu drew,23.9860161817,5.45600575461,1,2,3
xurk,23.981597656,3.1631587551,5,7,12
7bananananananans,23.9788244209,3.23495199796,4,7,11
lostsock,23.9779079093,5.47976209111,1,2,3
kupo,23.9770656892,5.98552969463,1,2,3
dyne,23.9749016858,3.33612076321,5,7,12
nurk,23.9706449854,4.1016806898,3,4,7
chobos,23.9605408432,4.74860546675,2,3,5
neon,23.9588241331,5.44200599459,1,2,3
s.o.s.,23.9559011389,5.02607533949,1,3,4
blackknight,23.9552710127,4.82577628853,2,2,4
little shocker,23.9535893239,3.71962077397,3,4,7
firewater,23.9528807286,3.67502739897,3,4,7
mj,23.9513330215,5.03834185122,1,2,3
ikey,23.9491241012,4.13083425572,3,3,6
jeremy,23.9479674416,4.45789824964,2,2,4
vaati,23.9473396269,5.02746903041,2,2,4
saval,23.9459690021,4.81128226168,2,2,4
beer,23.9452612141,5.63033689452,1,2,3
kob,23.9444679302,4.87515386921,2,2,4
brekke,23.9419360481,3.65501154248,3,4,7
q?,23.9416861759,2.58520296589,5,8,13
joebags,23.9294104854,3.67774435434,2,4,6
bortogo,23.9261077929,4.80803034525,2,2,4
spammalanche,23.9132850694,4.98288655899,2,2,4
gnarly,23.9118501638,4.92701138959,2,2,4
chez,23.9031465541,4.83495593366,2,2,4
yep,23.8968222327,2.87527665506,4,8,12
blue,23.8960592753,2.70267335385,7,9,16
yang,23.8920563923,5.34607155944,1,2,3
remark,23.8905138491,3.96252527205,2,4,6
tfs,23.8896806535,5.21418266827,1,2,3
ogma,23.8891239283,5.1222000978,1,2,3
a duck,23.8887404869,4.02182084062,3,4,7
cday,23.886911865,3.60725807833,3,4,7
messiah,23.8766441831,5.53492998345,1,2,3
seth love,23.8746114012,5.59258370902,1,2,3
oathlivion,23.871436112,2.40778550645,8,13,21
markovic,23.8713991601,4.58525735532,2,2,4
psychictandemwarelephant,23.8685043516,5.01780463803,2,2,4
nathan,23.8680381081,5.37749868239,1,2,3
gerb,23.8676594312,4.68757391096,2,2,4
paladin,23.8673469205,4.64855905249,2,4,6
kid a,23.8647612616,4.05446782526,2,3,5
odey,23.8616210806,3.73597092226,4,4,8
morris,23.8587029448,5.38256634146,1,1,2
bron,23.8582822287,5.10058246916,1,2,3
genghis fong,23.8576350086,4.62542980538,2,2,4
pup,23.8555612315,5.00975814347,2,2,4
tred,23.8467745262,2.11512249662,7,15,22
kev,23.846228671,4.22732661763,2,4,6
cornelius,23.8458564616,5.41244071913,1,2,3
gucci swag gubu,23.8432985725,4.67203288824,1,2,3
-1up,23.8425292226,5.02502886934,1,2,3
deliciousoctorok,23.8418078657,2.50019461809,7,8,15
digg,23.8404794066,5.04087719999,2,2,4
mrpoo,23.8403078338,2.42288954833,8,12,20
magebreaker,23.8389643026,5.51831302433,1,2,3
freajk,23.8347080769,5.02068239736,2,2,4
the meadow,23.8344038463,5.18964531704,1,2,3
krisspear,23.8332569777,4.82174489347,2,3,5
olga,23.8332569777,4.82174489347,2,3,5
delay,23.8285781193,5.1960874348,1,2,3
jonny2x4,23.8270057644,5.05511589055,1,2,3
marbleblaster,23.8244644069,4.97664849249,2,2,4
by15,23.8231100182,5.68061266625,1,2,3
majorleagueoddish,23.8221031377,3.72551921445,4,4,8
mochtroid,23.8189366997,5.36735011356,1,2,3
qwop,23.817656141,5.57430766174,1,2,3
chu12ch,23.8107173313,3.9199250268,2,4,6
bootyblast,23.8086111517,4.47442646449,2,3,5
toxic,23.8057538132,5.52218999148,1,2,3
noble,23.8017667123,5.37432445093,1,2,3
xephyer,23.8015176269,5.27537454531,1,2,3
dew,23.7984309373,3.66197004822,4,6,10
x3zinja12,23.7942780426,5.48838880955,1,2,3
sean,23.7913554999,5.34577410633,1,2,3
ads,23.7906939336,5.05841262359,2,2,4
gravity,23.7896857989,3.73524266907,4,4,8
bajef,23.7871379171,3.88161743203,3,4,7
garbage,23.783840866,2.51393461181,5,14,19
| bre4d,23.7782327838,5.43453556877,1,2,3
the king,23.7779121731,5.2547739819,1,2,3
baki,23.7681405368,5.5458920116,1,2,3
necro joe,23.7600612994,5.3177411136,1,2,3
ranger guy,23.759973858,3.72465925153,4,4,8
zodz,23.7596352668,4.59056768553,2,3,5
blynde,23.7591207319,5.35560409218,1,2,3
spectroid,23.7541530621,5.58853464706,1,2,3
reset,23.74939839,4.83361238237,2,2,4
the gerogerigegege,23.7469939513,5.71195818961,1,2,3
enigma,23.7448771586,5.63033100571,1,2,3
toucan sam,23.7417427951,4.9618487793,2,2,4
met,23.7390276253,5.26353909068,1,2,3
bean,23.7380061987,3.27876705791,5,6,11
zaps,23.7375492732,4.51087531107,2,2,4
danimals,23.7335344592,4.98656763003,1,2,3
phazon,23.7298757472,3.86770331068,3,4,7
matty,23.7239395729,4.8150333699,2,2,4
dairgenerate,23.7238372717,4.85086708555,2,2,4
wumbo,23.7197045637,4.03418078963,3,4,7
jlf,23.7192857475,3.90439489131,4,4,8
car_los,23.7132909387,5.11493569669,1,2,3
sureeal,23.7110250447,5.35787872998,1,2,3
shpiders,23.7061931289,5.40008757678,1,2,3
broc,23.6983537652,5.36571700784,1,2,3
killua,23.6953330374,5.46367355014,1,2,3
the ta,23.69518139,5.21438732093,1,2,3
shrub,23.6941554909,5.40420514527,1,2,3
g3,23.6862106115,3.96341737598,3,4,7
merc,23.6825266,3.82432589065,3,4,7
vplatypus,23.6813018544,5.3992372111,1,2,3
c42p,23.6801551289,4.28434297253,3,4,7
bokk,23.6771378919,4.18144915598,3,4,7
nagatocchi,23.6746106218,5.29538574701,1,2,3
kden,23.6717884133,4.8801894116,1,2,3
oddomattx,23.67159835,5.41591035436,1,2,3
leer,23.6709152033,5.15422455961,1,2,3
whip,23.6693266689,5.49767262323,1,2,3
igotbored,23.6680077358,7.50875907872,0,1,1
specialspaceboy,23.6668386802,5.64171241329,1,2,3
raptormoses,23.6626854689,3.7101204024,4,6,10
powerfulgoku,23.6595456657,5.29583406394,1,2,3
big richard,23.6577139976,5.14774229106,1,2,3
fatbomba,23.6557540391,3.97688000634,2,4,6
raichunite,23.6527338001,5.71579584473,1,2,3
nyck,23.6517749577,5.33248173592,1,2,3
botepipapopote,23.6514708572,4.41182984611,1,4,5
your3rdgradeteacher,23.6496686973,4.97422245279,2,2,4
vexis,23.6476372358,5.26208632635,1,2,3
willy will,23.6475673999,5.49542858721,1,2,3
shydude,23.6459146441,5.13307374067,1,2,3
maresch,23.6456373172,5.35960108886,1,2,3
ringzzy,23.6365961728,5.29741965282,1,2,3
sp1nda,23.6329973449,3.99983645518,3,4,7
jonnyfox,23.6306164679,5.13679909551,1,2,3
smbr | southwest | tgbr | understands social dynamics | @ashkon_,23.6299851599,4.80682011338,2,2,4
frank goldman,23.6294118974,5.74494889328,1,2,3
delusion,23.6293651095,4.00298612029,2,4,6
toe,23.6270758817,3.22656182551,4,6,10
cong,23.6233371264,4.12328757425,3,4,7
onyx,23.6055160808,5.43087274194,1,2,3
p2,23.6028395709,3.74670369065,3,4,7
zaz,23.5927024459,5.87780557694,1,2,3
leering,23.5922784757,4.31274543747,2,4,6
,23.5909094284,3.39716718595,3,4,7
joshtinj,23.5838724905,5.33888286056,1,2,3
squazzil,23.5822778811,3.87123249324,3,4,7
hoov,23.5808674855,5.29615884987,1,2,3
knack,23.5777528237,5.66359458241,1,2,3
prilo,23.5756132452,3.09907780303,4,6,10
ben kenobi,23.5731602025,4.78141675842,2,2,4
dcap,23.5686839222,3.81127153683,3,4,7
nj,23.5674987557,5.21081140477,1,2,3
grant,23.5674910067,5.60589449085,1,2,3
loaf,23.5673724165,5.47867729996,1,2,3
house,23.5596510726,5.55102755972,1,2,3
deep♂dark♂fantasy,23.5595778489,4.4779941165,2,2,4
joey,23.554299589,5.85996929076,1,2,3
muta,23.5526088428,4.27456887398,3,2,5
yng$falcon,23.5495121959,4.2500877302,2,4,6
av_ultima,23.5486714141,5.2009461984,1,2,3
sweat,23.5479087374,5.27578568434,1,2,3
hotlineching,23.5473020121,3.83398856331,3,4,7
the trashman,23.5468929121,3.59475762143,4,4,8
jusbeatbox,23.5441798231,5.51300910046,1,2,3
masha,23.5441798231,5.51300910046,1,2,3
lelize,23.543179916,4.11214689179,2,4,6
kumi,23.542836859,2.55402338317,4,10,14
skwiggs,23.5413689129,5.26800337421,1,2,3
xxbounty,23.5367420277,3.53895907256,4,4,8
yushin,23.5342643989,4.10273692297,3,4,7
spaghett,23.5322786292,2.65531047171,8,11,19
peak,23.529306379,5.32515339617,1,2,3
dante dizzy,23.5280148079,5.09920717434,1,2,3
windy,23.5206539727,5.39181336101,1,2,3
gig,23.5202947177,5.54074776245,1,2,3
adct,23.5151710658,4.36590316214,2,2,4
paul the beast,23.5122411021,5.83241845358,1,2,3
typicalswattie,23.5033308907,5.12905042144,1,2,3
rylo ken,23.5020864202,3.89403794363,2,4,6
nunatak,23.4999169262,5.39261873294,1,2,3
coupkey,23.4951407694,6.00534145732,1,2,3
icecreamog,23.4925168144,5.0939374072,1,2,3
n3on,23.4856558613,5.1402298071,1,2,3
peridot,23.483645749,5.84406501065,1,2,3
satch,23.482758264,5.62878107576,1,2,3
woodstock,23.4777665747,5.36421683607,1,2,3
lank,23.4777057007,4.41733925873,2,2,4
lush,23.4728041213,7.47451288639,0,1,1
lunapresso,23.4707247203,5.45523013552,1,2,3
kim$$$,23.4700030846,5.15828474401,1,2,3
chrispcream,23.467182869,7.44593011631,0,1,1
zuul,23.4664283279,3.43079023924,4,6,10
krumbcat,23.4621559126,4.89074379453,2,2,4
graff,23.4587998781,4.56234772156,2,2,4
the oiler,23.4579465291,5.2239947623,1,2,3
king robin,23.4557688747,3.46014414875,5,7,12
[n],23.4549078488,4.1348532413,2,4,6
messi,23.4547181476,3.15711497626,5,6,11
itsadair,23.4544059514,5.03175151382,1,2,3
laugh,23.4519934406,4.9500768119,1,2,3
wooks,23.4508446838,5.43556097703,1,2,3
aquashard,23.45052691,5.47559142598,1,2,3
nerrawx,23.4493288626,5.31639491093,1,2,3
ccucumber,23.446589191,5.24832967666,1,2,3
stylz,23.4419522199,5.42980438113,1,2,3
blubcakes,23.4410316109,5.59784249705,1,2,3
arjuna,23.4375890421,4.77268331548,2,2,4
tipman,23.4374580821,5.84241905599,1,2,3
goaty,23.4369081452,5.42511228184,1,2,3
notechskill,23.4336606059,4.00785276555,3,4,7
bamg,23.4295065228,5.80093703255,1,2,3
jon,23.4294056315,1.86843559873,11,20,31
shadow light master,23.4283335284,5.52772439854,1,2,3
reign,23.4270323635,5.21032627627,1,2,3
check,23.4244586196,5.4134376313,1,2,3
derpy,23.424431294,5.42921086107,1,2,3
the1stson,23.4213361492,4.57136396235,2,2,4
chillmilk,23.4206869739,4.6840432202,2,2,4
tipc,23.4204035237,3.83679627978,3,4,7
grigliamos,23.4168200852,5.94862974911,1,2,3
khan,23.4156242431,3.37455062049,5,6,11
flaccidunicorn,23.4156123858,5.58043742579,1,2,3
abendrake,23.4147432199,5.77324416875,1,2,3
a.c.o.,23.4136361127,5.96008047058,1,2,3
enjoy,23.4135994929,4.04441698484,3,4,7
ceilingpanda,23.4112913537,4.2980603531,2,4,6
fenlet,23.4041733777,5.29111375913,1,2,3
ｈｉｔｏｒｉ,23.4020486328,5.62819756935,1,2,3
teenagemutantgingerturtle,23.3998574467,4.80097715439,2,2,4
sleepy gary,23.3997991397,5.51680587795,1,2,3
trock,23.3928952993,5.30818354401,1,2,3
dogs_johnson,23.3924922813,4.06857185374,2,4,6
voice,23.3921159874,4.20146185026,2,4,6
dank joel,23.3882610053,4.51454481331,2,3,5
fadversity,23.3868451152,4.60355126424,1,2,3
king_purple,23.3861364345,5.71024756628,1,2,3
clock,23.3848191372,4.1103238788,1,4,5
mokocchi,23.3838237488,5.08481835318,1,2,3
doctor moseley,23.3828989069,5.48504741778,1,2,3
slifer,23.3802840199,4.72627588095,2,2,4
space,23.3799334717,3.99166037068,2,4,6
hafwit,23.3769310128,5.3633294659,1,2,3
leo,23.3763772407,5.30405158536,1,2,3
pook,23.3733755934,5.36541934153,1,2,3
ubik,23.3712423067,4.73071115422,2,2,4
boomyx,23.3709241058,7.40327145968,0,1,1
infamous,23.3657497424,5.30089119504,1,2,3
donboss,23.3649087201,4.71516991528,1,2,3
kidney thief,23.3630233165,5.3679044192,1,2,3
knee 'em liam,23.3605654076,5.61251271008,1,2,3
3d,23.3602882688,5.09485284915,1,2,3
anne frank,23.3589686556,5.30482739061,1,2,3
kid stingray,23.3589686556,5.30482739061,1,2,3
snowstorm,23.3589686556,5.30482739061,1,2,3
clubhs,23.3589686556,5.30482739061,1,2,3
vien,23.3583137351,3.95467776025,3,4,7
flanman,23.3530166528,5.31221617606,1,2,3
nickpeaches,23.3523481243,4.5323077373,2,3,5
full mast,23.3523459066,4.8988653008,2,2,4
dessro,23.3514959748,5.03278500961,1,2,3
alamo,23.3489672022,5.1575888382,1,2,3
zane_gillgreen,23.3483149853,4.04426017266,3,4,7
land28h,23.3476475277,4.63298944288,2,2,4
bio,23.3434778459,5.10730581404,1,2,3
dis,23.335129747,5.30388869189,1,2,3
carpet,23.3350045478,5.27966107695,1,2,3
butt aldrin,23.3336284412,5.65373894428,1,2,3
di leva,23.3335622413,4.89120004423,2,3,5
luu,23.3333473301,5.0538975788,1,2,3
supercres,23.3331746206,7.38222897856,0,1,1
fyore,23.3268505435,5.74487353941,1,2,3
banjo,23.3267799349,3.256647741,3,6,9
#pppp9lr8,23.3246821092,4.80662528907,1,4,5
burnt wood,23.3229629367,5.08175545807,1,2,3
buddy,23.322512908,5.73123076874,1,2,3
legend of lando,23.3210381522,5.46211887691,1,2,3
raz,23.3174481383,5.34204425378,1,2,3
generalred,23.3152813668,5.63579095168,1,2,3
t-rekt,23.3149934723,5.49779830819,1,2,3
u01,23.3147915632,5.46499608314,1,2,3
steps,23.3146156448,3.85488907726,3,4,7
brotherly,23.3128204625,5.31926558231,1,2,3
stunner,23.3110333329,5.05381806146,1,2,3
meowmix,23.3096843011,5.64895564759,1,2,3
popkey,23.3077933303,5.0937257994,1,2,3
detrumi,23.3027136793,3.53614780145,4,6,10
ctn,23.298420729,5.63747909221,1,2,3
starcutter,23.29711001,5.13679537485,1,2,3
septagons,23.2958408899,5.93172036389,1,2,3
jack,23.2943672522,2.75259012162,6,9,15
chicago ben,23.2933943906,4.18026868223,3,4,7
danny doritos,23.2930397658,4.7029826917,2,2,4
low expectations,23.2911745304,4.35325572725,2,3,5
novahblazahzx,23.2894532451,5.43060530114,1,2,3
zebkeet,23.2892303392,5.41512049633,1,2,3
scudss,23.2885730817,5.41451056002,1,2,3
3flip,23.2880385027,5.38528678466,1,2,3
gbaby6,23.2807524285,5.30763362581,1,2,3
qualp,23.2776955825,7.5055540715,0,1,1
musichael,23.2719438037,5.15569030533,1,2,3
link2213,23.2703284592,3.01915907487,5,8,13
liberz,23.2701643992,4.17883009177,2,4,6
champloo,23.2690876264,3.92149088006,2,4,6
smackiavelli,23.2669357495,5.39971863376,1,2,3
zopher,23.2666061448,5.29011911802,1,2,3
brontë,23.2666061448,5.29011911802,1,2,3
mimorox,23.2666061448,5.29011911802,1,2,3
bdn,23.2666061448,5.29011911802,1,2,3
dair,23.2647550865,4.83541435573,2,2,4
captwheatroll,23.2637540457,5.41556908453,1,2,3
mr. thunder,23.2621294099,5.31169878632,1,2,3
kushmaster,23.2583840873,5.35070751242,1,2,3
doc brown,23.2582632452,3.59999617818,3,6,9
spoo,23.2558337597,3.88929337551,3,4,7
utters,23.2556342122,5.64415159041,1,2,3
jebailey,23.2547495648,5.13236530307,1,2,3
cfoy,23.2501446189,4.65735964207,1,4,5
poopydungman,23.2489167722,3.95290171631,2,3,5
80-d,23.2465482445,4.95992667077,2,2,4
sorrus,23.2455115657,5.4496591775,1,2,3
fang,23.2437083952,4.21979181092,2,4,6
captain casual,23.2424516193,4.1858200423,2,4,6
cowbell,23.2401574338,4.74209582773,2,2,4
lealmobile,23.2363396478,4.83104006585,2,2,4
mattdemers,23.2341064323,5.39275669312,1,2,3
northballz,23.231924146,5.37441891992,1,2,3
broshadian,23.2257868918,4.32249370455,2,4,6
invis,23.2255648206,4.90356572266,2,2,4
unkn0wnkami,23.2232364774,4.92244800326,1,2,3
flarebear,23.2166165452,5.0289218169,1,2,3
sonnen,23.2160750263,5.28456118682,1,2,3
gucci,23.2159463352,5.5144596192,1,2,3
taiki,23.2159440756,4.1313079596,3,4,7
flux,23.2143438461,2.37870376656,7,13,20
ashy larry,23.2101875237,5.22402850443,1,2,3
sworddancer,23.2037650477,5.37581407204,1,2,3
zimmer,23.2034958664,5.42763586218,1,2,3
ghost,23.1985150321,3.02319174192,5,8,13
wangz,23.1977280461,5.29516925981,1,2,3
lady c,23.1977280461,5.29516925981,1,2,3
redpilledangel,23.1977280461,5.29516925981,1,2,3
kickitsmooth,23.1977280461,5.29516925981,1,2,3
sityec,23.192353981,4.49222418259,2,4,6
todd,23.190996121,7.37102052843,0,1,1
murkywaters,23.1903142641,3.79496939408,4,4,8
pbrake,23.1882632231,5.33958093229,1,2,3
d_lidz,23.187507782,5.40481913706,1,2,3
rh0mbus,23.1871738954,3.88072173377,3,4,7
oddish,23.1848654863,5.41056705062,1,2,3
lost,23.1804669528,5.57793917198,1,2,3
pancho,23.1754879367,3.92038501773,3,4,7
the wash,23.1748025926,5.5491978332,1,2,3
datmawson,23.173494294,7.44808533767,0,1,1
kushwaii,23.170959118,5.16028259635,1,2,3
212 degrees,23.1695232882,5.491146668,1,2,3
rickdb3,23.1691456142,5.2829949038,1,2,3
fastnezy,23.1665618126,4.15717371311,2,4,6
crust,23.1659618456,5.59001875229,1,2,3
fakes,23.1618894094,5.36454201274,1,2,3
quasi,23.161457717,3.49641741113,3,7,10
zychotic,23.1598202954,5.47639394309,1,2,3
gamma,23.1597039164,5.59556014448,1,2,3
coma,23.15589612,5.32825025588,1,2,3
arbitrarychief,23.15589612,5.32825025588,1,2,3
gillionayre,23.1523246766,5.69249727903,1,2,3
invader slim,23.1515820741,3.20100576949,6,5,11
drunkunicron,23.1485244088,4.39548141367,2,4,6
annii,23.1463716261,5.34042218161,1,2,3
kodak,23.1460696669,5.37712482471,1,2,3
johnnycamine,23.1441334407,5.53331093495,1,2,3
bajur,23.1377412112,5.40320723528,1,2,3
adpextwindong,23.1376569233,4.13233454221,2,4,6
therm,23.1365834572,5.53181229105,1,2,3
becx,23.1277737586,5.33456481551,1,2,3
khornestalk,23.1277737586,5.33456481551,1,2,3
kered13,23.1277737586,5.33456481551,1,2,3
ludicity,23.1277737586,5.33456481551,1,2,3
boveda,23.1256645108,4.06503045975,3,4,7
1bm,23.1237759566,4.81873951915,2,2,4
imperatorchris,23.1122439015,4.71014179197,2,2,4
tea,23.1072126992,4.05999038049,2,3,5
xter7856,23.1014018909,5.49372558702,1,2,3
doepp,23.1000537539,4.07110127655,3,2,5
ham,23.0980892683,2.28370647156,9,14,23
surf,23.0978114849,5.60098284192,1,2,3
kid anarkist,23.0973275883,5.54503148164,1,2,3
mel'kaven,23.0972619574,5.36684295972,1,2,3
stels,23.0948007586,4.80595844198,2,3,5
sunnyknight,23.0919797817,5.50774056819,1,2,3
fern,23.0914232404,2.92817695342,4,8,12
homie,23.0899498106,5.56216081538,1,2,3
gongong,23.0871673744,2.79288649929,7,10,17
youngjiddle,23.0733974016,5.14052495856,1,2,3
prioritized,23.0714273432,4.68769130609,2,2,4
cazqu33n,23.0665650823,4.40645418896,2,4,6
klagsy,23.0644619798,4.66413699727,2,2,4
sadfish,23.0635630828,5.17090567332,1,2,3
big ben,23.0630923798,4.14564767708,3,4,7
corgisploot,23.0613258935,5.67844004099,1,2,3
bp,23.0579462663,2.51783062753,6,13,19
y.n.c.,23.0554159253,4.13222148246,3,4,7
zenro,23.054256676,2.75590417126,4,9,13
doghaus,23.0536081734,5.27182071686,1,2,3
rich,23.0532924117,2.30046604526,9,13,22
delarock,23.0525962916,3.74318384244,3,6,9
aspro,23.0516326869,4.96009204352,1,2,3
rottenyogurt,23.0486525042,4.80075521001,2,2,4
sd_justin,23.0418161934,5.17043582649,1,2,3
destinite,23.0410963648,5.62751546646,1,2,3
osubrandon,23.0389250335,5.46557343641,1,2,3
kebin,23.0378105785,5.19305972441,1,2,3
ero,23.0378037468,5.5143162238,1,2,3
mike4real,23.0370020371,4.76728476805,2,2,4
landry!,23.0344981119,3.77267892754,2,6,8
liverman103,23.0334869808,5.35233276415,1,2,3
dono42,23.0260705944,5.05161249028,2,2,4
bootstrings,23.0245746276,5.37763667864,1,2,3
saint shaden,23.0183602361,5.48201270604,1,2,3
forte,23.0175783788,3.56307472817,3,6,9
amishcatfish,23.0145959807,4.60640934542,2,3,5
wishengrad,23.0123922606,5.03273013142,1,2,3
dr. phil,23.0120115935,5.63677907997,1,2,3
thunda,22.9934011243,5.58016805474,1,2,3
okay,22.9933918763,3.91240900396,2,4,6
lax,22.9905048027,4.32857267429,2,4,6
ccoftw,22.9903201717,3.9790477455,3,4,7
frobey,22.9871879076,2.79931536656,6,10,16
frozenspade,22.9870728298,4.1966245949,2,4,6
dtwizzledante,22.9852161496,4.56329219473,2,2,4
gemigumi,22.9837848055,3.55607959215,3,6,9
loke,22.9833738868,4.39082319271,2,4,6
nahr,22.9832449718,5.2708599033,1,2,3
main,22.9775037538,5.17885661462,1,2,3
spicythug,22.9751688674,4.0472033453,3,4,7
yoloyoshi,22.9750717809,5.77781648687,1,2,3
cheesy,22.9719360768,2.62002736357,5,10,15
cravate,22.9682346198,5.32651571242,1,2,3
toby,22.9638903269,5.62673679002,1,2,3
knoll,22.9549362408,5.43405865797,1,2,3
stayqrispy,22.9525628415,5.28905383926,1,2,3
ouro,22.9466559321,5.31222591503,1,2,3
hollow,22.9452538891,5.05551615224,1,2,3
6 lasers,22.9442067745,5.24105403713,1,2,3
airfire,22.9436098339,5.50875424131,1,2,3
shockjock,22.9415185333,5.18170303428,1,2,3
indecisive,22.9397981343,4.93624643046,1,4,5
amoroy,22.9374829276,5.5718875463,1,2,3
lyric,22.9304122219,2.49194185612,8,12,20
wombat,22.9251592719,3.21110037662,5,6,11
jack frost,22.9226716731,5.54958428142,1,2,3
bbbd,22.9206268019,5.2397303975,1,2,3
treechen,22.9197390926,3.5851563501,3,5,8
mysteryfish,22.9196869157,2.75365005258,7,8,15
l81,22.9117273798,5.3723882304,1,2,3
m0nd0,22.9115486203,5.81976544031,1,2,3
dankiel,22.9108340924,5.37546081185,1,2,3
spamus,22.9098490374,4.10703901189,3,4,7
the postal tilt,22.9069282277,5.64589655485,1,2,3
rewind,22.8985142876,3.1435278764,4,8,12
soulster,22.8974643251,4.44708547915,2,4,6
crossfire,22.8915769948,5.45739885756,1,2,3
kfc manager,22.889568183,5.21608428181,1,2,3
grape jelly,22.8853319203,5.18632299228,1,2,3
bandito,22.8840559786,5.19050701735,1,3,4
$pud,22.8833373499,3.39803159983,4,6,10
zeria,22.8821508069,5.43292829467,1,2,3
horato,22.8815305169,5.45284616224,1,2,3
nabi,22.8777738932,5.53366073625,1,2,3
coni,22.8733758613,4.11769001752,2,3,5
oak,22.8681056029,3.21244483171,5,8,13
prodigy,22.8680925464,4.9941015133,1,2,3
vent,22.8677735183,5.19222553096,1,2,3
n1caps,22.8663077525,5.68259200887,1,2,3
tyleor,22.8661363288,5.46516162851,1,2,3
kdep,22.8638759937,5.50915368109,1,2,3
thekillerdude,22.8629630962,5.60060908426,1,2,3
damen,22.8624472185,5.3275284949,1,2,3
bb0p,22.8600191607,4.94513350155,2,2,4
megamega,22.8570834672,5.48062305573,1,2,3
mean as custard,22.8521253873,5.29131218742,1,2,3
woogieboogie,22.8479281543,3.12625766874,5,9,14
guacho,22.8471394627,3.75756709418,3,4,7
wepeel,22.8469599115,2.94572780183,5,8,13
word,22.8456494945,3.90559991024,3,4,7
henry,22.8429000926,4.65327602602,2,2,4
tp_fosho,22.841320024,5.55758561878,1,2,3
penance,22.8406690227,5.33101971058,1,2,3
brokenlawngnome,22.8400518613,5.36152600272,1,2,3
borz,22.8380310455,3.15604767543,5,6,11
boyne,22.8319650911,5.5877586277,1,2,3
645development,22.8281489591,3.87022593492,3,4,7
leyzarz,22.8200527076,4.84455767089,2,2,4
kw/ak,22.8196447727,5.30674932739,1,2,3
grasshoppa,22.8178397314,3.67628734194,4,5,9
flwns,22.8159163906,3.77589929898,3,6,9
mattatari,22.8152712627,4.05845597782,3,4,7
dueceswild21,22.8116010877,4.00417356383,3,4,7
junpei,22.8101869746,4.96331337308,2,2,4
pokenutz,22.8068390814,5.61629312871,1,2,3
highwalker,22.8066456489,5.46941477306,1,2,3
icecream,22.8056979502,5.10801197276,1,2,3
syrup,22.805334558,5.47633376214,1,2,3
big tone,22.8049347127,4.62327552752,2,3,5
twinkletoes,22.7999332859,5.00151177171,2,2,4
whiskeytits,22.7985646974,7.38285927407,0,1,1
drama-sama,22.7979632217,5.34189853392,1,2,3
teardispenser,22.7960438117,5.44898145114,1,2,3
gallegos,22.7936721498,4.81471291384,1,2,3
res,22.7920448164,4.53201101607,1,2,3
medical chicken,22.7911824108,5.29182875059,1,2,3
the_g3nt,22.7908802161,5.46170868411,1,2,3
ytyg echo,22.7902010842,5.44691536624,1,2,3
bananime,22.789654066,5.33776779277,1,2,3
caleb,22.7869632919,3.29065620774,3,6,9
cardoso,22.7849724005,5.33026447952,1,2,3
rhythm,22.7790961672,5.5138446188,1,2,3
onin,22.7786054744,5.64643166372,1,2,3
opiatre,22.7712390577,5.37130691196,1,2,3
djsnowcone,22.7692310669,5.62687495459,1,2,3
tianten,22.7677145148,5.44029803512,1,2,3
hodor,22.7664826525,5.62790872993,1,2,3
koggy,22.7624537813,5.29931337393,1,2,3
double a battery,22.762025812,3.56297475438,2,6,8
lanz,22.7588661042,5.4218225548,1,2,3
king armando,22.7565911747,5.00443067245,1,4,5
r0x,22.7565019243,4.50703633196,1,4,5
prohybrid,22.7524097354,5.49118617289,1,2,3
cube,22.7508305005,3.74193220904,3,6,9
cogzilla,22.750508206,5.31220961063,1,2,3
well dressed jem,22.7484422033,5.14367511844,1,2,3
trepp,22.7448758252,4.91028810198,2,2,4
kujo~,22.7420809558,4.97726570966,1,2,3
hei,22.740592451,4.64840561209,2,3,5
illegalalien,22.739163561,3.44605814984,5,5,10
dømø,22.7338405517,5.74168974131,1,2,3
ironchef,22.7314958216,5.46487398047,1,2,3
exo,22.7302840534,5.5518764481,1,2,3
sto0fo0,22.7285192455,5.49808873073,1,2,3
disafter,22.7267535906,5.5982417442,1,2,3
gnasher-,22.7187695644,5.03974116688,1,2,3
artron,22.7161401038,5.5111231799,1,2,3
dr.g,22.7145908437,5.42027142284,1,2,3
hufsa,22.7129425395,4.60563031285,2,4,6
king cobra,22.7121978424,5.3786247923,1,2,3
trak,22.7112741523,4.95898367551,2,3,5
gojv,22.7110073948,4.39835629373,2,4,6
g1j,22.7091730953,5.53292766555,1,2,3
havoc,22.7076018799,5.09875745312,1,2,3
gingerjesus,22.7058581928,4.35424474529,1,4,5
herbmaster%,22.7048951847,5.30620675312,1,2,3
rabittz,22.7044638357,5.56232518744,1,2,3
raze,22.7037313277,5.70976974308,1,2,3
silent e,22.7020509808,4.74462179253,2,2,4
remix,22.6984721402,2.70101132966,5,11,16
dirty dan,22.6977103312,4.33281781832,2,4,6
uncle carbuncle,22.6939110277,4.82257968024,2,3,5
kidwiththeface,22.6938549853,5.46137516501,1,2,3
chrono,22.6927495619,5.54725487811,1,2,3
bluj,22.687215332,5.49460127979,1,2,3
mrweclaw8,22.686911286,5.26845246838,1,2,3
papa no johns,22.6843669388,4.67059013623,2,4,6
tengil,22.6810281136,4.61294317044,2,3,5
wu2king,22.6798638482,5.50448911227,1,2,3
uncleph1l,22.6778148237,5.43717689715,1,2,3
tblow,22.6776529621,5.27791965357,1,2,3
ranger,22.6730075435,5.53496474968,1,2,3
mushroomcap,22.6698686269,5.61081517036,1,2,3
fakesnakejake,22.6682147927,4.43539234678,2,4,6
scooch,22.6654635052,5.46141430112,1,2,3
rico,22.6629123462,3.27433528582,4,7,11
bricktop,22.6621851442,7.02260418836,0,2,2
kazzini,22.6607636759,5.4938289693,1,2,3
jarido,22.6594067706,5.57805258176,1,2,3
chicken pizza,22.6562900674,4.45678298822,2,2,4
brizola,22.6555802958,5.27154583022,1,2,3
bi,22.6537063891,2.59449028484,5,10,15
nelsquik,22.6496743754,3.90956691031,3,4,7
generic,22.6478289,2.07120880529,11,21,32
oni,22.6454940527,4.71134489321,2,3,5
cross~up,22.6454940527,4.71134489321,2,3,5
joooop,22.6434913064,3.84921644583,3,4,7
beigemush,22.6409050992,3.83509928005,3,4,7
whatarethose,22.6407395029,5.00951408508,2,2,4
bcrypt,22.6347178939,5.6123500672,1,2,3
trasech,22.6327608793,5.57461417469,1,2,3
grandma dan,22.630680953,4.0214923666,2,4,6
seb,22.630641313,5.38878656672,1,2,3
robotnick,22.6303939718,5.38674437076,1,2,3
puppy,22.6269103277,5.3157588196,1,2,3
crispy t.,22.6266051418,5.22842908799,1,2,3
stripes,22.6190132507,5.12433061827,1,3,4
solid dong,22.616981321,5.4845347446,1,2,3
cel,22.6072269463,4.65842719748,1,3,4
objection,22.6058624711,5.58486567763,1,2,3
fnm,22.6057773416,5.17253483131,1,2,3
sweaters,22.598787315,5.20332289702,1,2,3
lildoozie,22.5911429321,3.61798456553,3,4,7
basilikus,22.5877833335,5.34089351655,1,2,3
essjay,22.5857079583,4.69197115401,2,2,4
mambo,22.5822034305,5.38165214933,1,2,3
fries,22.5814256976,4.24364375514,2,3,5
legoman,22.5734955561,5.45045837715,1,2,3
funk,22.5708837933,5.54525921557,1,2,3
judas,22.5695952541,5.24962933935,1,2,3
franknbean,22.5678163142,5.45082823492,1,2,3
osh,22.5653245786,4.83348685594,2,2,4
akbiggs,22.5617456099,5.56506240301,1,2,3
julio98,22.5571025385,5.52497653221,1,2,3
bryciepoo,22.5507923386,3.83917327448,3,4,7
therealjdawgz,22.5469747465,5.55593372952,1,2,3
gothoesinareacodes,22.5452085124,4.07201685279,2,4,6
notkris,22.5448695457,5.57461578132,1,2,3
savior,22.5445596125,3.05923627483,4,7,11
captaindirtybird,22.5433760952,5.61171953212,1,2,3
wallstreet,22.5427537351,5.31964600889,1,2,3
dogface,22.5425814435,5.54822154946,1,2,3
cavelemon,22.5415677444,5.23276945167,1,2,3
voa,22.5397155209,5.44649528993,1,2,3
oppai,22.5388666676,5.07133645283,1,2,3
jakemchale,22.5386845549,5.55732456018,1,2,3
gscar,22.5343540992,5.10809992032,1,2,3
seandabomb,22.5341011892,5.47923389869,1,2,3
pre,22.5329261981,5.43187505975,1,2,3
bad,22.5278020537,5.70326926928,1,2,3
xhinthink,22.5226145083,4.87073608057,1,4,5
dj_not_nice,22.5223301847,5.45929965189,1,2,3
dino,22.5197109494,4.66007356216,2,3,5
avester,22.5177379078,5.54694308364,1,2,3
squidman808,22.5172458739,3.87827624406,1,4,5
ung jedi,22.5106772529,4.18005449655,2,4,6
aysel,22.5057031133,4.695265401,2,2,4
garm,22.5033136926,5.41256653185,1,2,3
raxcity,22.502667867,4.06971260841,2,4,6
kiddo,22.4993294643,5.51192032204,1,2,3
railz,22.4933998782,3.46333313036,4,6,10
scav,22.4924604495,3.48022479399,3,6,9
merlin,22.4835267575,4.59242542373,2,3,5
salvadoc,22.4835034086,3.51989671985,4,5,9
caivs,22.4828754238,4.48681024963,2,4,6
shekler,22.4797562674,5.50007283965,1,2,3
aully,22.4777234694,5.47877268107,1,2,3
mcdonl,22.4777234694,5.47877268107,1,2,3
busy p,22.4777234694,5.47877268107,1,2,3
proc,22.4776996726,3.54536499191,4,7,11
kamikazefuneral,22.4745111724,5.49547536577,1,2,3
yogothewizard,22.4691514326,5.24048868857,1,2,3
ferwat,22.4675286006,4.94943755436,1,2,3
hyperslurpie,22.4662214808,5.41731168126,1,2,3
bladeless,22.4635838941,4.16418972459,2,4,6
thyrfa,22.4627409242,5.53472051393,1,2,3
jaw,22.462355864,5.4737874114,1,2,3
vintage,22.4605062314,5.3146238307,1,2,3
skrull,22.4596135385,3.94868301241,2,4,6
agora,22.4569420218,4.95846759473,2,2,4
awesomebee,22.4534059331,4.7183832889,2,4,6
cmyk,22.4431600079,5.77340790079,1,2,3
shake,22.4383692367,6.0197320913,1,1,2
mac,22.4376821232,5.43917759855,1,2,3
ralphanese,22.4355383442,5.63837769406,1,2,3
higglypuff,22.4348022855,5.54638461884,1,2,3
cosmit,22.4348022855,5.54638461884,1,2,3
sir,22.4348022855,5.54638461884,1,2,3
lvl 20 magikarp,22.4348022855,5.54638461884,1,2,3
binxxx,22.4325940937,5.65830172706,1,2,3
milo,22.4321977995,2.75720548161,6,10,16
schvein,22.4287462859,4.52723143923,2,4,6
ultraman,22.4225633526,4.33204367254,2,4,6
obsidian,22.4167610443,3.37535362808,4,6,10
abszol,22.4161512929,5.19465596656,1,2,3
frozenpizza,22.4142395005,4.18695171797,2,4,6
putpasswordhere,22.4119806199,4.01527035914,3,4,7
regi$ philbin,22.4092133907,7.09826393497,0,1,1
dxpsych,22.407662035,5.30636834743,1,2,3
acx$,22.40656951,4.78298015974,2,2,4
smurph,22.4057941074,5.4660288542,1,2,3
m7,22.4056224389,5.56001733199,1,2,3
bricklee,22.4007186721,5.37926145625,1,2,3
tobbeh99,22.400617521,4.86606477616,2,3,5
poli,22.400617521,4.86606477616,2,3,5
iamlazee,22.3957947106,4.99641558932,2,2,4
xanthus,22.3953366789,5.24714000668,1,2,3
hi,22.394233139,4.0544329349,2,4,6
guerrilla,22.3941363048,4.16082312573,2,4,6
concosta,22.3937353501,5.25641751648,1,2,3
sethlord,22.3935970047,5.24336631,1,2,3
portals,22.3889856223,3.47823525129,4,7,11
nik,22.3887154097,5.27455175504,1,2,3
soymilk,22.387640794,5.5975042456,1,2,3
flaf,22.3826723268,5.11480505922,1,2,3
brosef stylin,22.3798507212,3.73726582506,3,4,7
pseudo seras,22.3785494632,4.30926848001,2,4,6
branflakes,22.3767629646,4.40675357798,2,4,6
halogen,22.3756530396,4.44872874815,2,3,5
juniro,22.370572229,5.40753999525,1,2,3
stdemon,22.3672593788,5.15579649754,1,2,3
captn mason,22.3656394501,3.93434371056,2,4,6
chililtf,22.3652302657,5.17173833797,1,2,3
bigjoe,22.3622396894,5.06775415531,1,2,3
showtime,22.3589679595,2.46234762803,4,11,15
jackzilla,22.3571368196,2.72109773482,7,10,17
snake mistakes,22.3568946606,5.45436058519,1,2,3
bebopbeepboop,22.3533367091,7.16156636113,0,1,1
redrum,22.3471585886,2.88874974574,4,8,12
lucky_hamburger,22.3418384892,5.72549549374,1,2,3
wiggles,22.3417457102,5.42742341717,1,2,3
root,22.341513284,5.53378848395,1,2,3
darelis,22.3408169193,5.52998160864,1,2,3
hobbz,22.3408169193,5.52998160864,1,2,3
squeegee,22.3402640476,5.6833999326,1,2,3
mao,22.3392517902,5.48827027406,1,2,3
pilzlotta,22.3349475636,5.33875277632,1,2,3
buckskinbay,22.3346817996,4.88555182752,1,2,3
bcn,22.3344408534,2.97099649559,4,8,12
aoe,22.3289786698,5.55231832694,1,2,3
keams,22.3286209033,5.36716338262,1,2,3
doby,22.3248876266,3.55365314386,3,6,9
seto,22.3248773289,4.0555520112,2,3,5
king harkinian,22.3211443649,4.22427736097,2,4,6
ellipsis,22.3204378117,4.87128529546,1,2,3
yinja,22.3171818619,5.3494101095,1,2,3
ccubed,22.3164477309,5.34538423764,1,2,3
zebra,22.3091946275,4.26419459472,2,4,6
dr. rainbow bear,22.3083398771,5.33714447856,1,2,3
diamond,22.3065494978,5.59653053801,1,2,3
naythin,22.3033940814,5.58551221072,1,2,3
umi,22.2950630033,5.45881954507,1,2,3
scrapg,22.2950630033,5.45881954507,1,2,3
karn1vore,22.2950630033,5.45881954507,1,2,3
burnaby,22.2950630033,5.45881954507,1,2,3
yansnow,22.2950630033,5.45881954507,1,2,3
caden,22.2950630033,5.45881954507,1,2,3
locksmith,22.2950630033,5.45881954507,1,2,3
keagsbsmashin,22.2950630033,5.45881954507,1,2,3
link,22.2950630033,5.45881954507,1,2,3
moniker,22.2950630033,5.45881954507,1,2,3
rodan,22.2895787418,4.52792689213,2,2,4
modestmajor,22.2886415983,4.44975015179,2,3,5
pvtches,22.2865483766,5.18050043837,1,2,3
abc,22.2848288187,5.69098756388,1,2,3
halfrican,22.2798467582,5.36655435588,1,2,3
lemon zest,22.2762761309,4.90061297854,1,2,3
misfit,22.2732682392,5.47417198066,1,2,3
exoty,22.2730730102,5.44788652947,1,2,3
mercify,22.2707807785,7.03470520775,0,1,1
pope,22.26985024,5.6759517748,1,2,3
ljm,22.2673827604,3.11855378335,3,7,10
hoxton,22.2663972096,5.59773353609,1,2,3
kit,22.2643740147,5.67423125035,1,2,3
krell,22.262360458,5.31460057317,1,2,3
middleman,22.2620158918,5.05292714696,1,2,3
yandi,22.2605412499,7.00206163896,0,1,1
magictree,22.2572615808,2.78006535349,4,9,13
imcv,22.2566178641,5.30372119453,1,2,3
hayd,22.2545472281,5.67131127102,1,2,3
jmlee337,22.2490063762,3.89970539074,3,4,7
t0nka,22.2419556519,5.23989115711,1,2,3
matge,22.2407952811,4.71650032475,2,3,5
gorull,22.2407952811,4.71650032475,2,3,5
spikeuvm,22.2384782847,4.20436386205,2,4,6
bez,22.2361612025,2.67465126236,7,13,20
ash,22.2287553593,4.50438637045,2,4,6
forriggs,22.2190398057,4.75397283157,2,2,4
blizard,22.2184340818,5.01927377573,1,2,3
lojo,22.2166069662,5.68181938318,1,2,3
brassypolecat,22.2156764345,5.50960777756,1,2,3
squidoo,22.2147312857,5.42057434187,1,2,3
basedontruestory,22.2135881203,3.87634909706,2,4,6
jewellery,22.2115568811,5.45095335475,1,2,3
macdslover,22.2099802656,5.20396874648,1,2,3
threejaayz,22.2098189909,5.36435491154,1,2,3
gonzales,22.203505065,5.06614312362,1,2,3
gzlrgzlr,22.2015634503,5.65584116251,1,2,3
stealthypanda,22.1961450171,4.82155808836,2,4,6
maas,22.194357079,5.10850288395,1,2,3
whistle boi,22.1941211272,4.98162788107,1,2,3
crypto,22.1936430205,4.43272391285,2,3,5
datnero,22.1871030451,4.1301093775,2,4,6
akared,22.1843433596,4.35735178524,2,4,6
sickboy supreme,22.1831146696,5.28667450858,1,2,3
bayanati,22.1824836408,5.12446842351,1,2,3
milkwaffles,22.1824801847,5.52053346355,1,2,3
lukatic,22.1806633776,4.6853506841,2,4,6
paisa,22.1792135971,5.31023881982,1,2,3
w8asec,22.1751791967,4.55546616067,2,2,4
dan sam,22.1713918103,5.36618172578,1,2,3
hawkins,22.1695302799,5.46848119908,1,2,3
iffy,22.1684531537,4.06539409652,3,4,7
arkada,22.1673214779,5.5699132045,1,2,3
pickl,22.1662324464,5.64621605293,1,2,3
bibbs,22.1659291589,4.75282343061,1,2,3
kellz,22.1656123078,3.8784134365,3,4,7
odin,22.1650148232,5.42754032521,1,2,3
abobo,22.164200879,5.34205777201,1,2,3
mapletoothpick,22.1636249338,5.45975783105,1,2,3
bigvic340,22.160011742,5.49450789997,1,2,3
jiffy,22.159376956,5.60268535256,1,2,3
fiercewolf,22.1589424724,5.46698235914,1,2,3
f-ric,22.1537174934,5.64294330587,1,2,3
reece637,22.146136368,5.73830715612,1,2,3
master sergeon,22.1399326404,5.26468134428,1,2,3
chucknasty,22.1340127122,5.56853141105,1,2,3
perma,22.1335545706,5.16512331689,1,2,3
ghoti,22.131900247,5.52392652861,1,2,3
undefined,22.1314002853,4.78352491852,1,2,3
magicwan,22.1304769456,5.63705602618,1,2,3
tru,22.1294770028,4.66851526009,2,4,6
bwunt,22.1268460383,5.40967427819,1,2,3
melvin,22.1227244023,5.55058191296,1,2,3
magnet,22.1193843664,4.04674524684,2,4,6
rottenboyz,22.1183802698,5.51856262823,1,2,3
vorde,22.115791164,5.63349771434,1,2,3
zo9ine,22.1107224673,2.96777164607,4,6,10
ce,22.106049926,4.3652907624,2,3,5
george washington,22.1053427497,4.58348712009,2,2,4
attacking zack,22.1035657377,5.49564261514,1,2,3
kipz,22.1019031895,5.38150496117,1,2,3
hhhhhhhhhhhhhhh,22.0996662244,4.43190644308,2,4,6
brett,22.0967410173,5.36343720996,1,2,3
ted greene,22.0961068317,5.26647999432,1,2,3
renegade!,22.0941217786,5.61844692688,1,2,3
swankeaboo,22.0939408466,5.42691849039,1,2,3
applefrorm,22.0938551959,5.26526965856,1,2,3
marri,22.0924684353,5.62708448163,1,2,3
jad,22.0922298511,5.48359999044,1,2,3
dilly,22.0920284357,5.44314183987,1,2,3
ander,22.0877045208,4.69231134392,2,4,6
mojo joe,22.0868844265,4.40058348324,2,4,6
tvfish15,22.0864432836,5.62575211467,1,2,3
treeze,22.0847631009,5.53758031179,1,2,3
judzuu,22.0832446758,5.52720444839,1,2,3
pph,22.0832446758,5.52720444839,1,2,3
srocky,22.0832446758,5.52720444839,1,2,3
volk,22.0832446758,5.52720444839,1,2,3
jaws,22.0826521404,5.24556427587,1,2,3
k1ngcr0w,22.0812181947,5.53363232946,1,2,3
blackg,22.0795222369,4.13422953105,2,4,6
waga,22.0780319604,5.37477078636,1,2,3
slime,22.0767589404,4.44647829417,2,4,6
keiththegeek,22.0765426337,5.01160923434,1,2,3
bblz,22.0746114234,4.68665709788,2,4,6
stoopdapoop,22.0742031315,4.25378374901,2,4,6
black^sheep,22.0728110684,5.52622024907,1,2,3
supermrjmt,22.0725068832,3.6840134413,3,6,9
kidracula,22.0695810618,5.62181335914,1,2,3
seel,22.0654151377,5.41590627604,1,2,3
intersect,22.0629926707,5.18781282694,1,2,3
pilgor,22.0629818257,4.99257733161,1,2,3
bombsoldier,22.0618853432,5.40881041119,1,2,3
spills,22.0526371389,3.75448263222,3,6,9
otak_,22.0520957792,2.85766447098,5,9,14
nochill,22.0518390091,5.42367552841,1,2,3
pil0t,22.0511532004,5.4846880348,1,2,3
beckett,22.05021716,5.64650832995,1,2,3
saphire121,22.0501116251,5.06821109333,1,2,3
senpai,22.0487916157,5.50016510623,1,2,3
kirito green,22.0376437576,5.53207962878,1,2,3
the ram,22.0361917371,5.63964329496,1,2,3
cosmic,22.0340688051,4.2988671009,2,4,6
per hammar,22.0332489723,4.81370693781,1,4,5
octavian,22.0314453838,5.56472223734,1,2,3
pochilin,22.03119507,5.61303384698,1,2,3
meyerzzzz,22.0297030368,5.61391904496,1,2,3
whales,22.0294851348,5.61201534725,1,2,3
mob,22.0216887851,4.73433439005,2,4,6
my dad makes me play this,22.0212627072,5.39372749982,1,2,3
knææ,22.0206541609,3.9241913867,3,4,7
gameover,22.01984862,5.44078872362,1,2,3
bhox,22.0179523276,5.25402999697,1,2,3
rome,22.0173540056,3.40399577843,4,6,10
phoenixzero,22.0157758615,4.30472015907,2,4,6
suzarya,22.0128453197,5.40082297142,1,2,3
shysta,22.01184332,5.48535137183,1,2,3
tkbreezy,22.0111882859,5.41554730551,1,2,3
nostalgickitty,22.0098099437,5.44459265419,1,2,3
modus,22.0078356929,4.0957514862,2,4,6
erki,22.0076206103,3.21240756732,4,8,12
legendary link player,22.0067066706,4.33033150658,2,4,6
bitterking,22.0046547436,5.39800574875,1,2,3
mochi,21.9979127574,5.44065407861,1,2,3
duffo,21.995518143,5.35913855115,1,2,3
cookie,21.991979784,4.04169483567,3,4,7
astro,21.9878781626,5.46853370907,1,2,3
icahandlarn,21.9848446112,5.30733590175,1,3,4
ready set goats!,21.98355838,5.60187590387,1,2,3
bonobono,21.9819109185,5.49095192548,1,2,3
garou,21.9797969827,5.3072751125,1,2,3
kush wizard,21.9795633111,5.54214673459,1,2,3
mustard,21.9794794472,3.98192109208,2,4,6
othello,21.9714249621,5.1125111993,1,2,3
pied,21.9704160516,5.20519456976,1,2,3
wsyk,21.9665705128,5.13358258096,1,2,3
honk,21.9639172469,5.45463079654,1,2,3
reyond,21.9614994366,5.19926997725,1,2,3
just watch,21.9614227476,5.59772740715,1,2,3
sirjosh,21.9571889912,5.59547889742,1,2,3
nodge,21.9538391242,5.31705041821,1,2,3
retheo,21.9467512033,4.91766094649,1,2,3
haimatox,21.9411967595,5.59196921317,1,2,3
purple pain,21.9394066711,5.59316731964,1,2,3
agahnim,21.9373846529,5.4327342813,1,2,3
dauvid,21.9346889723,4.17667366463,2,4,6
u guy,21.9313162783,4.14753214088,2,4,6
aesthetic,21.928287631,4.28298399502,1,4,5
krakhead,21.9273861778,5.39075194528,1,2,3
organic,21.9227173716,5.58942059896,1,2,3
mossman,21.9213209011,3.2969468911,3,7,10
gizmodro,21.9195166572,4.05604187414,2,4,6
geoscyl,21.9170536391,5.02723356362,1,2,3
sorbet,21.916195216,5.51051035713,1,2,3
the chief,21.916195216,5.51051035713,1,2,3
most defs,21.916195216,5.51051035713,1,2,3
chrisinajar,21.916195216,5.51051035713,1,2,3
yung_stalin,21.916195216,5.51051035713,1,2,3
chef,21.915590598,3.64041452882,3,5,8
sensai,21.9144520122,5.15001607171,1,2,3
buddyboy,21.9140940492,5.39194151645,1,2,3
gorilla,21.9136956716,5.23263440102,1,2,3
jakester,21.9105652695,4.88593688398,1,2,3
pushin,21.9014769058,5.48688954013,1,2,3
bee,21.899304451,4.1512012286,2,4,6
cloak n swagger,21.8978232835,5.26401094482,1,2,3
trouts,21.8967191798,4.29127311121,2,4,6
froll3,21.8966279966,4.58859769935,1,3,4
sweet_lu,21.8954554829,5.5011661079,1,2,3
blackmoneycris,21.8939241416,5.53022596476,1,2,3
bombproof,21.889810193,4.13756720867,2,4,6
avenu,21.8878422546,4.22463295293,2,4,6
wham,21.8873668439,5.33873303659,1,2,3
edwin1-100,21.8845580825,5.04271584789,1,2,3
riot,21.8813504197,5.58154180527,1,2,3
lorek,21.8775012988,3.85162050086,2,3,5
nocturne,21.876141597,3.80518855672,2,4,6
dr. acula zx,21.8745786293,5.53021788315,1,2,3
magellan,21.8730285998,4.10088309883,2,4,6
steventheyoung,21.8729427154,3.07493456181,3,9,12
master jay,21.8714261764,5.58068018819,1,2,3
knapsack,21.8701560844,5.53519992295,1,2,3
cilan,21.8694587625,5.47496820702,1,2,3
keg,21.8660253348,5.51496910945,1,2,3
twto,21.8660253348,5.51496910945,1,2,3
barca,21.8660253348,5.51496910945,1,2,3
moon over my-hammy,21.864712384,5.46381891249,1,2,3
supermanchunky,21.8613914253,5.57549200227,1,2,3
kl3an,21.8612668498,4.27392979832,2,4,6
dcmaster,21.8600883272,4.10786185553,2,4,6
rx,21.8589882273,5.54082180954,1,2,3
ike,21.8589882273,5.54082180954,1,2,3
sedrader,21.8557793117,5.64499970563,1,2,3
sprak,21.8543177683,4.11988810139,2,4,6
jesusgoestoprom,21.8531638008,5.26956867761,1,2,3
krisp,21.8523597433,5.57403513103,1,2,3
otachi,21.8497200449,5.4416970047,1,2,3
vans,21.8427814843,3.67420843046,3,4,7
tri-volt,21.8415613036,5.45443744015,1,2,3
roro,21.8397848049,5.1876355732,1,2,3
smurf,21.8395655546,2.95265322915,4,8,12
vu,21.833299923,4.15548642833,2,4,6
elfie,21.8318509666,5.40398847469,1,2,3
xbeke,21.8307235041,5.25562130834,1,2,3
rocket,21.8170511949,4.13562487738,2,4,6
squirrlz,21.8137452478,5.35774002186,1,2,3
jeffsphere,21.8089052789,5.38341132505,1,2,3
tw!nk,21.8075834253,4.01486155165,2,4,6
slenda man,21.8066532601,5.4501169425,1,2,3
emb,21.803914455,4.44326235591,2,4,6
american brav0,21.8038486567,5.355342806,1,2,3
thissideup,21.7980434245,5.14656548974,1,2,3
cod,21.7943613344,5.25054788538,1,2,3
hentai69,21.7911686194,4.5265545468,1,2,3
arisingshadow,21.7827930377,5.56307180664,1,2,3
jakejam,21.7809924441,5.53923086061,1,2,3
tracer,21.7804428866,5.4972002095,1,2,3
candy,21.7774518952,3.75581322702,2,6,8
krax,21.7764631568,3.17512814439,4,7,11
no hablo,21.776199059,5.50533913166,1,2,3
koebeldwill,21.7759944164,5.53475569397,1,2,3
pikmon,21.7663811411,5.39314340472,1,2,3
klexi,21.7650042041,4.80734598518,2,4,6
dw,21.7637294951,3.44069756283,4,7,11
krodomon,21.7628816065,5.49076598866,1,2,3
nasty,21.7557296803,3.63025021817,3,6,9
hiben75,21.7546189873,5.2828879512,1,2,3
honeydew,21.75444071,5.4639369102,1,2,3
kieuarty,21.7530585833,5.29811414404,1,2,3
sianvar,21.7497945571,6.94866207219,0,1,1
kuradoberi,21.7439469957,5.29555331789,1,2,3
aurebeshx,21.742229882,4.97453748747,1,2,3
daniel-san,21.7402391555,5.5539956083,1,2,3
kälte,21.7387574076,5.5773559577,1,2,3
some moose,21.7361632362,7.18946781528,0,1,1
fathr,21.7330462476,3.48471353469,3,4,7
zora,21.7265374198,5.52194122996,1,2,3
tigurz,21.7251122548,5.55145150506,1,2,3
butterysmooth,21.723448264,5.73462724351,1,2,3
jonah,21.7189700995,3.18481135856,5,6,11
annapower89,21.7120089106,4.99878390257,1,3,4
jackedpuffguy,21.7087656534,4.16119208332,2,4,6
rocknturtle,21.7049575742,5.41274699013,1,2,3
trevor,21.7018578104,3.97222513527,2,4,6
psychowaffle,21.697570908,3.96602433869,2,4,6
rickter_scale,21.6973753242,5.46440957939,1,2,3
doritocrumbman,21.6935903377,5.46435805496,1,2,3
ruru,21.6877983668,5.54513985144,1,2,3
mfdom,21.6867950646,5.49425252058,1,2,3
na+,21.6867950646,5.49425252058,1,2,3
too many cooks,21.6867950646,5.49425252058,1,2,3
professor cube,21.6867950646,5.49425252058,1,2,3
jr1501,21.6867950646,5.49425252058,1,2,3
kelbek,21.6867950646,5.49425252058,1,2,3
mrbitter,21.6867950646,5.49425252058,1,2,3
bassmanbran,21.6867950646,5.49425252058,1,2,3
scraggus,21.6867950646,5.49425252058,1,2,3
hno3,21.6867950646,5.49425252058,1,2,3
yuxminato,21.6867950646,5.49425252058,1,2,3
the derrit,21.6867950646,5.49425252058,1,2,3
glgwawa,21.6867950646,5.49425252058,1,2,3
hnic,21.6867950646,5.49425252058,1,2,3
me,21.6867950646,5.49425252058,1,2,3
ausuri,21.6867950646,5.49425252058,1,2,3
mental djent,21.6867950646,5.49425252058,1,2,3
timbo,21.6867950646,5.49425252058,1,2,3
decency,21.6867950646,5.49425252058,1,2,3
captain lio,21.6867950646,5.49425252058,1,2,3
telic,21.6867950646,5.49425252058,1,2,3
fr1so,21.6867950646,5.49425252058,1,2,3
kat in the sac,21.6867950646,5.49425252058,1,2,3
ms. hester,21.6867950646,5.49425252058,1,2,3
not thor,21.6867950646,5.49425252058,1,2,3
dabes,21.6867950646,5.49425252058,1,2,3
skaterjayy,21.6867950646,5.49425252058,1,2,3
darklucario,21.6867950646,5.49425252058,1,2,3
epicramen,21.6867950646,5.49425252058,1,2,3
rngeesus,21.6867950646,5.49425252058,1,2,3
dd,21.6867950646,5.49425252058,1,2,3
starelf,21.6867950646,5.49425252058,1,2,3
dhir,21.6867950646,5.49425252058,1,2,3
ocks_rock,21.6867950646,5.49425252058,1,2,3
neverlucky,21.6867950646,5.49425252058,1,2,3
tape,21.6860773411,5.47985703048,1,2,3
gario,21.6860773411,5.47985703048,1,2,3
jamnt0ast,21.6860773411,5.47985703048,1,2,3
tvdonk,21.6860773411,5.47985703048,1,2,3
mulkster,21.6860773411,5.47985703048,1,2,3
allday napper,21.6860773411,5.47985703048,1,2,3
bphan,21.6860773411,5.47985703048,1,2,3
stick,21.6860773411,5.47985703048,1,2,3
noro,21.6860773411,5.47985703048,1,2,3
razz,21.6860773411,5.47985703048,1,2,3
debra!,21.6860773411,5.47985703048,1,2,3
sleeh,21.6860773411,5.47985703048,1,2,3
kittenlover,21.6860773411,5.47985703048,1,2,3
cashew,21.6860773411,5.47985703048,1,2,3
glasper,21.6860773411,5.47985703048,1,2,3
cyxy,21.6860773411,5.47985703048,1,2,3
carrot lord,21.6860773411,5.47985703048,1,2,3
matsson,21.6860773411,5.47985703048,1,2,3
franknstein,21.6860773411,5.47985703048,1,2,3
bagels,21.6860773411,5.47985703048,1,2,3
bamkek,21.6860773411,5.47985703048,1,2,3
pistols,21.6860773411,5.47985703048,1,2,3
zomb,21.6860773411,5.47985703048,1,2,3
caelan,21.6860773411,5.47985703048,1,2,3
cubot64,21.6860773411,5.47985703048,1,2,3
smackledorf007,21.6860773411,5.47985703048,1,2,3
fzzr,21.6860773411,5.47985703048,1,2,3
pastor,21.6860773411,5.47985703048,1,2,3
steak,21.6860773411,5.47985703048,1,2,3
cate!,21.6860773411,5.47985703048,1,2,3
somekid,21.6860773411,5.47985703048,1,2,3
jorbic,21.6860773411,5.47985703048,1,2,3
irishwristwatch,21.6860773411,5.47985703048,1,2,3
redfern,21.6860773411,5.47985703048,1,2,3
conch,21.6860773411,5.47985703048,1,2,3
mamabenji,21.6860773411,5.47985703048,1,2,3
trig,21.6860773411,5.47985703048,1,2,3
cheung,21.6860773411,5.47985703048,1,2,3
trippy,21.6860773411,5.47985703048,1,2,3
sergio,21.6860773411,5.47985703048,1,2,3
bat,21.6860773411,5.47985703048,1,2,3
the piledriver,21.6825456282,5.52643006716,1,2,3
dannyd,21.6750770435,5.35288625009,1,2,3
mahatma,21.6743115052,4.37039127025,1,3,4
k-c,21.6718102572,5.00701478016,1,2,3
waddledude,21.6704863467,5.55069055658,1,2,3
bennyboy98,21.6701830111,5.46052099973,1,2,3
dalius,21.6694500604,4.66887899833,1,4,5
paradox,21.6682152215,5.25836678053,1,2,3
the maltese falco,21.6632167439,5.49473487238,1,2,3
donnie cash,21.6592621832,4.33804653503,2,4,6
duk,21.6589702642,4.27802447311,2,4,6
moku,21.6578258165,5.53672997553,1,2,3
bigpoopz,21.6556900025,5.41483970412,1,2,3
apollo [thomas],21.6524669181,5.43677576938,1,2,3
noj,21.6524256777,4.31706322202,2,3,5
searabbits,21.6519753409,5.22911446109,1,2,3
viceroy,21.6504358409,4.46933529251,2,4,6
waltz,21.6489782411,5.28916088193,1,2,3
ajefk12555,21.6449948491,5.23535475087,1,2,3
flastname,21.6446779128,7.16091020226,0,1,1
ail,21.6361515135,5.25580397939,1,2,3
icon,21.6217934152,4.38409972372,2,4,6
damfam,21.6214081122,4.56923539942,2,4,6
satco,21.620698463,3.9056165557,2,4,6
two,21.6201948197,5.07566536557,1,3,4
boobs,21.6174316369,5.59319918565,1,2,3
ktpt,21.6168279711,6.58601817584,0,2,2
magmios,21.6126957241,5.54230632236,1,2,3
lo,21.611254881,5.36224166277,1,2,3
monk,21.6108614099,4.12030349436,2,4,6
drug,21.6094723496,5.52977469192,1,2,3
silo,21.6074869128,4.33177885169,2,4,6
alchemist,21.6063836572,3.18741293562,5,9,14
sadu,21.6054682305,4.76283361794,1,2,3
drstyles,21.6028599228,5.4682526801,1,2,3
swiftwolf,21.5994492443,5.26806721926,1,2,3
snice,21.5962731019,5.36742175227,1,2,3
pretzelguy,21.5883659655,4.35353508857,2,4,6
quest,21.5864755235,4.36346828797,2,4,6
dime,21.5781572636,3.13208835923,4,8,12
moment,21.5768951599,4.9877364106,1,2,3
melo,21.5742046227,5.32534420919,1,2,3
brochill,21.5732604837,5.34178752331,1,2,3
sunny,21.57216416,4.99515629648,1,3,4
uleksite,21.571879132,4.34931981182,2,4,6
cdrom,21.5692672162,5.36265151535,1,2,3
hyperbole,21.5668418815,6.62880771082,0,2,2
iceluigi,21.5650033291,5.52008655115,1,2,3
not that good,21.5643801316,5.0362832662,1,2,3
clifford,21.5640208982,5.48534755542,1,2,3
tiddles,21.5598189139,5.61224622472,1,2,3
bricks,21.5579610741,5.50341732119,1,2,3
hyphy,21.5571190518,5.17916358385,1,2,3
ahkiat09,21.5562054222,4.24513117265,1,4,5
tj combo,21.5532222116,5.32199650355,1,2,3
ikeatm,21.5491100653,5.38312582818,1,2,3
cb,21.5416093963,7.20060747438,0,1,1
radamen,21.5416093963,7.20060747438,0,1,1
scruffy,21.5416093963,7.20060747438,0,1,1
kreylekz,21.5416093963,7.20060747438,0,1,1
mason,21.5416093963,7.20060747438,0,1,1
spt,21.5416093963,7.20060747438,0,1,1
radeon,21.5395163172,6.54636768132,0,2,2
minusev,21.539266883,4.78250920596,1,2,3
5'10,21.5381794288,7.05056853341,0,1,1
littleboylarry,21.5380103834,5.65844195179,1,2,3
bleh27,21.5363675438,5.37092029601,1,2,3
abaasy,21.5344776435,5.48974888375,1,2,3
joe,21.5343129957,4.96568230183,1,2,3
shug,21.5296678768,3.13945068117,5,8,13
ogjanks,21.5289913219,5.51197413268,1,2,3
caped baldy,21.5285038533,4.09982465186,2,4,6
poofies,21.5272861026,5.34980638975,1,2,3
bit.ly/mamekitsune,21.5267007235,6.78006389915,0,2,2
suuu,21.5230355942,5.26697041254,1,2,3
floonchdoonch,21.522299358,3.50089668995,4,7,11
sazeny,21.5222343644,5.58740619709,1,2,3
purplepanda,21.5216865433,4.55800598171,2,4,6
voltaire,21.5151863904,5.51348316469,1,2,3
myroknpancakes,21.5148377298,4.0063866315,2,4,6
oless,21.5135957926,3.98878822244,1,4,5
ashley,21.5095215727,4.89056559249,1,2,3
cat_tree,21.5047657545,5.52858492613,1,2,3
liaem,21.5047657545,5.52858492613,1,2,3
von,21.5047657545,5.52858492613,1,2,3
espi,21.5047657545,5.52858492613,1,2,3
malkasaur,21.5047657545,5.52858492613,1,2,3
bratic,21.5047657545,5.52858492613,1,2,3
wransky,21.5047657545,5.52858492613,1,2,3
trickster,21.5047657545,5.52858492613,1,2,3
halaa,21.5047657545,5.52858492613,1,2,3
lopsided,21.5047657545,5.52858492613,1,2,3
pocket,21.5047657545,5.52858492613,1,2,3
poodledeedoop,21.5047657545,5.52858492613,1,2,3
dude,21.5047657545,5.52858492613,1,2,3
drumrollpls,21.5047657545,5.52858492613,1,2,3
mrl3gume,21.5047657545,5.52858492613,1,2,3
just kevin,21.5047657545,5.52858492613,1,2,3
gilby,21.5047657545,5.52858492613,1,2,3
burgher earl,21.5047657545,5.52858492613,1,2,3
leather daddy,21.5047657545,5.52858492613,1,2,3
katahri,21.5047657545,5.52858492613,1,2,3
pray,21.5047657545,5.52858492613,1,2,3
seamoose,21.5043065908,4.35663248395,2,4,6
tedgar,21.4996546172,5.4403879893,1,2,3
wwjd,21.4994226585,5.23430373125,1,2,3
jankz,21.4948711517,3.63626185091,3,7,10
huber,21.4945122717,5.54334620599,1,2,3
fice,21.4938569557,5.47127015196,1,2,3
chals,21.4864750629,3.07639083036,5,9,14
tyde,21.4830949607,5.06775078303,1,2,3
guccipivotmaster4000,21.4780678816,5.51141192656,1,2,3
whichkraft,21.4693243196,5.49951526608,1,2,3
lysid,21.4687202075,5.52204088431,1,2,3
sd rick,21.4654959409,5.50755396434,1,2,3
starwolf,21.4634936388,4.92240869813,1,2,3
wik,21.4610854059,4.64453052231,1,4,5
redwing,21.4598828015,5.04800392378,1,2,3
leavescat,21.4560286717,5.3032322909,1,2,3
psythr,21.4551593182,4.34255122644,2,4,6
jabberwock,21.4523049901,4.08499589889,2,6,8
nitsua,21.4490190207,6.95409914069,0,1,1
booty,21.4396711443,5.66044490451,1,2,3
calebtemple,21.4364592516,5.27347074322,1,3,4
iceberg,21.4344569607,4.77133192541,2,4,6
kirbykid,21.4341201392,5.46215455339,1,2,3
depp,21.4306844084,5.56067450099,1,2,3
dreekas,21.4270623258,5.09895923898,1,2,3
gambit,21.4248655198,5.59282554938,1,2,3
harvey_birdman,21.4230236125,5.49885983923,1,2,3
mrluggyogirl,21.4221626132,5.51661217091,1,2,3
farthbog,21.4218708538,5.42241854477,1,2,3
cr,21.4193707435,4.43142050758,2,4,6
jon carr,21.4175623107,6.58593648281,0,2,2
arol,21.416215944,4.5351944387,2,4,6
ybro,21.414502121,5.13481352704,1,2,3
falf,21.4144570984,5.36831481341,1,2,3
akaboshi,21.4138892626,5.28874299137,1,2,3
bambi,21.4054872772,3.75050212607,3,7,10
photon,21.4037569096,5.61626627993,1,2,3
dani,21.4014137882,5.53156813266,1,2,3
missing,21.4013360005,5.40058092352,1,2,3
sad,21.400393691,5.33111348801,1,2,3
stonehaus,21.400043856,3.93596435687,2,4,6
atticus,21.3985864411,5.2963669076,1,2,3
coupon,21.3974864253,4.52566068386,2,4,6
kylebrandon,21.3955768667,5.00163000295,1,2,3
young metro,21.3940150763,4.86336427335,1,2,3
sputo,21.3930008205,5.27757591568,1,2,3
barry allen,21.3877537463,5.25333277675,1,2,3
2 trainz,21.3866623381,3.78073724344,3,6,9
wille1923,21.3805716896,4.71427744162,1,4,5
link strife,21.377992484,4.00195259844,2,5,7
kidney,21.3745467636,3.91845276745,2,5,7
wisaac,21.3644578071,4.01134363968,2,4,6
kakpu,21.3640038114,7.13829747382,0,1,1
amz,21.3628058596,4.16248076389,2,4,6
bobalu,21.356935652,4.68296475947,2,2,4
samo,21.3504332979,6.91825477652,0,1,1
spence,21.349782228,5.44249514337,1,2,3
thereal,21.3456211649,4.33684296885,2,4,6
zelms,21.3455135387,5.46466544969,1,3,4
ssb4 sucks,21.3422581477,5.51129103904,1,2,3
k•maru,21.3422581477,5.51129103904,1,2,3
spinr,21.3422581477,5.51129103904,1,2,3
heeb,21.3422581477,5.51129103904,1,2,3
coveredinbees,21.3422581477,5.51129103904,1,2,3
fierce,21.3422581477,5.51129103904,1,2,3
jeezus,21.3422581477,5.51129103904,1,2,3
the don,21.3422581477,5.51129103904,1,2,3
0xyswag,21.3422581477,5.51129103904,1,2,3
ej39,21.3422581477,5.51129103904,1,2,3
crawfish,21.3422581477,5.51129103904,1,2,3
shwang,21.3422581477,5.51129103904,1,2,3
og asi,21.3422581477,5.51129103904,1,2,3
yourfaceson,21.3422581477,5.51129103904,1,2,3
sleepy time,21.3422581477,5.51129103904,1,2,3
tenemos,21.3422581477,5.51129103904,1,2,3
sjw,21.3422581477,5.51129103904,1,2,3
blondie,21.3422581477,5.51129103904,1,2,3
smyd,21.3422581477,5.51129103904,1,2,3
metro,21.3422581477,5.51129103904,1,2,3
bangboy2000,21.3422581477,5.51129103904,1,2,3
hitboxninja,21.3422581477,5.51129103904,1,2,3
javelin,21.3422581477,5.51129103904,1,2,3
griffin,21.3422581477,5.51129103904,1,2,3
fatal,21.3422581477,5.51129103904,1,2,3
horse marth,21.3422581477,5.51129103904,1,2,3
tortellini tyler,21.3422581477,5.51129103904,1,2,3
castaway,21.3422581477,5.51129103904,1,2,3
loring,21.3422581477,5.51129103904,1,2,3
reckon,21.3422581477,5.51129103904,1,2,3
dox,21.3422581477,5.51129103904,1,2,3
claus,21.3422581477,5.51129103904,1,2,3
chuluu,21.3422581477,5.51129103904,1,2,3
dru_p,21.3422581477,5.51129103904,1,2,3
jfm,21.3422581477,5.51129103904,1,2,3
goonknight,21.3422581477,5.51129103904,1,2,3
gutwrencherttd,21.3422581477,5.51129103904,1,2,3
boscotty,21.3422581477,5.51129103904,1,2,3
anti care,21.3422581477,5.51129103904,1,2,3
koon,21.3422581477,5.51129103904,1,2,3
jisskhalifa,21.3422581477,5.51129103904,1,2,3
gnast,21.3422581477,5.51129103904,1,2,3
frankypaul,21.3422581477,5.51129103904,1,2,3
winda,21.3422581477,5.51129103904,1,2,3
meatcoffee,21.3422581477,5.51129103904,1,2,3
doubledorf,21.3422581477,5.51129103904,1,2,3
wine,21.3422581477,5.51129103904,1,2,3
azzy,21.3422581477,5.51129103904,1,2,3
cremepuff,21.3422581477,5.51129103904,1,2,3
jordova,21.3422581477,5.51129103904,1,2,3
sensazn,21.3422581477,5.51129103904,1,2,3
rish,21.3422581477,5.51129103904,1,2,3
v2o,21.3422581477,5.51129103904,1,2,3
plr0,21.3422581477,5.51129103904,1,2,3
harmless,21.3422581477,5.51129103904,1,2,3
trebert,21.3422581477,5.51129103904,1,2,3
jerome the gnome,21.3422581477,5.51129103904,1,2,3
hella ugly,21.3422581477,5.51129103904,1,2,3
goku,21.3422581477,5.51129103904,1,2,3
del,21.3422581477,5.51129103904,1,2,3
roi,21.3422581477,5.51129103904,1,2,3
mattymoo,21.3422581477,5.51129103904,1,2,3
homebad,21.3422581477,5.51129103904,1,2,3
jerbear,21.3422581477,5.51129103904,1,2,3
connoreno,21.3422581477,5.51129103904,1,2,3
tittyboi,21.3422581477,5.51129103904,1,2,3
jonksy,21.3415278976,4.29060413628,2,4,6
hotrod,21.3396588521,4.10454838297,2,4,6
paulito,21.3385591765,5.13818877457,1,2,3
dvid,21.3371032557,4.14312400354,2,5,7
swampy,21.3302746012,5.37707178665,1,2,3
sabo,21.3198605137,3.99054868507,2,5,7
paprika,21.3197182811,5.00633405073,1,2,3
20xx,21.3154171073,5.37324972753,1,2,3
darkshadowed,21.3129094028,5.58720274447,1,2,3
bants,21.3125629193,5.49226500014,1,2,3
raalts,21.3104610452,3.17440178236,5,8,13
sdmage,21.3023377906,5.41663186537,1,2,3
climax,21.3003394596,5.40218399444,1,2,3
jab,21.299328484,3.2478168012,4,9,13
ad,21.2948567839,5.34951594597,1,2,3
zeny,21.2864544297,5.51329081715,1,2,3
macbeth,21.2843447195,5.46711193125,1,2,3
arctic,21.2834602681,6.5827026474,0,2,2
romulus,21.2833696258,3.87083177438,2,4,6
veso,21.2827087779,5.03037815367,1,4,5
haram,21.2776838128,5.66491110344,1,2,3
dazy,21.2728527152,4.52864847095,2,4,6
s&s,21.2703523965,5.41298548686,1,2,3
mlpjoey,21.2659216671,6.79031108444,0,1,1
coleslaw,21.2614496692,3.57560276289,3,6,9
wakkabanana,21.2591803079,3.00056458838,3,9,12
ruckus,21.2585704947,6.90873935442,0,1,1
scoolice,21.2561044228,5.09885103126,1,2,3
wheatley,21.2474323417,7.10288502135,0,1,1
rd,21.2431450804,4.48402131538,2,4,6
rocky reyes,21.2388516954,5.32470529857,1,2,3
pika,21.2362509607,5.38369283964,1,2,3
fish,21.2355352213,3.93492613336,2,5,7
nokit,21.2351926027,5.57991364092,1,2,3
asscastle,21.2347353426,5.21698584659,1,2,3
it's cha boi,21.2346408024,4.07433444508,2,4,6
deskpop,21.2344555732,5.49602046312,1,2,3
jp3,21.2334420661,5.23452277258,1,2,3
korvus,21.2326435233,5.25344962325,1,2,3
ogs gosu,21.2314021185,5.4535362302,1,2,3
gm,21.2263535838,4.94934698469,1,2,3
makvg,21.2260047311,5.70259649047,1,2,3
hamr boss,21.2233282122,5.47981329323,1,2,3
klear,21.2220007056,5.47303583875,1,2,3
hasme,21.2112392002,4.48219915827,2,4,6
zero fox given,21.2073290574,5.63507991064,1,2,3
88,21.2015169273,6.55914168828,0,2,2
philine,21.2007441403,5.49771862661,1,2,3
goliath,21.1927755857,4.32377675203,2,4,6
maki,21.1906403828,5.48993947332,1,2,3
warhaxs,21.1877689758,5.56118757683,1,2,3
sexyalexy,21.1877501806,7.08602746169,0,1,1
wiz biz,21.1845996415,4.05202239734,2,4,6
greensmith,21.1820907281,5.45957794115,1,2,3
theycallmechris,21.1804574182,5.46607194521,1,2,3
noob,21.1800864828,4.2071050419,2,4,6
fancy feast,21.1790860136,5.30883736879,1,2,3
en,21.1782385076,5.35289507504,1,2,3
jyrow,21.1738440063,4.26891361518,2,4,6
schiller,21.1713944536,5.3197198933,1,2,3
pness,21.1699522316,5.19405823226,1,2,3
shenanigans,21.1689750259,4.27932456073,2,4,6
cornbread,21.1660759348,5.56734892157,1,2,3
arcus,21.1632756527,5.50023691532,1,2,3
astropancakes,21.1630650435,4.25933526784,2,4,6
straywolf,21.1589950975,4.992806035,1,3,4
shurfyne,21.1587108991,5.47771898592,1,2,3
boptimus,21.155311911,5.58758000302,1,2,3
walby,21.1496692039,5.19980704943,1,3,4
wombätt,21.1428638699,5.29281030347,1,2,3
kelpoorganic,21.1409583975,5.50850081427,1,2,3
chibi,21.1344903602,4.12945189069,2,4,6
reverse,21.1271866663,6.52302740908,0,2,2
cyborg,21.1269045557,5.58982190474,1,2,3
bow,21.1218542127,5.49119745607,1,2,3
biggily oggily boogly,21.1183938134,5.4576431289,1,2,3
f12,21.1150550628,5.41094481345,1,2,3
sweets,21.1130411299,5.14201863769,1,2,3
young will,21.1105273894,3.3065288103,4,6,10
gimli,21.1097262584,4.36096426829,2,4,6
soul,21.106922374,3.36392444765,3,6,9
plautus,21.1040363011,5.22043993896,1,2,3
dolphin,21.102396216,5.22468280076,1,2,3
yono,21.0978753496,3.52114069002,3,4,7
pt2,21.0967494724,5.52435524955,1,2,3
3hits,21.0961748415,5.34506374044,1,2,3
sackofwine,21.0931500648,6.89249138434,0,1,1
therapture_,21.0929963353,3.72614726183,3,8,11
furniture,21.088475958,5.48194494759,1,2,3
guts,21.0865505835,4.30146346528,1,4,5
bunnyblast,21.0855117073,4.10256831174,2,5,7
tomce,21.0840260382,5.31796472826,1,2,3
emperorbutt,21.0828347204,5.48885336835,1,2,3
jungle,21.0817100508,3.72855116913,2,5,7
yardo,21.0814031421,6.58805126481,0,2,2
frostybroshake,21.0783015788,6.93059296947,0,1,1
gustavus adolphus,21.0770614892,3.53654532252,3,4,7
narutogod666,21.0770431684,5.30551205907,1,2,3
leahboo,21.0753994861,2.91987600399,5,10,15
yoda,21.0747594105,4.06398401712,2,4,6
truski,21.0726434461,4.1089988191,2,4,6
djit,21.0722070879,5.50912085499,1,2,3
korobeniki,21.0718245871,5.57156539062,1,2,3
zega,21.070209472,5.51002169606,1,2,3
asterisk,21.070209472,5.51002169606,1,2,3
keefer,21.070209472,5.51002169606,1,2,3
jirachinick,21.070209472,5.51002169606,1,2,3
meso,21.070209472,5.51002169606,1,2,3
diltune,21.070209472,5.51002169606,1,2,3
@@,21.070209472,5.51002169606,1,2,3
rick rosser,21.070209472,5.51002169606,1,2,3
ohai,21.070209472,5.51002169606,1,2,3
nukidin,21.070209472,5.51002169606,1,2,3
blazed chumpi,21.070209472,5.51002169606,1,2,3
kiki,21.070209472,5.51002169606,1,2,3
lyter,21.070209472,5.51002169606,1,2,3
slade,21.070209472,5.51002169606,1,2,3
ryan,21.070209472,5.51002169606,1,2,3
chevaca,21.070209472,5.51002169606,1,2,3
trebejo99,21.0699378048,4.24714696201,2,4,6
keebler,21.0692723183,4.28985695576,2,4,6
stoc,21.0685545161,3.82668330811,2,4,6
new york siddy,21.0632139797,4.57565403216,1,2,3
frostmagma,21.0606649454,5.47966339075,1,2,3
blank,21.0600136755,3.44896078677,4,7,11
ludwig,21.0578459784,3.60043337447,3,6,9
fjt,21.0554069132,5.02809656629,1,2,3
queen,21.0552225029,3.56608905177,3,7,10
badwolf,21.0523489122,5.53658679977,1,2,3
goldenboy,21.0489177722,4.37249298036,2,4,6
mudkipslaps,21.0488476998,5.48686112286,1,2,3
dio,21.0473288858,3.5812012198,3,7,10
shais young,21.0456616429,4.94225433694,1,3,4
cemith,21.0450128607,5.26023457282,1,2,3
sulgimme,21.0427077913,4.95617574796,1,3,4
icy mcpicy,21.0380587341,5.241943051,1,2,3
broseidon,21.0371624237,7.02216853372,0,1,1
rattmogers,21.0352837378,6.44557681872,0,2,2
lvl3,21.0273220304,5.48024885745,1,2,3
snow flake,21.0230092881,7.04159031008,0,1,1
savage lionfish,21.0206592336,4.20262241637,2,4,6
chedie,21.0166110552,5.27045399503,1,2,3
schoolboyj,21.0159155402,5.27186824584,1,2,3
eviox,21.0101393134,5.46601017394,1,2,3
marth vader,21.0087054048,5.19676468173,1,2,3
rainy day,21.0072880314,4.85962468115,1,2,3
gfd,21.0053718494,4.10754078205,1,5,6
paolothedon,21.0018920243,5.57075754789,1,2,3
jbuzzybee,20.9995784778,2.99727210367,4,8,12
bepis,20.9992493825,2.6760718053,4,11,15
erk,20.9944582163,4.05489471448,2,4,6
warnine,20.9924847129,5.3377140528,1,2,3
wynan,20.9907603022,5.31908003056,1,2,3
beardbot,20.9904900684,6.84011338045,0,1,1
ralph cecil,20.9903031794,5.19333297581,1,2,3
stretch,20.9888167681,2.40734064378,4,14,18
star99,20.9828543893,5.29204738615,1,2,3
beely,20.9762989136,5.47375759777,1,2,3
wonov,20.9761779338,4.28825808887,1,4,5
prinny,20.9744562605,4.9762935385,1,2,3
eros,20.9523748634,4.11920908966,2,5,7
songbird,20.9507700034,4.23520423874,2,4,6
noldorian,20.9500719781,4.74464049458,1,2,3
thetruetides,20.9495553358,5.36443397423,1,2,3
the rake,20.9472735484,7.02618012058,0,1,1
ritalin-and-steak,20.9468985645,5.46697533919,1,2,3
lastpo,20.9388470019,5.08033447253,1,2,3
altr0n,20.9333697904,5.22818741087,1,2,3
fatefiend,20.9264476274,5.35416828753,1,2,3
metanoia,20.9238950254,3.68731739381,2,5,7
quentendo,20.9201965748,6.94650197426,0,1,1
meeko,20.9166233931,5.54496290467,1,2,3
echo,20.9159156279,4.6318784096,2,4,6
accelzero,20.9115419849,4.2337925719,2,4,6
big papi,20.9087424756,3.55975715953,3,7,10
spencert,20.9082424406,5.38280494303,1,2,3
zayas,20.9079902552,5.28742351576,1,2,3
pharaoh,20.9050530561,5.57248194168,1,2,3
slinkman,20.9041791101,7.01650683115,0,1,1
notparis,20.8982969843,5.05485737105,1,2,3
timblord1738,20.8962820554,5.39467688226,1,2,3
moachies,20.8958404948,4.15954910896,2,4,6
keff,20.8955928631,3.99602728847,2,4,6
slip,20.8947631607,5.23519865806,1,2,3
barry seanders,20.892898228,4.8659262798,1,2,3
candyman!,20.8891470919,5.77137388366,1,2,3
smeagle,20.8882957764,4.73373847814,1,3,4
astronut,20.8854177838,5.21437026602,1,2,3
bt$,20.8771963319,7.00590441279,0,1,1
harvest,20.8759924959,5.25069208554,1,2,3
ejmp,20.8711528777,6.41711906906,0,2,2
turbo,20.8602467296,5.43856203914,1,2,3
lucas anderson,20.8597726756,4.52893968823,2,4,6
prime,20.8575022373,6.95088040379,0,1,1
campari,20.8442238641,5.29967814836,1,2,3
grape,20.8441044598,4.10036283998,2,3,5
stellar,20.8432996414,4.82483516893,1,4,5
chikin,20.8426060761,5.5284471656,1,2,3
tailz,20.8421384945,2.96193630245,5,9,14
obgyn,20.8381796082,5.51223367921,1,2,3
harkules,20.8354382284,6.99405407208,0,1,1
trust,20.8320358664,5.56175734451,1,2,3
tninja,20.8296512806,4.48813006931,2,5,7
pichu main,20.8241909106,3.35761091281,4,8,12
belome,20.8241236862,5.50264832598,1,2,3
i am an owl,20.8230817525,4.56966109594,1,4,5
seymourstyle,20.8209860978,4.39695050167,2,4,6
sususuueeeeloooo!!!!,20.817825804,4.46364070124,1,4,5
jtk,20.8157060092,5.34711763827,1,2,3
odon,20.8139454638,6.99172162292,0,1,1
proga,20.8100110502,6.57337367509,0,2,2
daddybiggums,20.8100038688,5.3647648757,1,2,3
chillycity,20.8086916793,5.31981749188,1,2,3
djdriftking.97,20.8070518135,4.46443328316,2,4,6
anewbus,20.7998077765,5.18269474041,1,2,3
kelp,20.7996627375,5.29548829463,1,2,3
jaaj,20.7990787621,6.71912333278,0,1,1
reen,20.797586981,5.49022643066,1,2,3
storm,20.7941406745,3.72130546255,3,6,9
tinklefairy6,20.7932359575,5.81227474192,1,2,3
seng,20.7918247522,4.89660178794,1,2,3
easy,20.7901424584,5.28937925812,1,2,3
crawshaw,20.7899169798,6.98645935621,0,1,1
stepdad,20.7886138504,5.22600298426,1,2,3
nhale,20.7866481929,5.25257814635,1,2,3
ruffian,20.7857774834,5.5226206813,1,2,3
sparky,20.7857774834,5.5226206813,1,2,3
la bomba,20.7857774834,5.5226206813,1,2,3
wonk,20.7857774834,5.5226206813,1,2,3
vvvvv,20.7857774834,5.5226206813,1,2,3
the problem,20.7857774834,5.5226206813,1,2,3
mantistoboggan,20.7857774834,5.5226206813,1,2,3
ir,20.7857774834,5.5226206813,1,2,3
nana saves popo,20.7857774834,5.5226206813,1,2,3
thewildjandro,20.7857774834,5.5226206813,1,2,3
winnie,20.7719722743,2.35451265157,4,14,18
intrances,20.7657528144,5.32820972625,1,2,3
ractor,20.7603840786,5.35914617164,1,2,3
the candyman!!!,20.7591244158,4.99000756496,1,2,3
by9,20.7586601288,5.31757294889,1,2,3
gorx,20.7456011928,3.5673500458,3,6,9
angel,20.743379429,6.9805851989,0,1,1
hazystalebread,20.742582436,3.16008229296,4,9,13
king magikarp,20.738275096,5.25084975729,1,2,3
weavle,20.7291878714,5.05184049527,1,3,4
brando550,20.7284359723,5.26866893846,1,2,3
coaster,20.7278402159,5.14967470128,1,2,3
mortecael,20.7245952596,5.58235588714,1,2,3
sevag,20.7201497681,5.43353589067,1,2,3
hahaae,20.7183221855,5.43622662378,1,2,3
zhao_guang,20.7133198021,6.51162879413,0,2,2
vitaminc,20.709198402,5.33652745754,1,2,3
medic,20.707981697,6.46028074652,0,2,2
bbng,20.704924252,4.03890794072,2,4,6
jpg,20.7021979509,4.50396139132,2,4,6
kzoo,20.6973892059,4.96370561438,1,2,3
white cinnamon,20.6950136097,4.29735076438,2,5,7
sluggo,20.6923281103,5.63263815654,1,2,3
fick,20.6903976465,5.34410206223,1,2,3
bopolev,20.6834318565,5.04211702011,1,2,3
niar,20.6808974599,4.35832790089,1,5,6
lmnts,20.671086373,5.23884529812,1,2,3
dimarx,20.6695276682,6.30392254936,0,2,2
shade,20.6661133566,2.58333815478,5,13,18
withputit,20.6652006091,4.27107362863,2,4,6
lip,20.6607805404,2.98432273116,4,9,13
c2,20.6581056464,4.25463468334,2,4,6
squishy boy,20.6553506566,5.11442866678,1,2,3
roland,20.6508307889,4.07469910195,2,4,6
jäger,20.6484072268,5.26841021146,1,2,3
ælj,20.6434233458,3.7386336156,3,4,7
viper,20.6420116168,4.3912076854,2,4,6
mrsalezz,20.6418835419,5.01579055478,1,2,3
nah son,20.6294681707,3.12543596883,3,9,12
the dang,20.627127756,5.27129922872,1,2,3
pagan,20.6266032224,5.12057235151,1,2,3
anutim,20.6256791307,4.23644849544,2,4,6
coffeehamster,20.6186324254,6.78982717057,0,1,1
suave,20.6170025064,5.54847067856,1,2,3
spoge,20.6138640439,5.22690719209,1,2,3
lurogmz,20.6136423839,5.25304570531,1,2,3
novamatt,20.610325354,5.53066819224,1,2,3
big spoon,20.6049392356,4.19378752189,1,5,6
takablade13,20.60416798,7.17147558733,0,1,1
blackmagic754,20.60416798,7.17147558733,0,1,1
toxic zane,20.60416798,7.17147558733,0,1,1
roller,20.60416798,7.17147558733,0,1,1
quada,20.60416798,7.17147558733,0,1,1
ren,20.60416798,7.17147558733,0,1,1
willson,20.60416798,7.17147558733,0,1,1
hypn0tiq,20.60416798,7.17147558733,0,1,1
shitty hungrybox,20.60416798,7.17147558733,0,1,1
garrettxvx,20.60416798,7.17147558733,0,1,1
getnikkdon,20.60416798,7.17147558733,0,1,1
rattigan,20.60416798,7.17147558733,0,1,1
spicky,20.60416798,7.17147558733,0,1,1
cc,20.60416798,7.17147558733,0,1,1
mokkori,20.60416798,7.17147558733,0,1,1
dewster,20.60416798,7.17147558733,0,1,1
waffle,20.60416798,7.17147558733,0,1,1
khoid,20.60416798,7.17147558733,0,1,1
locke robster,20.60416798,7.17147558733,0,1,1
dopamine,20.60416798,7.17147558733,0,1,1
scooter,20.60416798,7.17147558733,0,1,1
jkcc,20.60416798,7.17147558733,0,1,1
lukie,20.60416798,7.17147558733,0,1,1
swåç,20.60416798,7.17147558733,0,1,1
creamboy advanced,20.60416798,7.17147558733,0,1,1
bootyflute,20.60416798,7.17147558733,0,1,1
bayes,20.60416798,7.17147558733,0,1,1
insufficient heat,20.60416798,7.17147558733,0,1,1
meghna,20.60416798,7.17147558733,0,1,1
ogle,20.60416798,7.17147558733,0,1,1
rabid glitter,20.60416798,7.17147558733,0,1,1
rollinsky,20.60416798,7.17147558733,0,1,1
zanderwill,20.60416798,7.17147558733,0,1,1
kashi,20.60416798,7.17147558733,0,1,1
pookie,20.60416798,7.17147558733,0,1,1
mr. owl,20.60416798,7.17147558733,0,1,1
xyzp,20.60416798,7.17147558733,0,1,1
moju,20.60416798,7.17147558733,0,1,1
tkthoughts,20.60416798,7.17147558733,0,1,1
ryden hope,20.60416798,7.17147558733,0,1,1
altex,20.60416798,7.17147558733,0,1,1
_diesel,20.60416798,7.17147558733,0,1,1
nostromo,20.60416798,7.17147558733,0,1,1
volmarrk,20.60416798,7.17147558733,0,1,1
murphy,20.60416798,7.17147558733,0,1,1
shubs,20.60416798,7.17147558733,0,1,1
kounotori,20.60416798,7.17147558733,0,1,1
cupcake pirate,20.60416798,7.17147558733,0,1,1
bruff,20.60416798,7.17147558733,0,1,1
you'repizza,20.60416798,7.17147558733,0,1,1
flics,20.60416798,7.17147558733,0,1,1
tk,20.60416798,7.17147558733,0,1,1
adobro,20.60416798,7.17147558733,0,1,1
mostlyred,20.60416798,7.17147558733,0,1,1
vianny,20.60416798,7.17147558733,0,1,1
triple f,20.60416798,7.17147558733,0,1,1
drill,20.6019188022,3.4006822068,2,7,9
long daddy green,20.5994421445,4.2238869148,2,4,6
too much tuna,20.5948255511,3.34677178645,3,8,11
relaxalax,20.592674919,5.23061504989,1,2,3
cco,20.5889432485,5.48179208324,1,2,3
ozley,20.5806053148,5.29056815003,1,2,3
catsaur,20.5771982314,5.07436530811,1,2,3
chainz,20.5726970057,5.31114714138,1,2,3
tidi,20.572516674,5.50353465967,1,2,3
kiwi,20.572516674,5.50353465967,1,2,3
edwin...,20.572516674,5.50353465967,1,2,3
tkoverkill,20.572516674,5.50353465967,1,2,3
torch,20.572516674,5.50353465967,1,2,3
gmar,20.572516674,5.50353465967,1,2,3
vapid,20.572516674,5.50353465967,1,2,3
achaoticnordi,20.572516674,5.50353465967,1,2,3
marcftl,20.572516674,5.50353465967,1,2,3
ruslinjimmies_rj,20.5708461394,5.07731211585,1,2,3
godzillaz,20.5682364776,5.29964250091,1,2,3
eddwardo,20.5670505045,6.93337494546,0,1,1
enen,20.5610575692,5.45491718307,1,2,3
edwanga,20.5585596015,6.4682339695,0,2,2
dabs,20.5526451782,2.82726448696,6,11,17
zave,20.546977172,6.43492891542,0,2,2
matthewgu4,20.5417939259,6.70731579059,0,1,1
pocket sand,20.5359420396,6.60415907975,0,1,1
vann allen,20.5358941768,5.35926784681,1,2,3
oolongt,20.5334215463,4.21790159935,2,4,6
noodl-d,20.5331399593,5.56794512414,1,2,3
nubpai,20.5290802266,5.22412142562,1,2,3
clownballs,20.5258717535,4.83765229322,1,2,3
i fucking hate this game,20.5253419012,5.56721627255,1,2,3
silverwind,20.5213308876,5.14143939685,1,2,3
x3n0,20.5208886586,4.89686996085,1,4,5
takeover,20.5159197129,3.87329665205,2,6,8
gustavo,20.5142981846,3.94205354308,2,6,8
martel,20.5133644262,4.82643772912,1,4,5
elicik,20.5127027965,5.23736383103,1,2,3
snover,20.5060116523,5.00424813399,1,4,5
dice,20.4986085773,4.07862334619,2,5,7
paradoxchris,20.4944852365,6.36273414953,0,2,2
manny707,20.4886267939,6.77762311811,0,1,1
psydoc,20.4866885206,5.17182544469,1,2,3
gibby,20.4841464879,4.60466976833,2,3,5
heisenberg,20.4825934685,4.61768580726,1,4,5
veloc,20.4759452512,6.6860739405,0,1,1
theroy734,20.4660230794,5.16768477871,1,2,3
quantum,20.4658575941,4.70671458775,1,3,4
joat,20.4653879797,6.91353290786,0,1,1
boriater,20.465066263,5.53133936321,1,2,3
eastrock,20.4598319362,5.61602826393,1,2,3
zach,20.4553197989,4.32635637448,2,4,6
biggusher,20.4549782985,6.55634759193,0,2,2
flarecinder,20.44923734,5.20492402378,1,3,4
harrisonfjord,20.4485414386,5.29726859278,1,2,3
iowndisgam,20.4479675867,5.29116103447,1,2,3
wigglywuigimain ,20.446823824,5.48376418179,1,2,3
muffin,20.4448087914,3.85374616707,3,6,9
alfster,20.4386554335,4.45980999098,2,4,6
hacksugar,20.4386554335,4.45980999098,2,4,6
djoy,20.436364618,5.37145171887,1,2,3
qwillinallthefish,20.4356527258,5.49681552051,1,2,3
rift,20.430854917,4.26203554051,2,4,6
seanzy,20.4276259761,4.75833334906,1,4,5
bantler,20.4211822503,6.91961080673,0,1,1
p-watts,20.4191879221,5.51842956917,1,2,3
t2,20.4175356667,4.20030450747,2,4,6
sammyg,20.4171062088,4.78601898738,1,2,3
curls,20.4046157981,4.2839379436,2,4,6
nap,20.3952224135,4.20275261242,2,4,6
triz,20.3940484278,4.17798218582,2,4,6
justice,20.3893736143,4.47676482816,1,4,5
scrooge,20.3864162033,5.00038579283,1,3,4
morning,20.3840873512,4.12945020007,2,5,7
flex36,20.3821421142,5.19958101965,1,2,3
thurmiz,20.3677173,6.97610837821,0,2,2
tehenderer,20.3663891993,4.92358553001,1,2,3
codeman,20.364361304,5.50545281248,1,2,3
spacebears,20.3625419908,4.22543506992,2,4,6
saborx,20.3614332351,6.44294066703,0,2,2
jibca,20.3612733202,6.92690169084,0,1,1
flan,20.3612733202,6.92690169084,0,1,1
em,20.3612733202,6.92690169084,0,1,1
swoop,20.3612733202,6.92690169084,0,1,1
etc,20.3612733202,6.92690169084,0,1,1
renegade hexer,20.3612733202,6.92690169084,0,1,1
ango,20.3612733202,6.92690169084,0,1,1
winter,20.3612733202,6.92690169084,0,1,1
vdx,20.3612733202,6.92690169084,0,1,1
urbok,20.3612733202,6.92690169084,0,1,1
stoozyfloozy,20.3612733202,6.92690169084,0,1,1
no blanket,20.3612733202,6.92690169084,0,1,1
original ginger,20.3612733202,6.92690169084,0,1,1
limen,20.3612733202,6.92690169084,0,1,1
gutes,20.3612733202,6.92690169084,0,1,1
garnet,20.3612733202,6.92690169084,0,1,1
ironflame,20.3612733202,6.92690169084,0,1,1
emperor ivan,20.3612733202,6.92690169084,0,1,1
pandoz,20.3564955148,4.43525128964,2,4,6
reefx,20.3546243025,3.56506846355,2,5,7
jameps,20.3522322486,5.39771745448,1,2,3
maui howy,20.3516026735,5.45544611134,1,2,3
clusterfuckhead,20.3416510632,3.89599506951,2,5,7
big l,20.3341549618,6.70396686556,0,1,1
g0mega,20.3340759581,5.2005015427,1,2,3
2spoopy,20.3330302318,5.39500384239,1,2,3
lawngarms,20.3329706511,5.26145235625,1,2,3
larsson,20.3320623245,4.04108488849,2,4,6
cakes,20.33097549,4.24294438086,2,4,6
black knight,20.3303287219,4.60500667035,1,4,5
sacto style,20.3222723316,6.45750202566,0,2,2
bigshot,20.3200446287,5.144204615,1,2,3
emerald,20.3140230021,5.25392302781,1,2,3
ferox,20.3102605479,6.34568537758,0,2,2
alesana,20.3101235437,6.34442105335,0,2,2
elaktomte,20.309001805,4.27987717516,2,5,7
swing,20.3038094734,5.09652435065,1,2,3
maxsimon123,20.3028862802,3.68089697093,3,7,10
tanwad,20.3024391636,5.03036423669,1,3,4
maxi,20.2804063148,4.11212203318,2,4,6
maxthunder,20.275561848,4.74403669886,1,5,6
pursuit,20.2744936746,5.29701247401,1,2,3
kuroisekai,20.2704258633,5.26231223179,1,2,3
tangent,20.2652123152,6.87352541018,0,1,1
hurricane,20.2590799486,4.92073960072,1,3,4
segfault,20.2577195271,4.04422923939,2,4,6
duck chris,20.2557987002,4.10912146464,2,4,6
i use tap jump,20.2503690472,6.78214093736,0,1,1
skin ticket,20.2482018342,5.2283145032,1,2,3
cyberabbit ,20.2428955627,4.0249410791,2,5,7
albinosaurus,20.2399202537,4.49866561186,1,4,5
c mill$,20.2381451995,4.26347667486,2,6,8
cpwho,20.2277414753,4.13223529167,2,4,6
norbu,20.2267884253,6.90429113779,0,1,1
mellis,20.2257389741,4.49883112287,2,4,6
colt,20.2206065821,7.0651883313,0,1,1
buzzbuzz,20.2119103001,5.29072229381,1,2,3
moosie,20.2106977063,4.37288341944,2,4,6
repsguy,20.2064403648,4.95752001293,1,4,5
born 2 sd,20.2015668132,4.46022244612,1,4,5
rbm,20.2000593935,4.48739420593,1,4,5
mr.pvblo,20.1977923732,4.97845416755,1,2,3
mteb,20.1962774311,4.9168678173,1,2,3
hayden f baby,20.1951102815,5.24879235557,1,2,3
jay,20.1832559091,3.82782468549,2,6,8
maw,20.1728530496,3.0342443462,5,8,13
sausage948,20.1689849558,3.78735447631,3,6,9
suff,20.1649626819,6.69327023809,0,1,1
smashyoface,20.160017737,6.62372049437,0,1,1
zabu,20.1583992778,5.2010995727,1,2,3
bumsqueeze,20.1519203912,6.57625871815,0,1,1
jsmirk,20.1509314783,6.70589629715,0,1,1
cooljoe,20.1482949739,3.68793418168,1,4,5
backwards god,20.1370549051,6.73295648046,0,1,1
benji,20.1301820028,6.83583760166,0,2,2
vander,20.1279428502,6.89704561133,0,1,1
amne,20.1279428502,6.89704561133,0,1,1
kid manager,20.1279428502,6.89704561133,0,1,1
paxinchristo,20.1279428502,6.89704561133,0,1,1
mucho man randy passion,20.1279428502,6.89704561133,0,1,1
zolomon,20.1276151434,6.84660294199,0,1,1
sirencresselia,20.1250889771,6.18706217946,0,2,2
qt 3.14,20.1222816574,6.88245729927,0,1,1
providerofsouls,20.1173463453,5.37498868257,1,2,3
ceeds,20.1169760782,5.05482454247,1,3,4
chief,20.1149506138,6.73324976881,0,1,1
vedbod,20.1144391251,4.91505854079,1,4,5
pepi,20.1119532075,3.97000421147,2,4,6
danson,20.1117607564,5.37856873712,1,2,3
cool guy,20.1111028215,4.58058751705,1,4,5
arcin,20.1102667701,6.27840104571,0,2,2
juiceee,20.1070862375,6.85568769854,0,1,1
alex,20.1036420391,4.30182139393,2,4,6
lemon,20.1029398641,5.16823852594,1,2,3
unagi,20.0949891329,4.31385230176,2,4,6
tater,20.0949225944,4.63232636669,1,4,5
rios,20.0907377512,6.81983547622,0,2,2
pooodge,20.0828027154,5.26693954941,1,2,3
the p-diddler,20.0820381025,5.39279304785,1,2,3
weedle_v,20.0779435865,4.15999316537,2,5,7
yosemite dabbs,20.0768567069,6.66140406396,0,1,1
mkultra,20.0682686014,4.22010057174,2,4,6
k$o,20.0680712616,4.21016168174,2,4,6
toucan,20.0636587909,4.27730155399,2,4,6
captain planet,20.0630034121,6.57270000546,0,1,1
evab,20.0629449594,5.07998597436,1,2,3
budokan,20.0551376609,4.91358635845,1,4,5
cylinder,20.0547152512,6.58552420544,0,2,2
tecnus,20.0530024268,6.55466396674,0,1,1
sylvx,20.0521621779,4.14987231166,2,4,6
bluue,20.0495072013,5.33402168072,1,2,3
tjockisbulle,20.0440121194,5.06090187963,1,4,5
gunfer,20.0378474904,6.74636638982,0,1,1
dan,20.0327536078,5.51144465858,1,2,3
raidos,20.0322891933,3.26646801464,2,8,10
scazern,20.0306679998,6.20291909473,0,2,2
kiffer,20.0299463969,4.60094342744,1,4,5
racci,20.0270905834,5.30176987506,1,2,3
matat0,20.0256278689,6.82710781281,0,1,1
rahma noodles,20.0222051818,3.70881944119,2,4,6
bunz,20.0192184525,5.2618357611,1,2,3
dusk,19.9977262724,3.20622687972,2,11,13
the bird,19.9923022877,6.79384654053,0,1,1
brando,19.9787283932,3.97020515708,2,4,6
shanondorf,19.9770946898,4.05267779877,2,4,6
magaroni,19.9764968316,3.84789436212,2,4,6
royal,19.9723427164,4.9694513749,1,4,5
badger,19.9709371445,5.1137949604,1,3,4
daniels,19.9662873203,4.99708452292,1,3,4
chaoslink,19.9654236422,5.10799748591,1,4,5
impulse,19.9640452091,6.83359241627,0,1,1
bullebengt,19.9561609289,4.99434134539,1,3,4
ustanak-rising,19.9554496795,6.4283652602,0,2,2
heads,19.9539525607,6.18662024271,0,2,2
i3njamin,19.9527304378,2.76791870893,4,10,14
bombchu,19.9519659675,5.07611332046,1,2,3
long0uw,19.948983547,4.13236903918,2,4,6
d.j.r.,19.948643714,5.47889507849,1,2,3
esmod,19.9386853277,6.76739732017,0,2,2
maytag,19.9279211946,7.00132195746,0,1,1
murky,19.9277396357,4.66320405952,1,4,5
stami,19.9229965812,4.23651399616,2,4,6
cool master,19.9149954402,4.80195428148,1,4,5
adamantoise,19.9111008221,4.0558308672,2,5,7
mewtroid,19.9110009821,6.85758509551,0,1,1
uke,19.9078343646,4.52485317042,2,3,5
flow,19.9078154207,6.86495007095,0,1,1
eridaan,19.903936914,4.24971328162,2,4,6
zalz,19.8999549257,4.97710458246,1,4,5
steele,19.8960820518,6.73419895015,0,2,2
#28898l88,19.8820873865,4.94132516731,1,3,4
pkjoey,19.8787930984,6.55812057258,0,2,2
derpson,19.8784014584,3.34602743608,2,8,10
money man,19.876171877,6.69619167554,0,1,1
pecan3141,19.8753121901,5.39835071231,1,2,3
kylebaked,19.8700935554,4.35131179099,2,4,6
delta,19.856962141,3.90028408162,2,6,8
thewizard,19.8549731052,6.98441329569,0,1,1
meamking,19.8542081955,5.1695392237,1,2,3
juan andres rodriguez,19.8530702319,4.08759320781,2,4,6
sevan,19.8513642475,6.13065874189,0,2,2
twig,19.8458779629,3.17522967908,4,8,12
enqwers,19.8430002737,5.2137859731,1,2,3
the brometheus,19.8370674715,6.68244595884,0,2,2
tickct,19.8279610181,3.18516207616,2,11,13
jettset,19.8235560112,6.71560798148,0,1,1
clutchreacts,19.8211987756,5.07431421824,1,3,4
acholight,19.8172949409,5.34679006144,1,2,3
launch,19.8141728984,5.05757979379,1,2,3
rick_thefox,19.8135186628,4.43968158165,1,4,5
caveman?,19.811446329,4.31810013253,1,4,5
workingbee,19.8101572955,6.0219677541,0,2,2
lejoy,19.808139334,5.22752746863,1,2,3
bagel,19.8072646348,6.19062107488,0,2,2
egal,19.8041391304,4.73320797528,1,3,4
duff,19.8014440665,5.19550834497,1,2,3
wasted,19.7997130022,5.21657603623,1,2,3
thrice,19.7965457852,5.05177605574,1,2,3
kelso,19.7955420542,5.02545935449,1,4,5
ch14,19.7920365652,5.207645004,1,2,3
jotinos,19.7867374911,4.1058202903,2,4,6
jujubeen,19.7787570103,6.85827560504,0,1,1
a1-ex,19.7696587226,5.25430791414,1,2,3
zukon,19.7685356239,6.87575740977,0,1,1
vipereyezd,19.7684235121,6.67268058218,0,2,2
juniorbug,19.7659466096,5.18504360015,1,2,3
tay tay swizzle,19.753225713,4.30912453515,2,4,6
bruny bby,19.7526456897,6.82687533901,0,1,1
meeech,19.7477066729,6.22435882845,0,2,2
noon,19.7461365335,4.78529711797,1,4,5
hatesauce,19.7453075767,4.1812901778,2,4,6
moko,19.7371489029,5.09558964748,1,2,3
kre,19.7353828601,4.34612301187,1,4,5
vidya_james,19.7204951595,5.06935344392,1,3,4
ryebread,19.7156624132,5.17105188085,1,2,3
stonerocks,19.7092617664,5.32361560048,1,2,3
goop,19.70016567,6.27570617528,0,2,2
cyb3r,19.6928632238,5.19140624953,1,2,3
tranq,19.6859894436,6.57665583284,0,2,2
burgei,19.6843539624,6.26774973263,0,2,2
preme,19.6762412176,6.5117649642,0,2,2
kavorca,19.6746152081,5.17035680857,1,4,5
memes,19.6563580221,3.59730528086,2,7,9
pumpkinleaf,19.6556505175,4.42848502383,2,4,6
maharg07,19.6514221754,6.62992025882,0,2,2
sloth-behr,19.6494076939,6.48539883339,0,2,2
psych,19.6465049445,6.62148661572,0,2,2
fancy wolf,19.6439678337,4.47665042778,1,4,5
tvomusic,19.6307182877,6.93483552681,0,1,1
jhomas,19.6197401305,5.26253603762,1,2,3
rustysneakers,19.6166993686,6.9316655958,0,1,1
yopedd,19.6122174447,6.60600985303,0,2,2
nimrod,19.6119797533,6.39228364396,0,2,2
sailor mercury,19.603182115,6.93203529603,0,1,1
hoyt,19.6024016685,4.93643252597,1,2,3
syix,19.6003057705,6.07940108341,0,2,2
mikehawk,19.5999132812,6.57619254313,0,2,2
derg,19.5896695633,6.59711367544,0,2,2
buttpounder420,19.5862406016,6.66053855777,0,2,2
italian n1nja,19.5850959495,2.83075221756,3,12,15
thesneakiestbeaver,19.5793550527,6.36579314602,0,2,2
king james,19.5786963394,6.7580169964,0,1,1
exaltedoreo,19.5773730094,6.59267664676,0,2,2
butrs,19.5648642378,4.79724927739,1,4,5
boh,19.5635148848,5.17776784754,1,2,3
spiritranger99,19.5535400177,5.16453595188,1,2,3
majersk21,19.5493395729,5.243342441,1,2,3
wassup,19.5475334204,6.63119763251,0,2,2
hawkboy1080yt,19.5421375177,4.98097760203,1,3,4
zee,19.5394913583,4.90495722878,1,4,5
deadstorm,19.5374271313,4.14145040011,2,4,6
wojo42,19.536383704,4.26236535515,2,4,6
jeodude,19.5277546764,6.60290746278,0,1,1
slyfincleton,19.5254206839,6.58127348227,0,2,2
monkeyzz,19.5196109917,4.77122069974,1,2,3
kaos,19.5170508533,6.28540514281,0,2,2
yor742,19.5153798255,6.22057770469,0,2,2
mr. cool guy,19.5136468128,6.18518906032,0,2,2
spankers,19.5122181022,6.57473098585,0,2,2
tourguide,19.5064428208,6.15084529295,0,2,2
mr. h,19.5056999537,6.41665718313,0,1,1
ehro,19.5053188451,6.91185086532,0,1,1
juicé,19.4918308369,6.23745009215,0,2,2
thunderchunkie,19.4845849753,5.26259215191,1,2,3
snailure,19.4815415336,6.52050880381,0,2,2
bonestorm,19.4759163841,6.74153879572,0,1,1
soup,19.4731580719,4.49153232809,1,5,6
pablopicasso,19.4476635182,6.52554802907,0,2,2
renz gaming,19.4429991691,4.95667840195,1,3,4
sid,19.4367304894,6.90792122918,0,1,1
grublord,19.4339713056,6.55177704929,0,2,2
dutes,19.4336098817,5.02566759216,1,2,3
heykyle,19.4306464002,4.72967921347,1,2,3
kid dank,19.4297875612,6.08551969998,0,2,2
drybones,19.4270772102,6.05689267945,0,2,2
soulless,19.4243657354,6.89549862718,0,1,1
crysisbacon,19.4141270752,6.02507008023,0,2,2
koopa,19.4123390206,4.8858158096,1,4,5
jebu,19.4123390206,4.8858158096,1,4,5
dmon,19.4109585478,6.53749294485,0,2,2
toiletsnakes,19.406085459,6.49948374549,0,2,2
oni shin,19.3963620528,6.91632160687,0,1,1
caucasian asian,19.3835359485,6.10511762647,0,2,2
bchan,19.3794948771,6.62307184856,0,1,1
cagnar,19.3757262613,4.99587864558,1,4,5
n337,19.3756603909,6.21954718803,0,2,2
joshers,19.3749219133,6.20953006314,0,2,2
element of smash,19.3747711534,6.51405392082,0,2,2
samadisafadi,19.3737989834,6.35580278254,0,2,2
olives,19.3730577784,4.29830131261,1,4,5
musigh,19.3711183767,4.0810389138,2,6,8
kevinwut,19.3659189048,6.21274215268,0,2,2
just ben,19.3645988958,6.52335928823,0,2,2
guillermoose,19.3634493513,4.6642128221,1,4,5
brimiq,19.3564058163,4.67958827253,1,4,5
maven,19.3545702517,4.52547187676,1,3,4
wff,19.352184711,4.46570100721,2,4,6
sap,19.3433166642,4.91724301175,1,4,5
red blaze,19.3397799432,3.8455584,2,7,9
kulprit,19.3362247235,3.23823250594,3,8,11
flyingmelons,19.3342029001,2.47702530642,3,18,21
michaelmichaelmotorcycle,19.3329959283,4.84112543874,1,4,5
nextile,19.3292033152,6.58629259251,0,2,2
n-boss,19.3262792993,5.24068920235,1,2,3
sudofox,19.326016905,6.50183202749,0,2,2
vallarris,19.3254468114,6.04649039357,0,2,2
rod,19.3210779403,6.45935136957,0,2,2
brandonthehighschooler,19.31316803,4.88839021828,1,2,3
koten,19.3120892819,5.14349636402,1,2,3
....,19.3102878863,6.7398200569,0,1,1
rollock,19.3094393262,6.906843086,0,1,1
afterlife,19.3094393262,6.906843086,0,1,1
gomer,19.3094393262,6.906843086,0,1,1
cjscaduto,19.3094393262,6.906843086,0,1,1
keirazyth,19.3064662548,6.53773830914,0,1,1
jembosa,19.302829864,6.14178509983,0,2,2
omar,19.3023294073,6.22294103452,0,2,2
veryyes,19.2951250799,5.78727340819,0,4,4
set!,19.2926846013,6.50306536445,0,2,2
st0rmetom,19.2920835481,5.94957043622,0,2,2
moonunit,19.2899774868,6.38507609816,0,1,1
pelso,19.2860530188,3.85192107189,2,5,7
cope,19.2825115556,4.76564785506,1,4,5
blizzy nuggs,19.2820818089,5.21220790078,1,2,3
kaiser,19.2756432564,4.16460259223,2,7,9
fez2,19.2751397245,6.46545207464,0,2,2
pkluv,19.271110928,6.19019966087,0,2,2
schleep,19.2709357305,6.87274407623,0,1,1
praaxx,19.2697174967,6.15923364537,0,2,2
sparkbrain,19.2625732799,4.4766373803,1,4,5
barcode,19.259827973,4.2994778378,1,4,5
lumia,19.2548537707,3.80828277053,2,8,10
napi,19.2516675483,4.69572784687,1,4,5
wterka,19.2511253049,6.22976795785,0,2,2
dark link,19.2508079324,6.46365717049,0,2,2
phoenix,19.2474505073,2.66998609093,4,15,19
swing first,19.2466992908,6.48591405768,0,2,2
axel,19.2449657488,5.34332046111,1,2,3
doonee,19.2443525586,6.4728385258,0,2,2
pk don,19.2430171967,6.23227267321,0,2,2
samson,19.2413733463,5.61253312758,1,2,3
hest,19.2377820057,4.81254617902,1,4,5
grinfinity,19.2256512846,6.87136383112,0,1,1
sampai,19.2133420139,4.1953981272,1,6,7
firearrow,19.211035738,4.90465135008,1,4,5
house rat,19.2100751597,6.26485245456,0,2,2
kjae__,19.2091983977,6.29761066564,0,2,2
ladies,19.2084256932,6.2639845496,0,2,2
general gengar,19.1957927436,6.38735507829,0,2,2
chirka,19.1892021497,6.17854118795,0,2,2
yogi,19.1863114688,3.5771919609,3,8,11
contrabass,19.1838499183,6.44577727773,0,2,2
kliner,19.1789782086,6.49822062528,0,2,2
ultimat3spaz,19.1765878063,5.05781861326,1,4,5
dreamsicle,19.1761931767,6.29727153722,0,2,2
falcouser,19.1755389826,6.85097043946,0,1,1
the muffin man,19.1736673498,6.46721565753,0,2,2
faddie,19.1725588959,6.69765868345,0,1,1
consultant,19.1680393671,6.03527406395,0,2,2
d2ng,19.1669224956,6.88555455547,0,1,1
duni,19.1581604616,3.75078270839,2,8,10
rezo,19.1565929476,6.88403402177,0,1,1
flawlesskills,19.1542251764,6.46355221873,0,2,2
otter,19.1521428037,6.41696205563,0,2,2
pythagoras,19.1485413387,6.46348621908,0,2,2
harambe,19.144693621,4.92154885843,1,2,3
cag,19.1358753473,3.67331434644,2,6,8
kafka,19.1264351188,3.06289735296,3,11,14
samwize,19.1239405658,2.76570478492,2,10,12
styx,19.1184169509,6.1134590013,0,2,2
dom,19.1136363045,4.93659770822,1,4,5
zen,19.1078628521,3.42239995074,3,8,11
robotsword,19.1057597031,6.51122808885,0,2,2
mr. beet,19.0985193028,6.4230661318,0,2,2
e-n,19.096816736,4.57778913089,1,4,5
astealthykorean,19.0874094017,4.83795390559,1,4,5
beaver,19.0821040052,6.42993545031,0,2,2
lickney,19.0816133795,6.55134884927,0,2,2
rest,19.0813048813,6.38641134983,0,1,1
leather,19.0804083798,3.98241552185,2,3,5
beak,19.0764086253,6.41171563054,0,2,2
maxxorz,19.0667142607,5.961860603,0,2,2
captbutter,19.0660320645,5.22365286992,1,2,3
owlnips,19.0635060916,4.86721364767,1,2,3
kido,19.0629664704,6.64006431004,0,2,2
kid_a,19.0604131293,6.50169909335,0,2,2
bitch-sensei,19.0601485119,6.17124319499,0,2,2
docukid,19.0600636963,6.39597367834,0,2,2
smeedot,19.055165774,5.08063565244,1,2,3
linkguy23,19.0549173996,6.39803791318,0,2,2
outlier,19.0533550743,4.68052571495,1,4,5
palaver,19.0457569138,6.58347101572,0,2,2
banana,19.0451293784,5.89554005071,0,2,2
pikalu,19.0393759683,6.54700293458,0,2,2
lightning mcpeen,19.0368316397,5.96411133307,0,2,2
commish,19.0350401481,6.56095087948,0,2,2
megaman,19.0349037414,4.54676923842,1,4,5
derilink,19.0270836177,6.67484662996,0,2,2
nvy,19.0246741502,5.05460817764,1,2,3
havana club,19.0195020357,6.53814806018,0,2,2
taro,19.01727632,6.37657113368,0,2,2
c3l,19.0136410028,3.1454316479,3,9,12
necky,19.0110266607,3.88928364451,2,5,7
josephdn,19.0061058786,5.87153973727,0,2,2
peegert,19.0059585685,6.15496857629,0,2,2
thunder mlee,19.0028728103,6.87267909617,0,1,1
yung young,19.0028728103,6.87267909617,0,1,1
syntax,19.0028728103,6.87267909617,0,1,1
catan,19.0028728103,6.87267909617,0,1,1
noflexzone,19.0028728103,6.87267909617,0,1,1
enjoiful,19.0028728103,6.87267909617,0,1,1
yeah~ok,19.0028728103,6.87267909617,0,1,1
edward,19.0028728103,6.87267909617,0,1,1
mindchanger,19.0028728103,6.87267909617,0,1,1
tingsing,19.0028728103,6.87267909617,0,1,1
zonezero,19.0028728103,6.87267909617,0,1,1
benzzyzx,19.0028728103,6.87267909617,0,1,1
nanas,19.0028728103,6.87267909617,0,1,1
misting,19.0028728103,6.87267909617,0,1,1
conair,19.0028728103,6.87267909617,0,1,1
derpfish,19.0028728103,6.87267909617,0,1,1
i.c. wiener,19.0028728103,6.87267909617,0,1,1
matx,19.0028728103,6.87267909617,0,1,1
bob sura,19.0028728103,6.87267909617,0,1,1
lava,19.0028728103,6.87267909617,0,1,1
jinzo,19.0028728103,6.87267909617,0,1,1
ubll black mage,19.0028728103,6.87267909617,0,1,1
gab,19.0028728103,6.87267909617,0,1,1
actualgarbage,19.0028728103,6.87267909617,0,1,1
albexican,19.0028728103,6.87267909617,0,1,1
hinglemccringleberry,19.0028728103,6.87267909617,0,1,1
nate,19.0028728103,6.87267909617,0,1,1
mootumog,19.0028728103,6.87267909617,0,1,1
yena,19.0028728103,6.87267909617,0,1,1
s@nt,19.0028728103,6.87267909617,0,1,1
tyger,19.0004497469,6.42840820721,0,2,2
pidove,18.9973812047,6.49638684075,0,2,2
sharkman,18.9973187684,6.26728824979,0,2,2
sonic,18.9947053937,6.11602289494,0,2,2
ravedave,18.9921276442,4.06122785765,2,7,9
gems,18.9910949092,4.77567195944,1,4,5
zoso,18.9899923903,6.16351158507,0,2,2
seraph,18.9890469286,6.02900160308,0,2,2
negrodomus,18.9884456064,5.23429023684,1,2,3
kobra,18.9833901889,4.79559911817,1,4,5
curry,18.9830096103,6.39518645417,0,2,2
4skn,18.9814984972,6.41091450564,0,2,2
jonk,18.9773291201,6.12433299232,0,2,2
billy___may,18.9740836573,6.37919471437,0,2,2
blacksite,18.9731073245,4.9617250166,1,4,5
tketle,18.966540617,6.53279185548,0,2,2
beanpaste,18.9630134381,6.08279121241,0,2,2
panosso,18.9606659044,6.46860952464,0,2,2
abdulaziz,18.9473478643,4.78492913092,1,4,5
droltseknad,18.945432044,6.11695912658,0,2,2
dirtydan520,18.9436180969,6.47775570226,0,2,2
alpha,18.9432139224,6.11445649195,0,2,2
doujin logic,18.9411850477,3.53825896401,3,8,11
zamn,18.9349040716,6.3512022743,0,2,2
longlegs,18.9328603432,6.66363703152,0,1,1
bhop,18.931476979,4.42705757305,1,4,5
bupo,18.9279313709,6.63815356044,0,1,1
zectron,18.9261553776,6.35193327547,0,2,2
voodoo man,18.9235627776,4.12922687418,2,4,6
professor compressor,18.9171944841,3.58799245715,3,8,11
bicktrip,18.9130181364,6.0917586749,0,2,2
gib,18.9117276338,3.70947618584,2,8,10
bouyer,18.9055071548,5.09644763378,1,2,3
bendo,18.9045868513,6.14343866174,0,2,2
queuess,18.9008658823,3.97968022986,2,6,8
whiz kid,18.8959978717,4.7063780397,1,4,5
confusion,18.8952892221,4.74926813963,1,4,5
hsy,18.8926446219,6.36574813354,0,2,2
godzillaking,18.8892768111,5.85532238736,0,2,2
a$ce,18.8865284417,6.40779735538,0,2,2
sidetrak,18.8813511664,6.12765376122,0,2,2
shulgin,18.8775613129,6.47249194685,0,2,2
nutsack,18.8758951068,5.28552487667,1,2,3
peeko,18.8739879596,2.61053188761,4,14,18
blueeco,18.8727853859,4.83037918959,1,4,5
triumph,18.870408113,6.38838398059,0,2,2
realalexhahn,18.8657401551,6.11078599275,0,2,2
somethingugly,18.8639816548,4.79378516612,1,4,5
saladin,18.8601677932,4.66975914353,1,4,5
~~boxed~~,18.8531434756,6.19199963226,0,2,2
a-v-ill,18.8511175996,4.79075684566,1,4,5
stk,18.8501874638,4.55055255993,1,4,5
stout,18.8480872993,6.36016096466,0,2,2
jetran,18.842647009,6.10636848347,0,2,2
veps,18.8422115091,3.62975251934,3,9,12
king boolean,18.8410206831,4.07752383446,2,6,8
mech,18.8384230963,6.3923433036,0,2,2
dragonite,18.8302057111,6.13353864664,0,2,2
ace turner,18.8284952166,4.78989953071,1,4,5
midgetto,18.8284471178,4.3885108767,1,4,5
jams,18.8260507118,3.93184265941,2,6,8
midgeet,18.825532316,3.11144034789,2,9,11
coysquash,18.8229505496,6.09453927366,0,2,2
c4,18.8211416184,5.11837626505,1,2,3
vii,18.8186465578,6.1512020116,0,2,2
the rampaging mariner,18.817021323,6.45524039081,0,2,2
slay,18.8107385003,5.96661732845,0,2,2
jcela,18.8075425098,4.42594181459,1,4,5
taiko,18.8072951411,4.73757546979,1,4,5
euclid,18.804265205,6.30915308086,0,2,2
ooookillem,18.8009920455,6.36530300949,0,2,2
blazerboy,18.7981268741,5.92948012154,0,2,2
l-gambino,18.7967269393,4.61110447257,1,4,5
qedem,18.7928222369,6.30364587985,0,2,2
lex,18.789894129,6.34223766748,0,2,2
xpertwizard,18.7892412232,6.31252691538,0,2,2
muddaphocuh,18.7878824464,6.1673287977,0,2,2
macho,18.7820952163,6.46127928623,0,2,2
2sierra,18.7785907653,3.9262641981,2,5,7
tablesalt,18.7768673518,4.23442051284,1,5,6
beggy,18.773976886,4.59110113932,1,5,6
flat nat,18.7668089859,6.31176922132,0,2,2
jisu,18.7653893248,3.89155236906,2,6,8
rashidajones,18.7593428392,6.79008553684,0,1,1
aedrenaline,18.7493025782,4.83522243322,1,4,5
l3ggy,18.7472815527,6.25845489564,0,2,2
poutine,18.7462511437,4.79350278339,1,5,6
killajive,18.7453513987,6.33232800676,0,2,2
wartle,18.7387831898,6.35913915484,0,2,2
swift,18.7383736493,6.50922807336,0,2,2
ciex,18.7378857144,4.98041097539,1,3,4
hunterlittle,18.73565092,6.34294621287,0,2,2
grin,18.7321294259,4.61677567287,1,4,5
nibbynibbynub,18.7298254005,6.35268084485,0,2,2
beatthat,18.7279951837,6.5051055611,0,2,2
szoltan,18.7271557867,6.42394586071,0,2,2
fire,18.7152313724,4.92999029986,1,4,5
flaze,18.7148437058,6.28971510335,0,2,2
propaneaccessories,18.7104554574,6.25247123735,0,2,2
duke tresnor,18.7000223172,4.54262559229,1,4,5
supernuggit,18.6998007716,4.73043852491,1,4,5
catelt,18.694319137,3.95644338525,2,7,9
swish,18.6903278583,4.73788591315,1,4,5
slugimus,18.686391216,6.2772188096,0,2,2
la8pv,18.6828970937,4.52598098584,1,5,6
lalo,18.6822393644,6.0158926657,0,2,2
rocksam,18.6806148077,4.95175091427,1,4,5
veghard,18.6798436901,4.46267947974,1,5,6
isjoltz,18.6784441521,6.31697510193,0,2,2
woofpack,18.677954684,4.43081546959,1,4,5
jellocube,18.6700221561,4.36989292713,1,4,5
nich,18.669815759,5.06104953112,1,2,3
enanogee,18.6693538761,4.76458653771,1,4,5
smookums,18.6683517968,6.30689682532,0,2,2
cheegor,18.6651532653,4.63203919273,1,4,5
dfish,18.6638890041,6.29705135454,0,2,2
squanto,18.6617498786,6.21391861155,0,2,2
hobojoe,18.6578868789,6.63177292726,0,1,1
gyoska,18.6540282502,6.26686413763,0,2,2
dominmuda,18.6459354822,4.2192052232,1,5,6
scoobylew,18.6450935183,6.40496001219,0,2,2
tamn son!,18.6435714184,5.27626600573,1,2,3
snape,18.6399822731,6.25616001929,0,2,2
kem0therapy,18.6396845454,6.47320211719,0,2,2
fantasy,18.6358337666,5.00586083918,1,2,3
bathtubfrog,18.6328279447,6.40397897151,0,2,2
jasper,18.6319175762,5.86399079086,0,2,2
tac,18.6298631477,6.22351925426,0,2,2
chiefchickenwing,18.6258084607,6.46802905084,0,2,2
wasian,18.6247040508,4.76385253798,1,4,5
winky,18.6212266487,4.55675503385,1,4,5
parappa,18.6194499343,5.95346413358,0,2,2
sigmar,18.6191406255,4.01901726345,2,5,7
imbimbo,18.6136742028,6.23249623792,0,2,2
ramenshaman,18.6121242645,6.46377059851,0,2,2
briefs,18.611145022,6.16230679718,0,2,2
dog+,18.6026072423,6.09406042188,0,2,2
surge,18.6019637502,3.43399752707,2,8,10
beltbuckle,18.5984668017,4.72988041691,1,4,5
mumb0 jumb0,18.5968341435,6.22469184476,0,2,2
caff3in3fr33,18.5936903659,5.99645216837,0,2,2
frardvark,18.5924468103,6.44687663908,0,2,2
muchomario,18.5875414108,6.01114538626,0,2,2
ihavesonar,18.585198612,6.02915355467,0,2,2
robes,18.5823131286,6.20948254862,0,2,2
scud,18.5795357823,6.07684165939,0,2,2
micro,18.5786691953,4.84460195953,1,5,6
dr-wumbo,18.5766899079,6.16092555896,0,2,2
elliot,18.5744645371,3.49694466548,3,7,10
kups,18.5739321805,6.32103573309,0,2,2
hammern,18.5733103773,4.13712073139,2,5,7
arjen,18.5726410667,6.39437070956,0,2,2
dan soup,18.570754886,5.0849823683,1,4,5
papa ben,18.5701125974,6.30344101959,0,2,2
varisia,18.5683980134,6.31388266501,0,2,2
rumo,18.5681729561,2.91764431328,2,10,12
bowman,18.5656630032,6.44910257287,0,2,2
raiguy,18.5626282741,6.19596109878,0,2,2
valkyrie,18.5595410216,6.06262771859,0,2,2
kil,18.5591811665,6.44631452939,0,2,2
we-g,18.5572371063,6.24347861697,0,2,2
nasty$lckback,18.5531658516,4.80869688911,1,4,5
josamabinladen,18.5516840247,6.20529414945,0,2,2
skyles,18.5510205625,6.44543013967,0,2,2
randy butternubs,18.5494619392,6.44343213699,0,2,2
cholo steve,18.5479879052,6.44350463665,0,2,2
dota,18.5442342421,6.08606262997,0,2,2
jaypee,18.5440272782,6.31190773026,0,2,2
vawx,18.5388934987,6.44077939027,0,2,2
cpu,18.5381228661,6.19227316802,0,2,2
radbot,18.5378195232,5.66916610092,1,2,3
big d squirrels,18.5372554676,4.74030490108,1,4,5
jfro,18.5356327483,6.39065541211,0,2,2
rugaru,18.5336109417,6.24289050794,0,2,2
karvaperse666,18.5314123325,4.75150376784,1,4,5
spann,18.5313112511,4.62799606527,1,4,5
the best,18.5302336423,5.05365588532,1,3,4
diablomablo,18.5300178883,6.32001790553,0,2,2
swiss,18.5294265163,5.95213019522,0,2,2
snake master,18.5292117971,5.85927764296,0,2,2
nefe,18.520975974,4.80754355139,1,4,5
dannyy,18.5190674335,4.63391631398,1,5,6
ckx,18.5165502825,3.10731137597,3,10,13
battery,18.5164533759,6.23880570116,0,2,2
toasty,18.5154465469,4.9656094831,1,3,4
suck,18.5128686225,4.45631382569,1,4,5
timemuffin,18.5112547525,6.06665044787,0,2,2
fija,18.5097896563,6.14914824019,0,2,2
jag älskar avatar123,18.5091468535,5.88295565435,0,3,3
lemons,18.5090576382,3.41160624395,3,8,11
mdsr,18.5062469062,6.37569861138,0,2,2
jeo,18.5042937914,6.39868868768,0,2,2
baumwolle8,18.5004726952,6.04445589473,0,2,2
ankle,18.5002254913,6.25588538352,0,2,2
hijo,18.4995847089,4.571186932,1,3,4
yowaffle,18.4947279502,6.05573908925,0,2,2
doublepappa,18.4924153003,6.42649352107,0,2,2
djswerve,18.4917851685,4.67674769753,1,4,5
johncraw,18.4896143347,6.12468706615,0,2,2
zircean,18.4884055087,6.60967396435,0,1,1
ponj,18.4811447371,6.42318728266,0,2,2
jrrd,18.4810019638,6.17620443306,0,2,2
jpin,18.4762042524,6.30319308607,0,2,2
meteora,18.47462449,4.81221215066,1,4,5
tengu man,18.4743013092,6.42184998572,0,2,2
wes,18.4714234585,6.42047679026,0,2,2
notlightningrunner,18.466210287,6.41905837003,0,2,2
chinaux,18.4649996137,6.16106388381,0,2,2
danku,18.4613700312,4.54098463593,1,4,5
geeslice,18.4558890068,6.34339263042,0,2,2
kamek,18.4553941305,4.38364925361,1,4,5
stonewill,18.4552996999,4.72473466468,1,4,5
salfam,18.4529225484,6.27590526856,0,2,2
shakey,18.4516675313,6.22287322588,0,2,2
oshi,18.4507517095,5.7740908284,0,2,2
sarthssb,18.4506377665,6.41534381188,0,2,2
r0cky,18.450605875,6.41504857299,0,2,2
eggmode,18.4483626731,4.78876073873,1,4,5
midnight,18.4482133167,6.75742069655,0,1,1
sablestarr,18.4449071571,6.3413237468,0,1,1
island,18.4415963531,6.37297866263,0,2,2
stickers,18.4373515175,6.36129434507,0,2,2
koga,18.4346011549,5.86384360161,0,2,2
jamz,18.4332156568,6.19292519525,0,2,2
bushels,18.4331805408,5.96171123781,0,2,2
redribb0n,18.428365906,6.23106565094,0,2,2
hotsauce,18.4279984139,5.95778977222,0,2,2
dad nuggets,18.4262325094,6.28525501857,0,2,2
muthaluva777,18.4197161777,6.40576726266,0,2,2
jstar,18.4183236917,4.86264203449,1,4,5
rushhour,18.4116475573,6.21596211338,0,2,2
phoenix2448,18.4079266375,4.77073818557,1,4,5
luxx,18.4002695498,4.86883780466,1,4,5
youngquest,18.3959219503,6.40069731943,0,2,2
show me the carfax,18.3956976684,6.36209992307,0,2,2
espionage,18.3951248017,5.0956965828,1,2,3
slippy,18.3915093031,3.13896882515,2,12,14
ifger,18.3912229839,6.39657651533,0,2,2
bravo$,18.3893287169,5.96473625856,0,2,2
quiche,18.3867482201,6.73275840994,0,1,1
trains,18.3866846253,6.09792937414,0,2,2
nnn,18.3810528744,4.76028922837,1,4,5
insector,18.3775521622,4.75345114329,1,4,5
galeforce,18.3774497477,6.30974676466,0,2,2
uguize,18.3744013582,6.21817519942,0,2,2
fishguts,18.3743640429,6.19964761309,0,2,2
telmo,18.3732508401,4.85619851924,1,4,5
monarchy,18.3696951716,6.14147980739,0,2,2
666,18.3679571351,6.20868053988,0,2,2
pulver,18.3660466478,5.99489516956,0,2,2
drfabs,18.3647429419,6.2493938914,0,2,2
natalie portman,18.3634568773,6.38874711307,0,2,2
_liuser,18.3624582933,6.39092768553,0,2,2
lan,18.3577767565,6.2521714548,0,2,2
winston,18.3577767565,6.2521714548,0,2,2
kurben,18.3577767565,6.2521714548,0,2,2
glitter,18.3577767565,6.2521714548,0,2,2
fizix,18.3517597921,4.78532100042,1,4,5
r2z2,18.3507542711,6.25540169543,0,2,2
emo,18.3502224863,6.18013792829,0,2,2
kenzz,18.3489853655,6.38711100188,0,2,2
holden,18.3455076884,6.07976606381,0,2,2
javqa,18.3440846439,3.68538738983,2,7,9
cadronate,18.340424137,6.3523393028,0,2,2
nutsosteel,18.3394749733,6.21699671193,0,2,2
jeez,18.335760793,6.38290837447,0,2,2
juststrife,18.3344453612,6.02601159167,0,2,2
sir dax,18.3337669927,6.38873139608,0,2,2
finesse,18.3319736191,6.38205528131,0,2,2
master brawler,18.3315123602,6.42539225051,0,2,2
bonnup,18.3294803452,6.36879947602,0,2,2
tara,18.3290782135,3.1175010794,3,10,13
tmanmaniac,18.3264660219,5.98226519564,0,2,2
regralht,18.3253914383,6.38023202143,0,1,1
/.help,18.3240829318,6.263155055,0,2,2
kos,18.3190790425,6.38005947191,0,2,2
geppetto,18.3188835846,6.38083724089,0,2,2
papa diamond,18.3162649063,6.18005701831,0,2,2
qwetroop,18.3127398028,6.37533401992,0,2,2
axis,18.3052027651,6.22895677931,0,2,2
urpasmash,18.3046710367,5.98999254804,0,2,2
z0ra,18.3024840472,6.25000922345,0,2,2
dat cookie doh,18.3014258849,6.2237746044,0,2,2
unit456,18.300209315,6.03555483893,0,2,2
siliconphallus,18.3001820288,6.37522358902,0,2,2
alam2,18.2947996696,6.3748142162,0,2,2
wherd,18.2927015415,6.37426260432,0,2,2
kyri0n,18.2890904824,6.36917649173,0,2,2
catfish,18.2862467153,6.244752387,0,2,2
dbat,18.2858792337,5.9847917475,0,2,2
primal,18.2789553189,4.70933775881,1,4,5
hasp,18.2781481092,6.36815094644,0,2,2
shaq,18.2771271452,5.94913999577,0,2,2
lolimacat,18.2753698195,6.07690186924,0,2,2
hensdaddy,18.2738755686,4.69608706373,1,4,5
mabotofu,18.2719720978,6.37824025652,0,2,2
helm,18.2649116449,6.12595088901,0,2,2
proxibomb,18.261321226,4.10484973921,1,5,6
luke wilson,18.2611356539,5.73116304664,0,2,2
joe deveer,18.2602592217,6.09770065309,0,2,2
snoop,18.2514328997,6.3595125069,0,2,2
c15,18.2495316119,4.10493442899,2,4,6
skull 5,18.2488616417,6.16333285723,0,2,2
smoking_hot_bbq,18.2453160378,6.25159412573,0,2,2
anton,18.2443256103,6.0494274822,0,2,2
oldjokes,18.241017383,4.74811712674,1,4,5
marionette,18.2379224142,4.15383424981,2,6,8
krakennrv-,18.2371571938,4.82118274096,1,4,5
sg1simmons,18.2371535524,6.35988573931,0,2,2
migboy,18.2359000664,6.20887040273,0,2,2
duke,18.235420088,6.3594542091,0,2,2
tafy,18.2352684538,4.69883278028,1,4,5
nuts4nuts4nuts,18.232707062,6.15287702823,0,2,2
jeff chang,18.2314440659,6.33949456221,0,2,2
pengwenhawk,18.2295782072,6.35320884793,0,2,2
els3y,18.2256869099,6.1417663267,0,2,2
ketchupnmustard,18.2248054873,6.35712442662,0,2,2
psiguy,18.224116661,5.98867020517,0,2,2
djstank,18.2232921457,6.30997860779,0,2,2
solo,18.2184276089,3.50245033501,3,10,13
black pit,18.2175082758,6.05902665305,0,2,2
ds,18.2144205704,3.6112232453,2,5,7
nuggyjones,18.2140833698,6.01715711869,0,2,2
peter,18.2132481954,6.02349107937,0,2,2
aisengobay,18.2049544227,6.23510357107,0,2,2
flat,18.199020153,6.26506717841,0,2,2
tuukkatime,18.1968969079,6.13709710101,0,2,2
kepp,18.1929123127,4.79243101217,1,4,5
sdoc,18.1916740764,6.07777445212,0,2,2
connoramo,18.1893215791,6.70765709634,0,1,1
lolex,18.1878221595,3.74557085679,3,6,9
him,18.1876132981,6.06468095853,0,2,2
porter,18.1873401433,6.28773254264,0,2,2
vile,18.1865757683,6.15003530559,0,2,2
bass,18.1862188639,6.23141240502,0,2,2
moonman,18.1829969528,4.57436046482,1,4,5
#20g9ry2gp,18.1821213017,4.52100097543,1,4,5
ricedude,18.1815795085,6.35667866989,0,2,2
champagne papi,18.1806601701,6.33934377402,0,2,2
tlbs,18.1746948674,5.70023074596,0,4,4
tarzan,18.1738002419,6.35483782361,0,2,2
mayofknees,18.1727745837,5.99776420424,0,2,2
faded,18.1716374459,4.00468420792,2,4,6
hummuslover69,18.1695070233,5.93758347516,0,2,2
pat,18.1693629391,6.33322709773,0,2,2
ziltoidfalco,18.1688443736,6.32624678292,0,2,2
tpop,18.1644216129,6.13650018319,0,2,2
bajoggles,18.1643477863,6.1312735904,0,2,2
kitty,18.1559970157,6.11938911677,0,2,2
long and hard,18.1539216447,6.35079651557,0,2,2
that0neguy,18.1526707096,6.12791219724,0,2,2
bang,18.150943246,6.13123888327,0,2,2
wooper,18.1476807269,6.33771154541,0,2,2
superbagel,18.1455287126,6.02940437952,0,2,2
majorleagueturtle,18.1444551807,4.52243899051,1,4,5
almost ham,18.140906936,6.21578576284,0,2,2
dustland,18.1361987889,6.14425940785,0,2,2
jo,18.1361983201,6.35750874244,0,2,2
hexagons,18.1353569608,6.04604243513,0,2,2
ghost [gardner],18.1258877587,6.33445717145,0,2,2
chi$munny$,18.1256969792,6.14413383562,0,2,2
real,18.1241324317,4.73724013038,1,4,5
jaji,18.1239109848,6.23195536556,0,2,2
kzidek,18.1229855198,4.59363726102,1,5,6
ny_lights,18.1196603998,6.36326178204,0,2,2
rai,18.1155548075,6.32741060607,0,2,2
cryptic,18.1144599766,6.19619953331,0,2,2
dennysgrandslambreakfast,18.1142916122,6.22171372407,0,2,2
ragecage,18.1131154154,6.15817737688,0,2,2
rayramono,18.1112220974,4.63578725676,1,4,5
dirty socks,18.1102630677,6.32749404187,0,2,2
dirtydev,18.1089416713,6.29648098141,0,2,2
yobbo,18.1069641894,6.03756702357,0,2,2
mirth,18.1012300186,5.92414374458,0,2,2
cherrypauper,18.1006942572,6.32718451654,0,2,2
canary,18.1000003278,4.94139097675,1,5,6
patchwork,18.0992287077,6.10708343666,0,2,2
dylonway,18.0987763059,6.0668282322,0,2,2
bambooo,18.0978274374,6.03657519657,0,2,2
good handwriting,18.0978006068,6.67406190924,0,1,1
pika god,18.0955748111,6.03453135319,0,2,2
teejusb,18.094825302,6.30426331404,0,2,2
luretryne,18.0908530336,3.82420100626,1,6,7
quien?,18.0895120868,5.70379454402,0,2,2
veggietalesdeluxe,18.0886499232,6.09567626875,0,2,2
wal,18.0882923112,4.52137641187,1,4,5
mesmerist,18.0882564081,5.95644782853,0,2,2
edamame,18.0850745739,6.3107897112,0,2,2
norway,18.0841022875,3.30969260436,3,11,14
anduni,18.0828444979,6.32125134031,0,2,2
rezah,18.0824771234,6.01108971192,0,2,2
cyrup,18.0816831323,6.32287378383,0,2,2
rza,18.0764371614,6.19864407248,0,2,2
5,18.0754517575,6.1853540477,0,2,2
parra,18.0708270262,3.91597696115,1,8,9
mrdr,18.0703723729,6.31834047469,0,2,2
some freaking cactus,18.0695408889,6.18446838979,0,2,2
groove crusader,18.0689734211,4.719612033,1,4,5
swiper,18.0674267053,5.95235234579,0,2,2
bom,18.063794277,6.31396442905,0,2,2
whims,18.063581897,6.12450036494,0,2,2
ruthy,18.0631123667,6.31423754964,0,2,2
captain kush,18.0624078875,6.27052943745,0,2,2
nashi,18.0622710642,4.61706671121,1,4,5
my mom,18.060791029,6.31405475336,0,2,2
mesh$,18.0576202435,6.31546092757,0,2,2
vibes,18.0573227949,6.33103684303,0,2,2
joeyoyos,18.0567787193,5.89679387712,0,2,2
obama,18.0564932189,6.2245370821,0,2,2
robocop,18.0562665324,6.05394969638,0,2,2
overly minus,18.0521447848,6.10067114108,0,2,2
mexican  spongebob,18.0519391521,5.89829113822,0,2,2
louieg,18.0519225452,5.78810335501,0,2,2
pewu,18.043130453,6.33311666586,0,2,2
fuwa,18.0429568542,5.93001502829,0,2,2
fr0d,18.0428187692,6.46387437135,0,2,2
hoofarted,18.0428187692,6.46387437135,0,2,2
bloodzure,18.0428187692,6.46387437135,0,2,2
tunnelsnakesrule,18.0428187692,6.46387437135,0,2,2
kanto,18.0428187692,6.46387437135,0,2,2
porkwings,18.0428187692,6.46387437135,0,2,2
happydude2,18.0428187692,6.46387437135,0,2,2
mmshan,18.0428187692,6.46387437135,0,2,2
omelette,18.0422239208,5.75148519459,0,2,2
drum,18.0374245722,6.3080291707,0,2,2
everstorm,18.0362007759,6.30621486641,0,2,2
sortie,18.0354583135,4.49131290022,1,5,6
depressed eagle,18.0353671884,3.74277762047,2,8,10
flippy_o,18.0344104376,3.86043882488,2,8,10
taptap,18.0336965978,4.82300820257,1,4,5
151a,18.0335295337,6.23196164388,0,2,2
young_list,18.033279538,6.50820934208,0,1,1
captchagod64,18.0316336606,6.3068084885,0,2,2
kao,18.0305270645,6.32436071169,0,2,2
tiff,18.0283155728,6.28722065422,0,2,2
pom,18.0274899012,4.43868655712,1,4,5
gudaguda,18.0274530755,6.20025917537,0,2,2
winmil,18.0233718109,6.26847508749,0,2,2
dorsh,18.0226182975,6.17795456058,0,2,2
lazer,18.0216628583,6.21366753993,0,2,2
helio,18.0207211573,3.37707716007,3,10,13
kingmaxor,18.0202458531,6.45566975253,0,2,2
paco [larkin],18.0187249326,6.06986880855,0,2,2
shabby,18.0150440182,6.00946933763,0,2,2
kaboom,18.0125911386,6.24323830446,0,2,2
elfonzio,18.0083493699,6.33326283994,0,2,2
un0,18.0069446834,4.74317289348,1,4,5
bozomozo,18.0068685639,6.45114574338,0,2,2
zalost,18.0060240808,3.74093768479,2,6,8
syves,18.0030821245,6.29760265653,0,2,2
gumby,18.0019216299,6.11221248253,0,2,2
fashion police,18.0016287248,4.46466656757,1,4,5
soberd,17.9986358491,4.54893950965,1,3,4
lordbeard,17.9980023599,6.32119878345,0,2,2
codec,17.9980023599,6.32119878345,0,2,2
juno,17.9980023599,6.32119878345,0,2,2
the cold vein,17.9980023599,6.32119878345,0,2,2
letterboy,17.9980023599,6.32119878345,0,2,2
amoeba,17.9980023599,6.32119878345,0,2,2
candle,17.9980023599,6.32119878345,0,2,2
quancentrate,17.9980023599,6.32119878345,0,2,2
i'm the nalls,17.9980023599,6.32119878345,0,2,2
exile,17.9980023599,6.32119878345,0,2,2
highlyeducational,17.9980023599,6.32119878345,0,2,2
glist,17.9980023599,6.32119878345,0,2,2
mr cutting horse,17.9980023599,6.32119878345,0,2,2
rovl,17.9980023599,6.32119878345,0,2,2
megaamoonguss,17.9980023599,6.32119878345,0,2,2
l0rdchilled,17.9980023599,6.32119878345,0,2,2
cr0ak,17.9980023599,6.32119878345,0,2,2
maps,17.9980023599,6.32119878345,0,2,2
drowninfish,17.9980023599,6.32119878345,0,2,2
radical3i,17.9980023599,6.32119878345,0,2,2
jim,17.9980023599,6.32119878345,0,2,2
_ko,17.9980023599,6.32119878345,0,2,2
organic_bean,17.9980023599,6.32119878345,0,2,2
albert with a money sign,17.9980023599,6.32119878345,0,2,2
jayford,17.9980023599,6.32119878345,0,2,2
nice moose,17.9980023599,6.32119878345,0,2,2
picasso,17.9980023599,6.32119878345,0,2,2
equinox,17.9980023599,6.32119878345,0,2,2
earthberg,17.9980023599,6.32119878345,0,2,2
jlaw,17.9980023599,6.32119878345,0,2,2
1nertia,17.9980023599,6.32119878345,0,2,2
troll meister,17.9980023599,6.32119878345,0,2,2
kitka,17.9980023599,6.32119878345,0,2,2
humanoid,17.9980023599,6.32119878345,0,2,2
valor_ryan,17.9980023599,6.32119878345,0,2,2
moar,17.9980023599,6.32119878345,0,2,2
kingdong,17.9980023599,6.32119878345,0,2,2
kruzz,17.9980023599,6.32119878345,0,2,2
edmund nelson,17.9980023599,6.32119878345,0,2,2
sc0pes,17.9980023599,6.32119878345,0,2,2
mortfeld,17.9980023599,6.32119878345,0,2,2
tevaq,17.9980023599,6.32119878345,0,2,2
imatree,17.9980023599,6.32119878345,0,2,2
time and trust,17.9980023599,6.32119878345,0,2,2
bebop,17.9980023599,6.32119878345,0,2,2
dolla bill bill,17.9980023599,6.32119878345,0,2,2
ryzzle,17.9980023599,6.32119878345,0,2,2
kurly,17.9980023599,6.32119878345,0,2,2
broclee,17.9980023599,6.32119878345,0,2,2
eliminate,17.9980023599,6.32119878345,0,2,2
sammy,17.9980023599,6.32119878345,0,2,2
amrit,17.9980023599,6.32119878345,0,2,2
slappygilmore,17.9980023599,6.32119878345,0,2,2
pigeon,17.9980023599,6.32119878345,0,2,2
grizzlybair,17.9980023599,6.32119878345,0,2,2
darkclops,17.9980023599,6.32119878345,0,2,2
guapo,17.9980023599,6.32119878345,0,2,2
ikd!,17.9980023599,6.32119878345,0,2,2
spoons,17.9980023599,6.32119878345,0,2,2
mrdrjacob,17.9980023599,6.32119878345,0,2,2
tag pending,17.9980023599,6.32119878345,0,2,2
eggbert,17.9980023599,6.32119878345,0,2,2
dong,17.9980023599,6.32119878345,0,2,2
king k rool,17.9980023599,6.32119878345,0,2,2
shaw,17.9980023599,6.32119878345,0,2,2
birdman,17.9980023599,6.32119878345,0,2,2
rêve,17.9980023599,6.32119878345,0,2,2
dern,17.9980023599,6.32119878345,0,2,2
the pretzel pimp,17.9980023599,6.32119878345,0,2,2
laham,17.9980023599,6.32119878345,0,2,2
taco,17.9980023599,6.32119878345,0,2,2
m.kat,17.9980023599,6.32119878345,0,2,2
tokiokid10,17.9980023599,6.32119878345,0,2,2
tome,17.9980023599,6.32119878345,0,2,2
leazure,17.9980023599,6.32119878345,0,2,2
hatmadder,17.9980023599,6.32119878345,0,2,2
tats,17.9980023599,6.32119878345,0,2,2
blindluckbert,17.9980023599,6.32119878345,0,2,2
mr. meeseeks,17.9980023599,6.32119878345,0,2,2
broon the spoon,17.9980023599,6.32119878345,0,2,2
pliskin,17.9980023599,6.32119878345,0,2,2
charlie sheen,17.9980023599,6.32119878345,0,2,2
incurredwrath,17.9980023599,6.32119878345,0,2,2
iridium,17.9980023599,6.32119878345,0,2,2
yung blessed,17.9980023599,6.32119878345,0,2,2
vlerk,17.9980023599,6.32119878345,0,2,2
spike,17.9980023599,6.32119878345,0,2,2
fernyysanchez,17.9980023599,6.32119878345,0,2,2
bullshooter,17.9980023599,6.32119878345,0,2,2
athens,17.9980023599,6.32119878345,0,2,2
stanley mayhem,17.9980023599,6.32119878345,0,2,2
runix,17.9980023599,6.32119878345,0,2,2
bren,17.9980023599,6.32119878345,0,2,2
themickeynick,17.9980023599,6.32119878345,0,2,2
noire,17.9980023599,6.32119878345,0,2,2
nicklit,17.9980023599,6.32119878345,0,2,2
blackstar,17.9980023599,6.32119878345,0,2,2
toro,17.9980023599,6.32119878345,0,2,2
dr.islio,17.9980023599,6.32119878345,0,2,2
klms,17.9980023599,6.32119878345,0,2,2
theargentinegreek,17.9980023599,6.32119878345,0,2,2
zaq,17.9980023599,6.32119878345,0,2,2
brokr,17.9980023599,6.32119878345,0,2,2
nell,17.9980023599,6.32119878345,0,2,2
muse_10,17.9980023599,6.32119878345,0,2,2
gamestationpro,17.9980023599,6.32119878345,0,2,2
flcd,17.9980023599,6.32119878345,0,2,2
smt,17.9980023599,6.32119878345,0,2,2
mank,17.9980023599,6.32119878345,0,2,2
kebab,17.9980023599,6.32119878345,0,2,2
20pcmcnugget,17.9980023599,6.32119878345,0,2,2
paws,17.9980023599,6.32119878345,0,2,2
bbg,17.9980023599,6.32119878345,0,2,2
tonik,17.9980023599,6.32119878345,0,2,2
poontycoon,17.9980023599,6.32119878345,0,2,2
turnt_up,17.9980023599,6.32119878345,0,2,2
codytappen,17.9980023599,6.32119878345,0,2,2
sinine,17.9980023599,6.32119878345,0,2,2
gansama,17.9980023599,6.32119878345,0,2,2
mhmm,17.9980023599,6.32119878345,0,2,2
lustrick,17.9966408892,5.72861633507,0,2,2
hypa,17.9925940601,6.12893272343,0,2,2
mertauh,17.991935949,6.00091537386,0,2,2
kwang,17.9907402618,4.57819230892,1,4,5
iiliitist,17.9871352039,6.44476018853,0,2,2
shiiv,17.9867724827,6.20386368353,0,2,2
mcspammer,17.9846053545,6.29286714433,0,2,2
hiv+,17.9843615653,4.43579149229,1,4,5
zerthex,17.9814660217,6.14756800729,0,2,2
kingwolfgang,17.9811862118,5.69418032979,0,2,2
lordtogs,17.9794653113,4.01140596894,2,4,6
vinje,17.9788892564,6.32078887469,0,2,2
hamhampopo,17.9766716064,6.3145628101,0,2,2
tuba,17.9766431866,5.72669743114,0,2,2
baltimarth,17.9760186019,4.84989503927,1,4,5
cheeze whizard,17.9755130022,6.29906661054,0,2,2
countedbeef122,17.9738852133,6.3015179767,0,2,2
jacobarf,17.9699315921,4.40957015164,1,4,5
splash,17.9692443808,5.81240529341,0,2,2
kirro,17.9688003138,6.16880310589,0,2,2
trump2020,17.9656748699,6.14646852029,0,2,2
jslayer,17.9653539845,6.29617285694,0,2,2
mariner,17.9585285105,6.29365922064,0,2,2
durandal,17.9580664554,6.29508425825,0,2,2
the amputee,17.9549877037,6.28018135274,0,1,1
sss,17.9518755711,6.29353734746,0,2,2
endofstory,17.9509171114,4.84596758005,1,4,5
patsheezy,17.9509171114,4.84596758005,1,4,5
2%,17.9505484112,6.28790343264,0,2,2
theschmuck33,17.9504462947,6.31464811133,0,2,2
jesper,17.9484295575,4.0517837309,1,7,8
hatbeanie,17.9421735478,4.70750492165,1,4,5
cammy,17.9416867814,6.16786847069,0,2,2
j.tmbr,17.9408832999,4.28856022497,1,4,5
itchyanscratchy,17.9383694895,6.07451675831,0,2,2
theboy,17.9379689142,6.20481301144,0,2,2
the dormouse,17.9350455113,6.03423436328,0,2,2
cool blue™,17.9344406591,4.46193647827,1,3,4
tyler,17.9341651474,4.78805759995,1,4,5
strawberry love,17.9338658506,6.14285090816,0,2,2
barking_frog,17.9315943793,5.9128300841,0,2,2
ayyolado,17.9304706219,6.30905337612,0,2,2
meguca,17.930093097,4.91054139848,1,3,4
pwnagepolice,17.9280083988,4.69997430807,1,4,5
bruisingprune,17.9270553965,5.79267042997,0,2,2
yeesus,17.9253742354,6.17292597545,0,2,2
shippu,17.9241714887,6.30546336552,0,2,2
bell,17.9232877436,4.06250447109,1,4,5
b33f,17.9211405839,6.70910250356,0,1,1
verity,17.9201923097,6.28791785163,0,2,2
pandemicpotato,17.9069747558,6.20400902405,0,2,2
cinc0,17.9057304173,4.54976388821,1,4,5
acons,17.9055473681,6.28645623876,0,2,2
novi,17.903702112,4.85263744263,1,3,4
patty-wagon,17.9028011122,6.30248159975,0,2,2
yeet,17.8998130813,6.00769404966,0,2,2
heavenlyflow,17.8981856505,6.09853062172,0,2,2
na5ty,17.8970001755,5.95983724006,0,2,2
wolfie,17.8936691593,5.84023352308,0,2,2
glockodile,17.8920409796,4.57060521184,1,4,5
mysterion,17.8910847757,4.74738223233,1,4,5
lawyerdog,17.887961304,4.92919790367,1,4,5
omnicloud7strife,17.8857907613,6.08868174046,0,2,2
raiden1,17.8818794385,3.64815005442,2,5,7
karnage,17.8792951176,5.72819364108,0,2,2
slopnessie,17.8786266911,6.26961688279,0,2,2
theauthor,17.8768167541,6.01191450765,0,2,2
chombomann,17.8759551299,6.29759383592,0,2,2
jake snek,17.8745927827,6.06008352777,0,2,2
diego,17.8703777027,6.05870906251,0,2,2
aweshucks,17.8702151353,4.60209017158,1,4,5
gutiger,17.86788803,5.56180652566,0,2,2
dole,17.867236677,6.04228936002,0,2,2
disdeyn,17.8671955424,6.40919634243,0,2,2
shum,17.8632864466,5.8897715081,0,2,2
cosmicswagdaddy,17.8616653953,5.93830825462,0,3,3
mafoo,17.8614769154,6.16463441558,0,2,2
blaziken,17.8581556321,4.45915490493,1,5,6
mccombo,17.8578994316,6.46943629545,0,1,1
j-roc,17.8557121088,4.77970989358,1,4,5
bureaucraat,17.8550470922,6.29429574863,0,2,2
fmax,17.8547702612,4.6304221792,1,4,5
cbass,17.8543455967,6.27402162371,0,2,2
no true scotsman,17.8533805208,6.40476598546,0,2,2
maverick,17.8521646467,3.86994395119,2,6,8
eggs on legs,17.8515352178,6.16117086978,0,2,2
ooze,17.8511775867,4.68595367924,1,4,5
nn7,17.8509207212,6.26286302029,0,2,2
radical raymondd,17.8489659406,6.40403602068,0,2,2
metalheadgx,17.842592747,6.70077814964,0,1,1
highdef,17.8425311656,6.01761332175,0,2,2
joff,17.8424125908,6.05880683304,0,2,2
tashigi,17.8416208398,4.75727719183,1,4,5
marko,17.8410701625,6.40161034098,0,2,2
deathforgold,17.8378409603,6.25463043271,0,2,2
tone,17.833821562,6.07286479316,0,2,2
téabone,17.8336920305,4.7626185357,1,5,6
scorpiator,17.8314176099,4.59325026646,1,4,5
myst,17.829679362,5.82694335906,0,3,3
kimarah,17.8270005524,6.29388615473,0,2,2
axb,17.8270005524,6.29388615473,0,2,2
god,17.8270005524,6.29388615473,0,2,2
nychee,17.8270005524,6.29388615473,0,2,2
dr. wu,17.8270005524,6.29388615473,0,2,2
heavy metal sheik,17.8270005524,6.29388615473,0,2,2
roll,17.8270005524,6.29388615473,0,2,2
kyrios,17.8270005524,6.29388615473,0,2,2
tsundere,17.8270005524,6.29388615473,0,2,2
prism,17.8270005524,6.29388615473,0,2,2
skelly,17.8270005524,6.29388615473,0,2,2
elementofsmash,17.8270005524,6.29388615473,0,2,2
kannonzz,17.8270005524,6.29388615473,0,2,2
zeaku,17.8270005524,6.29388615473,0,2,2
mr yaah,17.8270005524,6.29388615473,0,2,2
jippythelion,17.8270005524,6.29388615473,0,2,2
kentobento,17.8270005524,6.29388615473,0,2,2
m@chete,17.8270005524,6.29388615473,0,2,2
heatriser,17.8270005524,6.29388615473,0,2,2
pop magoot,17.8270005524,6.29388615473,0,2,2
spek,17.8270005524,6.29388615473,0,2,2
witchcraft,17.8270005524,6.29388615473,0,2,2
druid,17.8270005524,6.29388615473,0,2,2
sheikmaster,17.8270005524,6.29388615473,0,2,2
toes,17.8270005524,6.29388615473,0,2,2
cobalt,17.8270005524,6.29388615473,0,2,2
lvl6zubat,17.8270005524,6.29388615473,0,2,2
ruskeezy,17.8270005524,6.29388615473,0,2,2
eorp,17.8270005524,6.29388615473,0,2,2
fraude françois,17.8270005524,6.29388615473,0,2,2
hp,17.8270005524,6.29388615473,0,2,2
locoelephante,17.8270005524,6.29388615473,0,2,2
weakener,17.8270005524,6.29388615473,0,2,2
samurice,17.8270005524,6.29388615473,0,2,2
vega,17.8270005524,6.29388615473,0,2,2
khakiducks,17.8270005524,6.29388615473,0,2,2
superflopp,17.8270005524,6.29388615473,0,2,2
noopers,17.8270005524,6.29388615473,0,2,2
2broke,17.8270005524,6.29388615473,0,2,2
neku,17.8270005524,6.29388615473,0,2,2
jazzy,17.8270005524,6.29388615473,0,2,2
red-white,17.8270005524,6.29388615473,0,2,2
porkloins,17.8270005524,6.29388615473,0,2,2
sasquatch,17.8270005524,6.29388615473,0,2,2
[the fox army],17.8270005524,6.29388615473,0,2,2
amplas,17.8270005524,6.29388615473,0,2,2
xcal,17.8270005524,6.29388615473,0,2,2
hurricane rising,17.8270005524,6.29388615473,0,2,2
dyldoge,17.8270005524,6.29388615473,0,2,2
dj  jose,17.8270005524,6.29388615473,0,2,2
the,17.8270005524,6.29388615473,0,2,2
anabanana,17.8270005524,6.29388615473,0,2,2
kochisnsd,17.8270005524,6.29388615473,0,2,2
gamarad,17.8260236677,6.39755968115,0,2,2
dreamfunk,17.8221150907,6.05970526571,0,2,2
daouzin,17.8204968948,6.06376900546,0,2,2
yamz,17.8177793268,4.70278208749,1,4,5
curiousplaces,17.817055081,6.15530893774,0,2,2
randellion,17.8103286048,6.05965318578,0,2,2
pink flamingo,17.8036499642,4.80639887223,1,4,5
venitas,17.8036499642,4.80639887223,1,4,5
malachite,17.7996319799,6.04241336714,0,2,2
giggitoxin,17.7995920436,6.05931614243,0,2,2
giraffe,17.7976568551,4.34968434389,1,6,7
czar,17.795646168,4.77150750592,1,4,5
gobos,17.7916977315,6.2624538143,0,2,2
makeamericagreatagain,17.7898496761,6.38829210126,0,2,2
mando,17.7847248835,6.27673946818,0,2,2
lube,17.7847010055,6.23659779107,0,2,2
pupudoodoo,17.7840550583,6.27197708,0,2,2
isbjørn,17.781762389,3.36459335048,3,9,12
dextrous devil,17.7809239444,5.91300591917,0,2,2
ricstr,17.7756843969,6.01598610834,0,2,2
yamsofsteel,17.7694845542,6.03559659391,0,3,3
alexander,17.7694767203,4.50954952354,1,5,6
cupcake,17.7641818624,6.24188737795,0,2,2
rambo nanny,17.7629167866,6.2757292914,0,2,2
exlatios,17.761833029,4.90868067621,1,2,3
trod,17.7563181542,4.77572784515,1,5,6
doppler12,17.7540659056,6.2479481061,0,2,2
spigot,17.7530263588,6.15411601902,0,2,2
term,17.7528540281,6.37840119552,0,2,2
arga,17.751501001,6.25502901984,0,2,2
antonio,17.7506574101,6.25115441119,0,2,2
elquapod,17.7503431297,6.28481550216,0,2,2
telemonic,17.7425500391,5.93258321879,0,2,2
c^2,17.7391572792,6.35064910342,0,1,1
chaotropic,17.7367696171,6.08456075178,0,2,2
brooke,17.7314791551,6.28328425926,0,2,2
sozo,17.7271920264,6.24050236417,0,2,2
smiles4miles,17.7245792596,6.26191557976,0,2,2
mdc,17.7220368619,5.85070365455,0,2,2
lfnt,17.7204336634,5.88599733509,0,2,2
dangerous dude,17.7201662539,4.23402172939,1,6,7
ricky jo,17.7154020792,6.22414134459,0,2,2
dallin,17.7140304443,6.16230441253,0,2,2
mark,17.7135856988,6.06445466971,0,2,2
ac!d,17.7135163758,6.06048814864,0,2,2
papa izzy,17.7121642847,5.83886377333,0,2,2
tarn,17.7116892315,3.78223476617,2,8,10
ozp,17.7109310593,6.21918182532,0,2,2
truck,17.7099714064,4.34111319979,1,5,6
maaron,17.70703752,6.12652688944,0,2,2
ark,17.7061154527,3.60563425605,2,7,9
agyle,17.7053492145,6.10037765647,0,2,2
scuba steve,17.7019121221,6.63955732121,0,1,1
patsj,17.701484792,4.11765575849,1,6,7
ruse,17.7006455059,4.65570233438,1,5,6
j9d2,17.699393923,6.1721237644,0,2,2
ben2,17.6982007491,6.36535899879,0,2,2
tbone,17.6949108442,6.11783448067,0,2,2
shreddern64,17.6925987228,6.3561012149,0,2,2
musicmasterjtw,17.6925767755,6.27964406675,0,2,2
heartsdealer,17.6900023137,6.2291814448,0,2,2
maxo the midge,17.6886801528,6.27857784045,0,2,2
kernimal,17.6868249983,6.09539574872,0,2,2
lmn,17.6866990245,5.94096717775,0,2,2
herr råbob,17.6853493532,4.7346527412,1,5,6
nawtfox,17.6810515713,6.22581139811,0,2,2
ddhs,17.6802624992,4.7299168305,1,5,6
yamin4,17.6789790191,6.53641129428,0,2,2
bikefrog,17.6785508089,3.67322747419,1,6,7
mrblazinasian,17.6782414782,6.08272353622,0,2,2
cmac1211,17.6737596362,4.70258999241,1,4,5
fig newton,17.673277955,6.35983874293,0,2,2
capitali$m,17.6727863501,6.04459201494,0,2,2
manifesto,17.6706255989,5.84062964508,0,2,2
yung,17.6700071769,3.79721072013,2,6,8
train,17.6696946786,6.23727248891,0,2,2
kimosabae,17.6687468802,6.0240651947,0,2,2
nico,17.6673384456,6.26628461383,0,2,2
clintbeastwood,17.6673384456,6.26628461383,0,2,2
sexynachos,17.6673384456,6.26628461383,0,2,2
bash,17.6632911537,4.35556856998,1,4,5
shnarples,17.656067242,4.61763488625,1,4,5
narwhal,17.6553411355,5.79765132653,0,2,2
terra,17.6551212487,4.42118329786,1,5,6
marker,17.653347373,6.22922186751,0,2,2
cr4nb3rry,17.6514561644,4.54031218212,1,7,8
striferz,17.6496255667,4.58147452037,1,4,5
cheez dragon,17.6479738518,6.20138733335,0,2,2
brwn,17.6477919394,6.35277522994,0,2,2
jampion,17.6459860892,6.00158542457,0,2,2
joey bag o' donuts,17.6457286492,6.22791473016,0,2,2
graydo,17.6444331911,6.35080509011,0,2,2
lukewarm,17.6383704548,6.21616859268,0,2,2
insomniatic,17.6382649198,6.35152361709,0,2,2
elric,17.6380882326,6.22847142719,0,2,2
prest0,17.6372220621,5.8543847298,0,2,2
hop,17.6357391997,3.99674555086,2,6,8
brat,17.6309922575,4.0728996723,1,6,7
nero,17.630835528,6.07024020227,0,2,2
vash,17.6300814641,5.8104483988,0,2,2
kitkat,17.6269420392,5.95072421393,0,2,2
surskim,17.6258245472,5.95852031341,0,2,2
fantasia addict,17.6200474539,6.00250432443,0,2,2
psy,17.6189689175,6.25729995097,0,2,2
loncas,17.6129914472,6.22358320548,0,2,2
fusion,17.6115815125,6.34499184095,0,2,2
dillweed,17.6097190502,6.02402664665,0,2,2
stryj,17.6088232344,6.2344399148,0,2,2
dolphintv,17.6088232344,6.2344399148,0,2,2
shoe,17.6088232344,6.2344399148,0,2,2
ferrero64,17.6088232344,6.2344399148,0,2,2
freakydashiki,17.6088232344,6.2344399148,0,2,2
resolute,17.6088232344,6.2344399148,0,2,2
goucheenachos,17.6088232344,6.2344399148,0,2,2
sirshmoopi,17.6088232344,6.2344399148,0,2,2
vsc al_bouggie,17.6088232344,6.2344399148,0,2,2
byod,17.6088232344,6.2344399148,0,2,2
kdxkdot,17.6088232344,6.2344399148,0,2,2
revelation,17.6088232344,6.2344399148,0,2,2
water,17.6061860164,6.09298369957,0,2,2
2ddj,17.6059713771,4.73794133638,1,4,5
johnny,17.6030528609,5.95912724631,0,2,2
adrenaline,17.6012683109,6.08681306483,0,2,2
pruben,17.5996548836,6.34126820436,0,2,2
kivo,17.5966484518,4.64714664828,1,4,5
e a s t,17.5935554864,6.13967060751,0,2,2
iamse7en,17.5928163458,6.14354741286,0,2,2
brentos,17.5925259787,5.92806748461,0,2,2
sebqt,17.5915671392,6.23487874242,0,2,2
l1me,17.5910752091,4.40318393698,1,5,6
recneps,17.5898172262,4.69151575094,1,5,6
north dr,17.5897375364,6.33941371998,0,2,2
kingsirwankalot,17.5888033034,6.21932727835,0,2,2
goose,17.5884610057,6.66663023849,0,1,1
gunn,17.5879406502,4.7345267505,1,4,5
gooms,17.5849845436,6.05037401472,0,2,2
shoshin,17.5840237194,5.98649537441,0,2,2
scratchin magician,17.5827593179,6.26040424297,0,2,2
4him,17.5729858765,6.33380190171,0,2,2
scrub lyfe,17.5724688098,5.95206051332,0,2,2
jackmaster,17.5720269577,6.14991083859,0,2,2
penguin,17.5720253212,5.78372579953,0,2,2
dankdaddy,17.570708968,5.88218980439,0,2,2
jimbabwe,17.5681867528,6.21070907186,0,2,2
i2g,17.5673061191,6.33503773548,0,2,2
riquiz,17.5661423365,6.25187934786,0,2,2
chrispy,17.564057775,6.05047339471,0,2,2
zachackach,17.5635888604,6.33420166196,0,2,2
comet,17.5630707026,5.80188546063,0,2,2
snak37,17.5597940391,6.3328242414,0,2,2
danny,17.5583379298,6.01455746908,0,2,2
grassmanmatt,17.5561083061,6.33264575409,0,2,2
roman,17.5534056065,6.09778036001,0,2,2
lumin,17.5481692785,5.61554728793,0,2,2
@xx_po0p_master_520_xx,17.5450901067,6.24980316806,0,2,2
fgglpggl,17.5447309099,6.05993542474,0,2,2
juicy,17.5393458525,6.19517179937,0,2,2
swail,17.5389224365,5.91443872398,0,2,2
majesticwood,17.5369092241,6.14982621206,0,2,2
under,17.5352402777,6.20856698699,0,2,2
wingding,17.534675871,6.02268495463,0,2,2
dyo,17.5338798025,6.21602667266,0,2,2
mastercat,17.5336645833,4.31717482265,1,5,6
drastnikov,17.5326985121,4.48589874606,1,5,6
spitx,17.5325942546,6.25417666688,0,2,2
ninja nova,17.5299601181,6.32580252739,0,2,2
colonel claw,17.528006463,5.77623445247,0,2,2
down with gravity,17.526259556,6.20353717089,0,2,2
scrubbymac,17.5261776467,6.32463254619,0,2,2
looseblue,17.5217467191,6.21422172819,0,2,2
classywolfman,17.5203287377,5.9380708607,0,2,2
purplecube,17.519275459,5.06296101727,1,2,3
jame,17.518178814,4.79059421604,1,4,5
kitab,17.5162953837,5.92530446321,0,2,2
thrownorc,17.5131579343,6.24616240367,0,2,2
ping warrior,17.5131191448,4.55191020512,1,3,4
whack,17.512762729,6.17517049965,0,2,2
reah,17.5113328325,6.32038649044,0,2,2
myxoma,17.5084779747,6.08972181919,0,2,2
rainpot,17.508190383,6.02881696921,0,2,2
hurtbox,17.5069129387,6.25201610747,0,2,2
breedlove1974,17.4980768572,6.23757353801,0,2,2
pikabob,17.4918138772,4.63460016933,1,4,5
wifi,17.4912966641,6.31529093424,0,2,2
fawger,17.4855810216,4.48318326389,1,5,6
nerds,17.4844064829,5.86862051642,0,2,2
seek,17.4832056192,6.10790675657,0,2,2
knipples,17.4791654116,4.61333012049,1,5,6
monkbard,17.4768971422,6.18991306966,0,2,2
magicalarmanjan,17.4738222752,4.54253741332,1,4,5
chenboy3,17.4655586735,5.96496313184,0,2,2
vaxellon,17.4633947023,4.59636972111,1,4,5
pure_bazurek,17.4612496514,6.31289425367,0,2,2
sbr,17.4602474187,5.01138401565,1,2,3
yukadon64,17.4599399325,3.90992715393,2,4,6
mr_dr_higgins,17.4551705772,6.31878768558,0,2,2
ditto,17.4528482673,4.72213290729,1,4,5
wavy,17.4519618295,6.0078424095,0,2,2
catam,17.4511042288,5.81420767724,0,2,2
teriyaki weeaboo,17.4491444346,5.9097252271,0,2,2
haise,17.4477681211,6.30940180208,0,2,2
dr. robotnik,17.4445562579,6.21061678838,0,2,2
gree,17.4418022043,5.98795778152,0,2,2
wolfjudgement,17.4413835151,6.1967767281,0,2,2
mariosmasher,17.4243349034,4.58388336973,1,4,5
minubrute,17.424291411,4.41199982133,1,5,6
bqx,17.4223742489,6.30292666562,0,2,2
daws,17.4207333269,6.30331139896,0,2,2
perfect light,17.420468175,4.82644150105,1,4,5
darner,17.4178526269,6.1068745912,0,2,2
sd master,17.4153975995,5.810566524,0,2,2
bangkok dangerous,17.4139720181,6.19210499572,0,2,2
hamstarr96,17.4128785826,6.30136724772,0,2,2
bakinshake,17.411380053,4.39404670705,1,4,5
hamer,17.4107337699,5.92161068053,0,2,2
trogdog,17.4061734656,6.00086991332,0,2,2
zephyr,17.4050841896,5.80835836364,0,2,2
labrador,17.4026249798,6.00650048139,0,2,2
zash,17.4020361741,6.19245914614,0,2,2
dable,17.4012539335,6.19224054601,0,2,2
c_mill24,17.4009569609,5.90645276679,0,2,2
cap,17.3987557706,3.7234182121,2,7,9
hufff,17.3943778966,6.0335851202,0,2,2
giga,17.3943515971,6.30888769888,0,2,2
thiefbug,17.3926578442,3.84598108718,2,5,7
xg,17.3915018666,6.20536674968,0,2,2
amaya,17.3893507806,6.18975720311,0,2,2
dylswitch,17.3875005785,5.99104961073,0,2,2
rf!,17.3859332073,6.29371496659,0,2,2
pajama jon,17.3845877123,6.20743051885,0,2,2
alui,17.3834882322,6.17803798251,0,2,2
narbs,17.3812223173,5.87711167659,0,4,4
vitreous,17.3787224382,5.68361876422,0,2,2
jon dog,17.3779262043,6.18978120184,0,2,2
allpain,17.3715655638,4.24390215492,1,6,7
joehowardjr,17.3649377004,5.901006325,0,2,2
zytral,17.3635188593,5.85219964196,0,2,2
acorn,17.360062824,6.29015149967,0,2,2
redeagle2000,17.357026717,5.78861817087,0,2,2
waltis,17.3562537372,5.74466770638,0,2,2
20ll,17.3534751018,6.08904620812,0,2,2
crymsen,17.3510690218,6.08550261345,0,2,2
engine,17.3509515609,5.96645358219,0,2,2
greenbean,17.3473157631,4.56203870045,1,5,6
corregret,17.3433075089,5.6401665283,0,2,2
docninj,17.3407318086,6.2838163424,0,2,2
undercoverraptor,17.3370891435,6.28221372558,0,2,2
nards,17.3328181076,5.91002135105,0,2,2
massive,17.3314988241,6.16500916018,0,2,2
levonheart,17.3302476468,6.28320409349,0,2,2
kazehana3,17.3297464451,4.62600438854,1,5,6
vexoskeleton,17.3257988278,6.18577377031,0,2,2
zarsz,17.3229995867,6.18282457443,0,2,2
takashi,17.3214169552,6.03381319918,0,2,2
n0ble,17.3196015071,6.093758989,0,2,2
lejaarmy,17.3184464796,6.28233276484,0,2,2
njwc,17.3182598381,6.2814501353,0,2,2
fap,17.3142002737,6.28058829244,0,2,2
stackdolla$,17.3112508209,5.83812882531,0,4,4
awe,17.309402659,6.17339028693,0,2,2
iceey,17.306956588,6.20427311217,0,2,2
johnnytsunamie,17.3004280492,6.1781854482,0,2,2
kingvi,17.3000788329,6.10748342898,0,2,2
loveswater,17.2949125284,4.70894670849,1,4,5
ale,17.2941126542,6.27338246932,0,2,2
loz,17.2926724865,4.46086209269,1,5,6
butter,17.2910595017,5.75953076878,0,2,2
jelly biscuits,17.2900894883,6.27790711227,0,2,2
starkiller,17.2873726847,5.86744618916,0,2,2
deathrtopper,17.2861432702,6.19816781697,0,2,2
volutedmarlin,17.2856821873,6.03476527174,0,2,2
kholdblooded,17.283723404,6.10269409556,0,2,2
sped,17.2822518922,4.40824682093,1,4,5
koj,17.2812251972,6.17473341795,0,2,2
orca,17.2809172243,6.08539339742,0,2,2
nichu,17.2805334023,4.21431007311,1,6,7
nanz,17.2793361642,4.28701931321,1,4,5
isyan,17.2751863543,4.77966375638,1,5,6
yoon,17.2720133899,6.2708772819,0,2,2
morpheus,17.2694634632,6.13130390996,0,2,2
jayrodd,17.2692382657,4.59070080974,1,4,5
wrenchingpiff,17.266676633,6.16355776036,0,2,2
seed,17.2641670728,5.73279672991,0,2,2
mrg,17.2601899794,6.06734280741,0,2,2
taylortotftw,17.2579654649,5.79685839424,0,2,2
mrbnjmn,17.2558366837,5.96895948536,0,2,2
hyper,17.2541730196,5.79340391011,0,2,2
dkoyc,17.2540168162,6.24659951159,0,2,2
plant,17.2534709597,6.27013643943,0,2,2
angabur,17.2522211299,5.96155530031,0,2,2
tequila,17.2509702629,3.85489287129,2,8,10
walleye,17.2479644965,6.5433620339,0,1,1
srgtelmo,17.2469275133,5.95689943242,0,2,2
djcrinklecut,17.2459748447,6.16934307671,0,2,2
shmoomin_,17.2452149198,6.03538956963,0,2,2
teknoor,17.2412240464,5.34729884228,0,4,4
ahcarbon,17.2343219271,5.95427114524,0,2,2
young craig,17.2342275523,6.25902251207,0,2,2
diabetodan,17.234135775,6.27951679061,0,2,2
d2,17.2310965742,6.26594299996,0,2,2
madman3,17.2287839783,4.06460505848,1,5,6
raid,17.2277347141,6.08213165054,0,2,2
neverpullout,17.2273356228,5.83172031751,0,2,2
alcides .i.,17.2240052497,6.0583748276,0,3,3
nope,17.2198251889,5.94486443399,0,2,2
quarry,17.2150717748,3.35170543114,2,10,12
brendy,17.2091721516,6.26226019014,0,2,2
peace,17.2088181359,6.38412066791,0,2,2
comment,17.2076701809,5.87641472724,0,2,2
gmny,17.1983960988,6.01442562735,0,2,2
coffeezombi,17.1914631574,6.03936742828,0,2,2
zeno,17.1896614721,6.06139215767,0,2,2
puttep,17.182034853,4.79602091218,1,5,6
chelo,17.182034853,4.79602091218,1,5,6
ragtime mouse,17.1795944047,6.03854575899,0,2,2
slammy,17.1794265831,5.96607770983,0,2,2
mrtom,17.1767758952,4.3914604098,1,5,6
nakeee,17.1730388204,6.05758489256,0,2,2
paranoidzoid,17.1722370282,5.97190668739,0,2,2
d ray today,17.1715702449,6.25574738576,0,2,2
kj,17.1707476989,6.26909855217,0,2,2
robo,17.1637537158,5.83188627751,0,2,2
ouicava,17.1629130309,5.98735063021,0,2,2
impy,17.1577263943,5.92072264539,0,2,2
demodairy,17.1573329149,6.26923433457,0,2,2
smlzgood,17.1573329149,6.26923433457,0,2,2
saydon,17.1573329149,6.26923433457,0,2,2
lazerkitten,17.1573329149,6.26923433457,0,2,2
eggsalad,17.1573329149,6.26923433457,0,2,2
cmurda,17.1573329149,6.26923433457,0,2,2
chromidorr,17.1573329149,6.26923433457,0,2,2
frames,17.1573329149,6.26923433457,0,2,2
college of luigi,17.1573329149,6.26923433457,0,2,2
pen,17.1573329149,6.26923433457,0,2,2
absolute chaos,17.1573329149,6.26923433457,0,2,2
waytoopro,17.1573329149,6.26923433457,0,2,2
shortstack,17.1573329149,6.26923433457,0,2,2
griz,17.1573329149,6.26923433457,0,2,2
pk_cheeze,17.1573329149,6.26923433457,0,2,2
espar,17.1573329149,6.26923433457,0,2,2
aaa,17.1573329149,6.26923433457,0,2,2
bman8tor,17.1573329149,6.26923433457,0,2,2
urboygraham,17.1573329149,6.26923433457,0,2,2
entropy,17.1573329149,6.26923433457,0,2,2
coro,17.1573329149,6.26923433457,0,2,2
nick allen,17.1573329149,6.26923433457,0,2,2
jamis,17.1573329149,6.26923433457,0,2,2
coinm,17.1573329149,6.26923433457,0,2,2
crisp,17.1573329149,6.26923433457,0,2,2
zelus,17.1573329149,6.26923433457,0,2,2
sad jesus,17.1573329149,6.26923433457,0,2,2
cap10kirk,17.1573329149,6.26923433457,0,2,2
tblades,17.1573329149,6.26923433457,0,2,2
dqking,17.1573329149,6.26923433457,0,2,2
rudy,17.1515898513,5.79302420322,0,2,2
quil,17.151136542,5.69087615072,0,2,2
kappa,17.1496408802,5.98289365848,0,2,2
polisen,17.1493544514,4.02098420653,1,5,6
fishwithnipples,17.1446040249,5.93660179695,0,2,2
ceo,17.1445171291,5.78783923622,0,2,2
bell pepper,17.1411510231,6.24852969702,0,2,2
shyseven,17.1399699181,5.81103816453,0,2,2
tomcat,17.1380125129,6.01238313061,0,2,2
fresh milk,17.1376008421,6.24244001796,0,2,2
nfoh,17.1355892909,5.85542717039,0,2,2
takeshi,17.1354053873,5.99264619368,0,2,2
commander ice,17.1353049609,4.07222546089,1,5,6
odesza,17.1302216899,6.24616555777,0,2,2
astra,17.1292986674,5.91098292877,0,2,2
candyman,17.1280156325,6.2402391421,0,2,2
boozki,17.1222473168,5.92951155048,0,2,2
helen,17.1166037853,6.13378073498,0,2,2
daymare,17.1165943331,5.926128704,0,2,2
1e,17.1152834944,6.13914146471,0,2,2
salt queen,17.1133086545,5.78821729024,0,2,2
yumyum,17.1127366833,6.24622958995,0,2,2
slopers-gonna-slope,17.104536385,5.98136580728,0,2,2
marx,17.101842255,4.6036835787,1,5,6
archaic,17.0982840014,6.24191257521,0,2,2
pintoa,17.0976473556,4.49573831664,1,5,6
b4y6,17.0964833439,6.24033812843,0,2,2
stevie b,17.0950101091,6.1360195602,0,2,2
venom turtle,17.094109751,4.48508571493,1,6,7
vonquack,17.0919819826,4.15333145041,1,6,7
blushehn,17.0908867308,6.13584107344,0,2,2
wumbo111,17.0903368453,6.23798399798,0,2,2
smooth jon,17.0887730279,6.23875514052,0,2,2
migz,17.0885230726,6.01443598807,0,2,2
sixten,17.0870389539,6.00416294889,0,3,3
sanjaypanini,17.0865796366,6.23863714796,0,2,2
buttermilk,17.0831258176,6.23915365362,0,2,2
dr. lip,17.0823111278,4.53909756615,1,4,5
sengoh,17.0803268762,4.35955745477,1,5,6
asoma,17.0787744509,5.95295413769,0,2,2
brum,17.0733919349,5.9713033446,0,2,2
tempest tim,17.0680738796,6.23479902484,0,2,2
krbay,17.0675473944,6.23639663785,0,2,2
apop99,17.0660837854,6.00495686503,0,2,2
sharkjaw777,17.0647258825,6.22529414405,0,2,2
riff [fournier],17.0559951788,6.25260505468,0,2,2
sharkkangaroo,17.0543457788,5.91403679843,0,2,2
dylan,17.0533851224,6.02696818808,0,2,2
tylerx5,17.049734968,6.23039862313,0,2,2
duckypotato,17.0490234201,6.02038868503,0,2,2
dkarnage,17.048924835,6.01649672786,0,2,2
domsta,17.0472116228,6.13368099681,0,2,2
leonidas,17.044143382,5.58835637322,0,3,3
dhs | gamestationpro,17.0441135153,6.250917857,0,2,2
pasta,17.0439472998,6.22527172915,0,2,2
everfresh,17.0423876164,4.37794820696,1,5,6
aztec2step,17.0402038165,2.60290584707,4,17,21
wenghis khan,17.0391859589,6.03825819004,0,2,2
dudeofhazardz,17.0328372912,5.97194671166,0,2,2
destiknee,17.0324529105,5.97668335232,0,2,2
igor,17.0321999802,6.04789273234,0,2,2
little bucket,17.0288156152,3.44161234703,2,6,8
pews,17.0283007134,4.21557472295,1,6,7
hashbrown,17.0281635273,6.04565184749,0,2,2
prince,17.0183059561,6.23133757959,0,2,2
stewbird,17.0179092593,5.82213912545,0,2,2
quigs,17.0162556472,6.22083656059,0,2,2
hatdog,17.0081519669,6.22679010822,0,2,2
g-sus,16.9984318203,6.22279083208,0,2,2
henrikvenn,16.989168213,4.67386198698,1,5,6
behemoth,16.9750323685,5.87701005648,0,3,3
chamoo,16.9748686221,5.862848912,0,2,2
slap,16.9680514168,6.09234182114,0,2,2
spit5000,16.9633107384,6.21709782607,0,2,2
kepa,16.9614221109,6.2182263125,0,2,2
4 phri,16.9553572857,5.94179202788,0,2,2
führer,16.9552947743,6.08986516556,0,2,2
shabba,16.9540199779,6.20660483838,0,2,2
afromania,16.9536808882,6.21555283909,0,2,2
thegnarlet,16.9532075301,5.9714284443,0,2,2
smk,16.952399825,5.9051707642,0,2,2
familiar,16.9488426691,5.95847048061,0,2,2
stitchell,16.9477060448,6.03203536543,0,2,2
fuseless,16.947138651,5.84713499875,0,3,3
zippow,16.9402563051,4.38500882492,1,5,6
mariofood,16.9402019737,5.97671937314,0,2,2
applejaxs,16.9366017385,6.51456366798,0,1,1
sentenga0421,16.9283749237,5.82626253062,0,2,2
drewpy,16.9273178368,6.23983584333,0,2,2
thagoldenchild,16.9273178368,6.23983584333,0,2,2
queue kyoo,16.9273178368,6.23983584333,0,2,2
ronan,16.9273178368,6.23983584333,0,2,2
summer was fun,16.9273178368,6.23983584333,0,2,2
pen15,16.9273178368,6.23983584333,0,2,2
ukulele,16.9273178368,6.23983584333,0,2,2
supra,16.9273178368,6.23983584333,0,2,2
jerm,16.9273178368,6.23983584333,0,2,2
cheeftain,16.9273178368,6.23983584333,0,2,2
paqsprime,16.9273178368,6.23983584333,0,2,2
stoveboy,16.9273178368,6.23983584333,0,2,2
yosuke,16.9273178368,6.23983584333,0,2,2
faze2,16.9273178368,6.23983584333,0,2,2
crilles,16.9273178368,6.23983584333,0,2,2
edlose,16.9273178368,6.23983584333,0,2,2
powerlemons,16.9273178368,6.23983584333,0,2,2
sord,16.9273178368,6.23983584333,0,2,2
twosick,16.9273178368,6.23983584333,0,2,2
shenpai,16.9273178368,6.23983584333,0,2,2
fro?,16.9273178368,6.23983584333,0,2,2
caravan,16.9273178368,6.23983584333,0,2,2
tony hawk,16.9273178368,6.23983584333,0,2,2
inversion,16.9273178368,6.23983584333,0,2,2
tal,16.9273178368,6.23983584333,0,2,2
theobsoletecomputer,16.9273178368,6.23983584333,0,2,2
kitten,16.9273178368,6.23983584333,0,2,2
dankmemer420,16.9273178368,6.23983584333,0,2,2
demna,16.9273178368,6.23983584333,0,2,2
file,16.9273178368,6.23983584333,0,2,2
technocrow,16.9273178368,6.23983584333,0,2,2
ciao,16.9273178368,6.23983584333,0,2,2
nessnger,16.9273178368,6.23983584333,0,2,2
randocalrissian,16.9273178368,6.23983584333,0,2,2
moonshine,16.9273178368,6.23983584333,0,2,2
aspens,16.9273178368,6.23983584333,0,2,2
fluzzarn,16.9273178368,6.23983584333,0,2,2
prismoid,16.9273178368,6.23983584333,0,2,2
quasarwolf,16.9273178368,6.23983584333,0,2,2
mello,16.9273178368,6.23983584333,0,2,2
trashboat,16.9273178368,6.23983584333,0,2,2
juul,16.9273178368,6.23983584333,0,2,2
help,16.9273178368,6.23983584333,0,2,2
arkana,16.9273178368,6.23983584333,0,2,2
quesalupa,16.9273178368,6.23983584333,0,2,2
dave,16.9273178368,6.23983584333,0,2,2
/b/l/a/d/e/,16.9273178368,6.23983584333,0,2,2
bstubs,16.9273178368,6.23983584333,0,2,2
nplusone,16.9273178368,6.23983584333,0,2,2
dethslayr,16.9273178368,6.23983584333,0,2,2
charles,16.9273178368,6.23983584333,0,2,2
faceoats,16.9273178368,6.23983584333,0,2,2
qk shkz,16.9273178368,6.23983584333,0,2,2
lobo,16.9273178368,6.23983584333,0,2,2
gooby,16.9273178368,6.23983584333,0,2,2
kramff,16.9273178368,6.23983584333,0,2,2
itsmadness,16.9273178368,6.23983584333,0,2,2
osiris197,16.9273178368,6.23983584333,0,2,2
blackthunder,16.9273178368,6.23983584333,0,2,2
na5h,16.9273178368,6.23983584333,0,2,2
thedarkdreamer,16.9273178368,6.23983584333,0,2,2
squab,16.9273178368,6.23983584333,0,2,2
lil mayo,16.9273178368,6.23983584333,0,2,2
techknowledgey,16.9273178368,6.23983584333,0,2,2
silversage64,16.9273178368,6.23983584333,0,2,2
bunne,16.9273178368,6.23983584333,0,2,2
jmac,16.9273178368,6.23983584333,0,2,2
deathden,16.9273178368,6.23983584333,0,2,2
silentknight,16.9273178368,6.23983584333,0,2,2
lodestar,16.9273178368,6.23983584333,0,2,2
jonny,16.9273178368,6.23983584333,0,2,2
scyfle,16.9273178368,6.23983584333,0,2,2
big daddy josh,16.9273178368,6.23983584333,0,2,2
sircabby,16.9273178368,6.23983584333,0,2,2
special events,16.9273178368,6.23983584333,0,2,2
delfino,16.9273178368,6.23983584333,0,2,2
lazyninja1017,16.9273178368,6.23983584333,0,2,2
oddyesy,16.9273178368,6.23983584333,0,2,2
it's_ogre~,16.9273178368,6.23983584333,0,2,2
buck,16.9273178368,6.23983584333,0,2,2
shlizark,16.9273178368,6.23983584333,0,2,2
lobster,16.9273178368,6.23983584333,0,2,2
oogaboogacaveman,16.9273178368,6.23983584333,0,2,2
dawangthang,16.9273178368,6.23983584333,0,2,2
7thjavi,16.9273178368,6.23983584333,0,2,2
nerf r nuthin,16.9273178368,6.23983584333,0,2,2
thedoctorisin,16.9273178368,6.23983584333,0,2,2
scabhammer,16.9273178368,6.23983584333,0,2,2
mornag,16.9273178368,6.23983584333,0,2,2
534,16.9273178368,6.23983584333,0,2,2
grima,16.9273178368,6.23983584333,0,2,2
mizuki,16.9273178368,6.23983584333,0,2,2
thursday boots,16.9273178368,6.23983584333,0,2,2
chiefreaper,16.9273178368,6.23983584333,0,2,2
nolo,16.9273178368,6.23983584333,0,2,2
zarfon,16.9273178368,6.23983584333,0,2,2
solace,16.9273178368,6.23983584333,0,2,2
tobi,16.9273178368,6.23983584333,0,2,2
duhwinning,16.9273178368,6.23983584333,0,2,2
hallow,16.9273178368,6.23983584333,0,2,2
j.killa,16.9273178368,6.23983584333,0,2,2
embracethe12,16.9273178368,6.23983584333,0,2,2
iko,16.9273178368,6.23983584333,0,2,2
junirc,16.9273178368,6.23983584333,0,2,2
humble,16.9273178368,6.23983584333,0,2,2
superbob,16.9273178368,6.23983584333,0,2,2
chubell,16.9273178368,6.23983584333,0,2,2
kiri,16.9273178368,6.23983584333,0,2,2
q-star,16.9273178368,6.23983584333,0,2,2
artlessavian,16.9273178368,6.23983584333,0,2,2
hybrid,16.9273178368,6.23983584333,0,2,2
altf4,16.9273178368,6.23983584333,0,2,2
wonder ginger,16.9273178368,6.23983584333,0,2,2
bulgogi,16.9273178368,6.23983584333,0,2,2
thugric,16.9273178368,6.23983584333,0,2,2
zwephy,16.9273178368,6.23983584333,0,2,2
ibkenny22,16.9273178368,6.23983584333,0,2,2
shanook,16.9273178368,6.23983584333,0,2,2
jerooney,16.9273178368,6.23983584333,0,2,2
daniel,16.9273178368,6.23983584333,0,2,2
sycko,16.9273178368,6.23983584333,0,2,2
@sdashkon,16.9273178368,6.23983584333,0,2,2
negrodamus,16.9273178368,6.23983584333,0,2,2
yuse,16.9273178368,6.23983584333,0,2,2
crocs,16.9273178368,6.23983584333,0,2,2
charlemagne,16.9273178368,6.23983584333,0,2,2
etroknight,16.9273178368,6.23983584333,0,2,2
8njay,16.9273178368,6.23983584333,0,2,2
0ust,16.9273178368,6.23983584333,0,2,2
corimon,16.9273178368,6.23983584333,0,2,2
butt,16.9273178368,6.23983584333,0,2,2
bronze,16.9273178368,6.23983584333,0,2,2
tristan taylor,16.9273178368,6.23983584333,0,2,2
sinist3r,16.9273178368,6.23983584333,0,2,2
syophan,16.9273178368,6.23983584333,0,2,2
dr. hasbeen,16.9273178368,6.23983584333,0,2,2
glistening,16.9273178368,6.23983584333,0,2,2
express,16.9273178368,6.23983584333,0,2,2
qaz,16.9273178368,6.23983584333,0,2,2
eastnutz,16.9273178368,6.23983584333,0,2,2
skyguy,16.9273178368,6.23983584333,0,2,2
adraks,16.9273178368,6.23983584333,0,2,2
tsar,16.9273178368,6.23983584333,0,2,2
ninestar,16.9273178368,6.23983584333,0,2,2
swiggu,16.9273178368,6.23983584333,0,2,2
muzdo,16.9273178368,6.23983584333,0,2,2
whatislove,16.9273178368,6.23983584333,0,2,2
frool,16.9273178368,6.23983584333,0,2,2
zenyou,16.9273178368,6.23983584333,0,2,2
mxgv!,16.9273178368,6.23983584333,0,2,2
talos,16.9273178368,6.23983584333,0,2,2
nikushimi,16.9273178368,6.23983584333,0,2,2
aileron,16.9273178368,6.23983584333,0,2,2
jgramm,16.9273178368,6.23983584333,0,2,2
demm,16.9273178368,6.23983584333,0,2,2
bobo big dog,16.9273178368,6.23983584333,0,2,2
moe moe kyun,16.9273178368,6.23983584333,0,2,2
wilachas,16.9273178368,6.23983584333,0,2,2
bartok,16.9273178368,6.23983584333,0,2,2
scf3,16.9273178368,6.23983584333,0,2,2
pigwick,16.9273178368,6.23983584333,0,2,2
dogcopter,16.9273178368,6.23983584333,0,2,2
kafkah,16.9273178368,6.23983584333,0,2,2
wetzel,16.9273178368,6.23983584333,0,2,2
lenori,16.9273178368,6.23983584333,0,2,2
nicholas fletcher,16.9273178368,6.23983584333,0,2,2
upyoda,16.9273178368,6.23983584333,0,2,2
vari,16.9273178368,6.23983584333,0,2,2
bait,16.9273178368,6.23983584333,0,2,2
r.i.p.,16.9273178368,6.23983584333,0,2,2
pinocchio,16.9273178368,6.23983584333,0,2,2
deestroy,16.9273178368,6.23983584333,0,2,2
longdog,16.9273178368,6.23983584333,0,2,2
cherished doll,16.9273178368,6.23983584333,0,2,2
orangepledge,16.9273178368,6.23983584333,0,2,2
saltkingmcgee,16.9273178368,6.23983584333,0,2,2
kuebiko,16.9273178368,6.23983584333,0,2,2
somethingazn,16.9273178368,6.23983584333,0,2,2
cryptos,16.9273178368,6.23983584333,0,2,2
metalloid,16.9273178368,6.23983584333,0,2,2
sunken,16.9273178368,6.23983584333,0,2,2
duck tale,16.9273178368,6.23983584333,0,2,2
ironpool,16.9273178368,6.23983584333,0,2,2
skywalkr000,16.9273178368,6.23983584333,0,2,2
fumofuu,16.9273178368,6.23983584333,0,2,2
rockin,16.9273178368,6.23983584333,0,2,2
huck,16.9273178368,6.23983584333,0,2,2
sloper,16.9273178368,6.23983584333,0,2,2
orion,16.9273178368,6.23983584333,0,2,2
justinbot,16.9273178368,6.23983584333,0,2,2
matt47,16.9273178368,6.23983584333,0,2,2
spirit,16.9273178368,6.23983584333,0,2,2
soft serve,16.9273178368,6.23983584333,0,2,2
rage,16.9273178368,6.23983584333,0,2,2
behappyu,16.9273178368,6.23983584333,0,2,2
$lik,16.9273178368,6.23983584333,0,2,2
james j,16.9273178368,6.23983584333,0,2,2
atm,16.9273178368,6.23983584333,0,2,2
itrez,16.9273178368,6.23983584333,0,2,2
rane,16.9273178368,6.23983584333,0,2,2
imdabes,16.9273178368,6.23983584333,0,2,2
vampire,16.9273178368,6.23983584333,0,2,2
bizzie smalls,16.9273178368,6.23983584333,0,2,2
mr. saturn,16.9273178368,6.23983584333,0,2,2
mom's   spaghetti,16.9273178368,6.23983584333,0,2,2
ramenator,16.9273178368,6.23983584333,0,2,2
krc_dub,16.9273178368,6.23983584333,0,2,2
rocktimus crime,16.9273178368,6.23983584333,0,2,2
daftzeppelin,16.9273178368,6.23983584333,0,2,2
thegordocat,16.9273178368,6.23983584333,0,2,2
hispanion,16.9273178368,6.23983584333,0,2,2
ricko chancho,16.9273178368,6.23983584333,0,2,2
atom,16.9273178368,6.23983584333,0,2,2
frio,16.9273178368,6.23983584333,0,2,2
nate$,16.9273178368,6.23983584333,0,2,2
iroga,16.9273178368,6.23983584333,0,2,2
swarley,16.9273178368,6.23983584333,0,2,2
pnis,16.9273178368,6.23983584333,0,2,2
sea,16.9273178368,6.23983584333,0,2,2
amadzebra,16.9273178368,6.23983584333,0,2,2
lovedelic,16.9273178368,6.23983584333,0,2,2
cru,16.9273178368,6.23983584333,0,2,2
linsanity,16.9273178368,6.23983584333,0,2,2
myk,16.9273178368,6.23983584333,0,2,2
bizon,16.9273178368,6.23983584333,0,2,2
glint,16.9273178368,6.23983584333,0,2,2
the brons kneecap,16.9273178368,6.23983584333,0,2,2
stuner323,16.9273178368,6.23983584333,0,2,2
missinglink,16.9273178368,6.23983584333,0,2,2
colin,16.9273178368,6.23983584333,0,2,2
atari,16.9273178368,6.23983584333,0,2,2
loonslaaf,16.9273178368,6.23983584333,0,2,2
hctaz,16.9273178368,6.23983584333,0,2,2
bugattimaster420,16.9273178368,6.23983584333,0,2,2
caerwyn_montale,16.9273178368,6.23983584333,0,2,2
proxy,16.9273178368,6.23983584333,0,2,2
the grouch,16.9273178368,6.23983584333,0,2,2
ajizl,16.9273178368,6.23983584333,0,2,2
moye,16.9273178368,6.23983584333,0,2,2
benguin,16.9273178368,6.23983584333,0,2,2
tyuip,16.9273178368,6.23983584333,0,2,2
ballz d33p,16.9273178368,6.23983584333,0,2,2
lusty,16.9273178368,6.23983584333,0,2,2
swagbag,16.9273178368,6.23983584333,0,2,2
ppdmd,16.9273178368,6.23983584333,0,2,2
fraudzilla,16.9273178368,6.23983584333,0,2,2
robobean,16.9273178368,6.23983584333,0,2,2
locuan,16.9273178368,6.23983584333,0,2,2
ollyeuph,16.9273178368,6.23983584333,0,2,2
bj,16.9273178368,6.23983584333,0,2,2
jbiz,16.9273178368,6.23983584333,0,2,2
kdat,16.9273178368,6.23983584333,0,2,2
mohummus,16.9273178368,6.23983584333,0,2,2
zombie adam,16.9273178368,6.23983584333,0,2,2
chippo,16.9273178368,6.23983584333,0,2,2
harrisondorf,16.9273178368,6.23983584333,0,2,2
sircitrus,16.9273178368,6.23983584333,0,2,2
cuffy,16.9273178368,6.23983584333,0,2,2
joshez,16.9273178368,6.23983584333,0,2,2
snowman,16.9273178368,6.23983584333,0,2,2
white,16.9273178368,6.23983584333,0,2,2
maltrez,16.9273178368,6.23983584333,0,2,2
dranyos,16.9273178368,6.23983584333,0,2,2
limit,16.9273178368,6.23983584333,0,2,2
scoundrel,16.9273178368,6.23983584333,0,2,2
moti,16.9273178368,6.23983584333,0,2,2
hyliancreation,16.9273178368,6.23983584333,0,2,2
sebs,16.9273178368,6.23983584333,0,2,2
the rock,16.9273178368,6.23983584333,0,2,2
jibb,16.9273178368,6.23983584333,0,2,2
zigludo,16.9273178368,6.23983584333,0,2,2
t-town,16.9273178368,6.23983584333,0,2,2
vaguba,16.9273178368,6.23983584333,0,2,2
magma,16.9273178368,6.23983584333,0,2,2
rapidrage,16.9273178368,6.23983584333,0,2,2
doggyness,16.9273178368,6.23983584333,0,2,2
yungmilford,16.9273178368,6.23983584333,0,2,2
yvng coolatta,16.9273178368,6.23983584333,0,2,2
fool94,16.9273178368,6.23983584333,0,2,2
nair,16.9273178368,6.23983584333,0,2,2
atomic,16.9273178368,6.23983584333,0,2,2
stupid yoshii,16.9273178368,6.23983584333,0,2,2
boty,16.9273178368,6.23983584333,0,2,2
mtown,16.9273178368,6.23983584333,0,2,2
enoch,16.9273178368,6.23983584333,0,2,2
jonpon,16.9273178368,6.23983584333,0,2,2
ellen degenerate,16.9273178368,6.23983584333,0,2,2
rubez,16.9273178368,6.23983584333,0,2,2
zorro,16.9273178368,6.23983584333,0,2,2
_dj_mana_,16.9273178368,6.23983584333,0,2,2
shasha,16.9273178368,6.23983584333,0,2,2
batista,16.9273178368,6.23983584333,0,2,2
raulwalrus,16.9273178368,6.23983584333,0,2,2
theeagle3805,16.9273178368,6.23983584333,0,2,2
v-bomber,16.9273178368,6.23983584333,0,2,2
spiderbubble,16.9273178368,6.23983584333,0,2,2
link master 3000,16.9273178368,6.23983584333,0,2,2
shas,16.9273178368,6.23983584333,0,2,2
shyboy,16.9273178368,6.23983584333,0,2,2
alpha-infinity,16.9273178368,6.23983584333,0,2,2
swordz,16.9273178368,6.23983584333,0,2,2
mackjeyers,16.9273178368,6.23983584333,0,2,2
the running banana,16.9273178368,6.23983584333,0,2,2
mlk$,16.9273178368,6.23983584333,0,2,2
kswz,16.9273178368,6.23983584333,0,2,2
vanillarin,16.9273178368,6.23983584333,0,2,2
garv,16.9273178368,6.23983584333,0,2,2
oam,16.9273178368,6.23983584333,0,2,2
korova,16.9273178368,6.23983584333,0,2,2
jeff,16.9273178368,6.23983584333,0,2,2
austyp,16.9273178368,6.23983584333,0,2,2
scebbles,16.9273178368,6.23983584333,0,2,2
yarfy,16.9273178368,6.23983584333,0,2,2
muse,16.9273178368,6.23983584333,0,2,2
gene parmesan,16.9273178368,6.23983584333,0,2,2
slumlord,16.9273178368,6.23983584333,0,2,2
weeb,16.9273178368,6.23983584333,0,2,2
tokaji,16.9273178368,6.23983584333,0,2,2
tipsytoto,16.9273178368,6.23983584333,0,2,2
peebah,16.9273178368,6.23983584333,0,2,2
dmwc,16.9273178368,6.23983584333,0,2,2
puke,16.9273178368,6.23983584333,0,2,2
tkyo,16.9273178368,6.23983584333,0,2,2
sandrin,16.9273178368,6.23983584333,0,2,2
redmist,16.9273178368,6.23983584333,0,2,2
kieu-tip,16.9273178368,6.23983584333,0,2,2
beverage,16.9273178368,6.23983584333,0,2,2
colinfly,16.9273178368,6.23983584333,0,2,2
8bitloser,16.9273178368,6.23983584333,0,2,2
thedqn,16.9273178368,6.23983584333,0,2,2
zeek,16.9273178368,6.23983584333,0,2,2
big l rest in peace,16.9273178368,6.23983584333,0,2,2
pixel beat,16.9252884292,5.81080729567,0,2,2
bozz,16.9202696122,6.20441701582,0,2,2
steez,16.9191944756,6.08283440987,0,2,2
eclipse,16.9164725232,6.21073257337,0,2,2
rjb,16.9158865809,5.92795384474,0,2,2
flangler,16.9143087683,5.84426291711,0,2,2
tet,16.9122380747,3.78603826232,1,7,8
pabsmonty,16.9116613976,4.43706172589,1,5,6
quote,16.9014262298,5.94626279057,0,2,2
mufasa,16.8976558043,5.92108377531,0,2,2
flanagandalf,16.8919625479,5.87652118122,0,2,2
dedleg,16.8910991583,6.0395362455,0,2,2
afmbot,16.8837395779,6.58700777392,0,1,1
cock,16.8825473127,5.80725502053,0,2,2
soupostrich,16.880007745,3.85666604348,2,6,8
rondelle,16.8783163407,5.99304959696,0,2,2
noelkitten,16.8752459001,6.50702681057,0,1,1
mrjewlittle,16.8738506194,5.91963984505,0,2,2
danbo,16.8707807904,4.42529117115,1,6,7
midnight marauder,16.8698915433,6.19125502497,0,2,2
vegeta,16.8597203627,5.72667652012,0,2,2
knox,16.8564551636,5.97287699504,0,2,2
sleepy,16.8561344339,5.8959853523,0,2,2
kalands,16.8542745678,6.19976487244,0,2,2
c-iv,16.8482278685,6.20123099918,0,2,2
fuzzman,16.8477327792,6.0050958069,0,2,2
tiger,16.8464842898,6.14465443246,0,3,3
mu9en,16.8417102394,6.01298310644,0,2,2
thrive,16.838514907,6.19764184878,0,2,2
–in–,16.8342471836,6.02954706804,0,2,2
roy the boy,16.8318265967,6.06406431453,0,3,3
tang it rell,16.8305618126,5.87341982272,0,2,2
wheep,16.8289997209,5.84316559214,0,2,2
meerkat,16.8277333231,3.92272877695,2,6,8
bk,16.827472666,2.86695380506,2,19,21
sjipz0r,16.8237206572,5.97715076155,0,2,2
crapple,16.8083961861,5.20780323944,1,2,3
vell,16.8040989027,5.92871522975,0,3,3
anchovy_pizza,16.8031105825,6.03878065737,0,2,2
elioto,16.8016934753,6.04519029543,0,2,2
darthdailey,16.8002840647,6.19184397556,0,2,2
kingkiller,16.7998061981,6.19262165924,0,2,2
sneazi,16.7960247165,5.61264831624,0,2,2
nick,16.7938545519,6.18755437852,0,2,2
leezy,16.7912347166,6.18958922823,0,2,2
doctor,16.7906373067,4.36553601365,1,5,6
laration,16.7866319715,4.91081672355,1,4,5
mtndewgong,16.7858364211,4.22207104265,1,5,6
bumpadump,16.7851557176,5.99282849848,0,2,2
free inui,16.7801172593,5.97867789085,0,2,2
prophet,16.7795780055,6.05082463133,0,2,2
j$,16.7779062137,6.11650392707,0,2,2
gooz,16.7710369657,4.43802200956,1,5,6
other jon,16.7631998801,6.03897715925,0,2,2
4sk,16.7572501814,6.06298534423,0,2,2
aml,16.7525353027,5.87146576768,0,3,3
wifl,16.7462525201,6.18108091455,0,2,2
discowinter,16.7445342628,6.17338892801,0,2,2
w1sh,16.7402420334,5.96922534236,0,2,2
she,16.7360947673,6.16735050736,0,2,2
handbanana,16.7343579858,5.97749989588,0,2,2
serbianfilm,16.7263710107,6.17384611341,0,2,2
eaglebloo,16.7251427818,6.1811949933,0,2,2
juhseppe,16.7232733046,5.8897007474,0,2,2
michael,16.7217807474,5.92260663923,0,2,2
private,16.7182173059,5.71324324177,0,2,2
skrai,16.7159286581,4.30723617886,1,4,5
johalter,16.714361625,5.89071535082,0,2,2
vanna black,16.7138213246,5.82455770725,0,3,3
the wizard,16.7096945075,6.17756141525,0,2,2
cloud,16.7068171994,6.0467536997,0,3,3
natalie,16.7040825116,5.94369565793,0,2,2
audie,16.7028281651,6.03891327819,0,2,2
starsoldier,16.7010055785,5.6498522159,0,2,2
flamo,16.6953690132,4.49588207268,1,6,7
joenut,16.6951627505,6.05141228926,0,2,2
nadamoor,16.6917879431,6.10900221246,0,2,2
jaquarium,16.6906240492,6.1798811211,0,2,2
sink-swim,16.6873629985,6.17661543306,0,2,2
uuuu,16.6759158387,6.15351432585,0,2,2
lucon,16.674138935,6.15463524211,0,2,2
beej,16.673880917,6.04028128069,0,2,2
kid sampson,16.6717059514,5.82346456883,0,2,2
ez money,16.6669268268,6.15763947069,0,2,2
raff,16.6665848588,6.17211642173,0,2,2
aquwas,16.6665848588,6.17211642173,0,2,2
windul,16.665883833,5.93993389391,0,2,2
double d,16.6630075881,6.16192094449,0,2,2
bao the wyld,16.6621135094,6.16999080881,0,2,2
rufio,16.6574734598,5.98278856261,0,2,2
satan [wagner],16.655855575,5.92024435213,0,2,2
dr. funke,16.6514367866,5.95677874694,0,2,2
d-money,16.6476712445,5.94679946976,0,2,2
jigg,16.6468239756,5.69423549616,0,2,2
.mov,16.6455460992,6.16375807795,0,2,2
boney,16.6444229793,5.83347723702,0,3,3
nrg,16.6440832032,6.16640907603,0,2,2
shanazz,16.6414286119,6.16275732972,0,2,2
blue ruin,16.638078503,5.95792108066,0,2,2
cadence,16.6375167295,4.34292394427,1,4,5
sheepdog,16.6358664281,6.16706992322,0,2,2
strouticus,16.6280031166,6.02920619085,0,2,2
bayless,16.6255573334,5.79694937157,0,2,2
rezz,16.6248008838,4.56950980304,1,5,6
sam the commentator,16.6232417679,5.9093245012,0,2,2
the chef,16.6181709013,5.84838677039,0,2,2
looney,16.6175138268,6.16245787909,0,2,2
indoaznboy,16.6152936448,5.54523318527,0,2,2
orana,16.6116285633,6.08045007664,0,2,2
spookmaster,16.6086577128,6.08210831385,0,2,2
cool,16.6078428707,6.15842539359,0,2,2
dr. dreidel,16.6073734609,6.1650118709,0,2,2
wumbology,16.6050324961,5.88301882027,0,2,2
jabloinks,16.6047692332,5.32780371443,0,4,4
zettaiterritory,16.6028658182,5.83935126202,0,2,2
fieryvale47,16.6019367024,4.75289366434,1,4,5
cartastikid,16.5931491848,5.73024176065,0,2,2
t_nils,16.5927716892,6.14391937665,0,2,2
el garz,16.5886008058,5.72680754648,0,2,2
ritz,16.5801295472,6.15005126747,0,2,2
poopy ass,16.571421068,5.96014962332,0,2,2
rez,16.5676368999,5.91277247814,0,2,2
4thwrldmrshl,16.5661062074,5.94973118379,0,2,2
the garbage man,16.5656149357,5.90993404805,0,2,2
pbj,16.5485599561,6.0018143924,0,2,2
shaggy,16.5470897002,4.46901797962,1,6,7
call_of_cow,16.5468163118,4.30210459869,1,6,7
nugz,16.5456379837,6.14586326276,0,2,2
snow,16.542816663,5.92153130068,0,3,3
#yp8cpyg2,16.5365153617,5.46080378108,0,4,4
speck,16.5312793618,4.54983051385,1,5,6
vurky,16.5305870338,4.46321065605,1,5,6
nordecai,16.5301871713,5.64735321298,0,2,2
depsyfer,16.5278990037,6.00987892236,0,2,2
kinglewi,16.5211786631,5.78425778551,0,2,2
starknight,16.5034494871,5.92257021298,0,2,2
2salty,16.5019032728,5.73500495988,0,2,2
ziptie,16.5004458902,5.66699560639,0,2,2
heat,16.4997169039,6.15010230217,0,2,2
50k!,16.4790249981,6.0041212614,0,2,2
dj tyro,16.4772775653,4.17044817809,1,5,6
supernac,16.472896184,6.14067428218,0,2,2
gnat,16.4618581376,5.91577817471,0,2,2
spacepigeon,16.4557527296,5.66752474516,0,2,2
babal,16.4541665045,5.90559559283,0,3,3
mikelangelo,16.4527383896,6.09700170926,0,2,2
chrism,16.4495310991,6.43563233312,0,1,1
s.k.a.n. the scrub,16.4440276642,5.74590121797,0,2,2
engdrew,16.4341611017,5.64479313487,0,2,2
omega,16.4322575323,4.12702353941,1,7,8
the_doug,16.4276483244,6.04195466971,0,2,2
safety1st,16.4259985414,5.99830107263,0,2,2
therealjustinbieber,16.4223938513,6.05718494988,0,2,2
henomura,16.4172780818,5.77362944331,0,3,3
torozan,16.4168242033,5.91004427219,0,2,2
~cp9~,16.4127344971,6.1395235136,0,2,2
sin_of_friday,16.4122248321,5.94726972085,0,2,2
puma,16.4109181933,5.77317736987,0,2,2
jandrw,16.4096246957,6.13871116238,0,2,2
djl,16.4077784517,6.14018249714,0,2,2
ink,16.398523879,5.80026088752,0,2,2
darklord,16.3949091009,5.86470278534,0,2,2
andirama,16.3940463611,6.13797533637,0,2,2
onehandbackhand,16.3895572311,3.52656787603,2,12,14
mermaid,16.3887898597,4.29006756499,1,5,6
dizcofunk,16.3854149234,4.14932719481,1,6,7
bakkestaffen,16.385111039,3.37243143162,2,11,13
zelgius,16.3835906082,4.51697813064,1,5,6
wirsun,16.3826340757,5.69669031229,0,3,3
derf,16.3820266214,6.12226970346,0,2,2
squeemos,16.3699953184,5.75820713866,0,2,2
kazin,16.3666364314,5.83805324165,0,2,2
aureate,16.3641610758,6.13224151431,0,2,2
seantos,16.3639934641,5.65716531325,0,2,2
mgod,16.3628159386,5.9871521771,0,2,2
irate,16.3602639174,6.13197601773,0,2,2
errl,16.3598438423,5.79691472213,0,2,2
adrian,16.3521644038,5.81151505039,0,2,2
samb,16.3482834096,6.13045187114,0,2,2
sirdunx,16.3477198111,5.99219267858,0,2,2
thesurfingpikachu,16.3450056178,4.50488258567,1,5,6
zinja,16.340089822,4.47992656997,1,4,5
jade,16.3397594719,5.85967955801,0,3,3
bourbonjr,16.3380519231,5.59238215849,0,2,2
majesticrhino,16.3371537901,5.84446675685,0,4,4
beerz4yearz,16.3359816485,5.85631504483,0,2,2
burnyay,16.3356014236,5.82948096927,0,3,3
m3che,16.3328173438,6.12867153367,0,2,2
fry,16.3325350506,5.41906778482,0,4,4
zbomber,16.3212343108,5.9836199763,0,2,2
witness,16.3207704181,4.4562004594,1,4,5
the legendary food,16.318564602,4.24563678044,1,6,7
rstevoa,16.3128240861,6.12572416987,0,2,2
redlime,16.3070254915,4.42813717784,1,6,7
lein,16.2997598025,6.40149966237,0,1,1
void axium,16.2996883569,5.94434943438,0,2,2
murrkin,16.2972585307,5.84137357547,0,2,2
420bonglord,16.2900826211,5.83704544003,0,2,2
cat,16.2886021007,3.84290805682,1,8,9
daifuku,16.2877429693,5.48285548874,0,3,3
bangs,16.2864611864,5.97126459697,0,2,2
jeffy,16.2828540868,5.59257076748,0,4,4
cowboy dan,16.2793522885,5.89205876342,0,2,2
mastermike,16.2775749377,5.73896653292,0,2,2
amae,16.2749472728,3.39808014906,2,10,12
wade lightman,16.2747662426,5.97552399064,0,2,2
batteriez,16.2744093685,5.94921150205,0,2,2
marc,16.2696940722,5.58775203631,0,2,2
spektatr,16.2666749678,5.79713608087,0,2,2
dcj,16.2568826844,5.57756476377,0,4,4
digboss,16.2474446202,3.96563995851,2,6,8
radjazz,16.2459197996,5.95563979365,0,2,2
notos,16.2435605868,5.82809051688,0,2,2
theytah,16.2353161507,5.80222559962,0,3,3
mr.mimetime,16.2353161507,5.80222559962,0,3,3
ganreizu,16.2309774077,6.10924612721,0,2,2
markyeet,16.2171310912,5.47756806571,0,2,2
equin0x,16.2114390632,5.78311633647,0,2,2
tex-mex,16.2104472159,6.05611456299,0,2,2
jellyman64,16.2029096281,5.80279721805,0,2,2
nattty,16.1994042655,5.97387723692,0,2,2
sapphire,16.1938089325,4.2165264352,1,6,7
sergeanthendog99,16.190223265,6.10752791721,0,2,2
dooi,16.1876453037,4.16567526693,1,6,7
masterbazaar,16.1852128912,3.96393449631,1,9,10
the fractal effect,16.182539686,5.96264430624,0,2,2
luffy,16.1784180763,5.94643317222,0,2,2
bobbyxm,16.1731233973,5.39033659894,0,3,3
osp975,16.1726282529,6.06992088167,0,2,2
lsupersonicq,16.1719034851,5.94651463263,0,2,2
nonk,16.1659233708,5.81997427285,0,2,2
a',16.1536723573,4.28339573752,1,5,6
smashphantom,16.1490390384,6.07822889123,0,2,2
arch,16.1461231229,5.93534624891,0,2,2
exvertus,16.1454391681,6.0815682245,0,2,2
brandowonder,16.1335659622,5.92193867767,0,2,2
fartrell cluggins,16.132770958,5.93507980898,0,2,2
skulltown,16.1319884828,5.88637855863,0,2,2
kadroh,16.1170542844,5.60685117294,0,2,2
gyro,16.1149267991,5.85445099657,0,2,2
izy,16.1129987813,5.74679955176,0,5,5
doofalo,16.1100626427,5.95261589599,0,2,2
z,16.1097644648,4.53281648173,1,4,5
ranger mike,16.1042254313,5.06287527526,0,6,6
lude,16.102374871,5.7571634788,0,2,2
seniorblopi,16.1013065027,5.91050659764,0,2,2
neat,16.0988028544,5.94091294376,0,2,2
rayboyp,16.094088435,5.6496568811,0,3,3
pewpew2,16.0926207002,5.73543220254,0,3,3
hoz,16.0859474264,5.80121973313,0,2,2
dounan,16.0834460497,5.93249486442,0,2,2
robbo,16.0816457377,5.93300009423,0,2,2
bump,16.0710537217,5.23649629041,0,3,3
ssj2luigi,16.069647498,6.00366846056,0,2,2
sleeper,16.0684578909,6.10322156244,0,2,2
post,16.0684578909,6.10322156244,0,2,2
lightsoul,16.0628324137,5.63268202494,0,3,3
lempo,16.0598004197,5.85133131306,0,2,2
zeezy,16.0578777632,4.49909425978,1,5,6
laine,16.0563540152,5.37391400912,0,4,4
charmander360noscope,16.0518657678,6.08397338035,0,2,2
venick,16.0494401023,6.19764974264,0,2,2
ex,16.0410545599,4.30191031403,1,5,6
mre,16.0345209235,6.06921998022,0,2,2
fuzyll,16.0263170171,5.95067761269,0,2,2
shinsuyavi,16.0248240927,5.42048481787,0,4,4
vench,16.0110038861,5.91557214664,0,2,2
freeman,16.0083785952,5.69295080646,0,2,2
bun$,15.9924988785,5.77147057299,0,3,3
incronaut,15.9921423175,5.78912926383,0,2,2
jessi snow,15.9841498819,6.06855864167,0,2,2
abigajillion,15.9747916914,5.63700759824,0,4,4
ciker,15.9731253797,5.54527155251,0,4,4
qbaby,15.961414838,5.94061886435,0,2,2
ghost [jackson],15.9540679883,5.88786710905,0,2,2
fenrir,15.9524404871,3.89359726906,1,7,8
lydian,15.9510172159,6.0711750733,0,2,2
asinistertaco,15.9509037348,5.49281898151,0,2,2
vitamin,15.9499474399,5.90885737339,0,2,2
shi-no,15.9484790409,6.01905191371,0,2,2
anonymous-limbo,15.9478941762,5.90723676652,0,2,2
tagless lauren,15.9477025162,5.77448042697,0,3,3
blenderer,15.9475986612,6.0853149484,0,2,2
pearson,15.9416644972,5.7254752864,0,2,2
gylk,15.9356366384,6.08385421162,0,2,2
immawhite,15.9350728806,6.08596093828,0,2,2
ciggas,15.9220239497,6.05141621013,0,2,2
touch tank,15.9170323368,5.88843515771,0,2,2
krookk,15.9125233878,5.43685750984,0,4,4
brothabebz,15.9120322266,6.06173309259,0,2,2
orchard,15.9091710992,5.6167507468,0,3,3
reker,15.9073414439,5.90885954172,0,2,2
v6,15.8954561105,5.89021555532,0,2,2
acecraze,15.8920695199,5.71675577548,0,2,2
tripledeckerpbj,15.8899488893,5.64053251036,0,4,4
psd,15.8869727109,5.49932758252,0,2,2
rabbitalex,15.8786454512,5.8414915942,0,2,2
haettis,15.8660659339,4.10610896585,1,6,7
bluepartyhat,15.8535346294,5.85098296088,0,3,3
crag,15.8460831426,5.59636916933,0,2,2
ejg,15.8423332175,5.82873652364,0,2,2
baku,15.8384864929,5.76527884998,0,2,2
hb,15.8370936414,5.74959813537,0,4,4
vaccine,15.8340931321,5.78455173693,0,2,2
zerqui,15.8240948151,5.8490520815,0,2,2
stone free,15.8240948151,5.8490520815,0,2,2
gaijilla,15.8240140225,5.37981587588,0,4,4
emceecurtis,15.8135023574,3.98376317013,1,9,10
tabasco,15.8116540458,4.14905853674,1,6,7
coupon collector,15.7994006989,5.98444230057,0,2,2
maverlck21,15.7992711566,5.88159021842,0,3,3
ghoul,15.7964706157,4.50546047264,1,6,7
fan,15.7956244146,5.23708582827,0,4,4
presentiment,15.7909713003,5.89780632572,0,2,2
geodude,15.7900158163,5.13219522597,0,4,4
sean barker,15.7886113318,5.86212644565,0,2,2
xlvr,15.7844202386,5.63710369941,0,4,4
lispy,15.781915073,5.53910031378,0,2,2
dazzle,15.7813953357,5.88019477068,0,2,2
@ndtryce,15.7793831421,3.78462927732,1,8,9
xenjih,15.7755663057,4.24320755327,1,5,6
makko_slade,15.7728132353,5.78744695157,0,2,2
gopu,15.7725678747,5.63263588164,0,4,4
mr.squiggles,15.7655253308,6.02692266782,0,2,2
perciprius,15.7646986181,5.79148183892,0,2,2
asianweirdo,15.7573668995,5.55017848578,0,4,4
krythan,15.7540334748,5.8589903952,0,2,2
paquito,15.7478401263,5.89816873962,0,2,2
improv,15.7473379471,5.86392231871,0,2,2
soma,15.7393198394,6.04238329121,0,2,2
daffle,15.737403743,5.92962423877,0,2,2
rossu,15.7361675726,5.74977255705,0,2,2
shucklin,15.7335819009,4.20621639261,1,7,8
juicymoose,15.7207877702,5.92387781301,0,2,2
the_sir_reginald,15.7194996046,6.00411786726,0,2,2
c0sm1x,15.7187976851,4.04766344344,1,6,7
burke092,15.7174921503,6.02975367175,0,2,2
peon,15.7084465053,5.09942093382,0,4,4
b minus,15.7029578196,5.88240855886,0,2,2
rossmpossm,15.7024935117,6.04194405763,0,2,2
elis,15.698047444,5.98738992411,0,2,2
haiducn,15.6935971681,4.10216079649,1,4,5
hadoush,15.6926177853,5.23936468511,0,4,4
marusudt,15.6858710858,5.8184692839,0,3,3
absynthe,15.683755406,5.66050796905,0,2,2
melvenorc12,15.6816089472,5.6549134581,0,3,3
medusa,15.6759265618,4.33455186192,1,7,8
missesmccloud,15.6745076658,6.00176272524,0,2,2
tx toast,15.6667902271,5.8830782915,0,2,2
mental,15.6665970245,4.29964051275,1,6,7
holosly,15.6631710305,5.66777975732,0,2,2
lordjosh2,15.6505916389,5.73785050363,0,2,2
deaf_intheleft,15.6486757157,5.85688907349,0,2,2
rickpicks,15.6455512464,5.55574443938,0,4,4
edge!,15.6434396278,6.10187713238,0,2,2
wrdstang,15.6365122426,5.73097766844,0,2,2
humus,15.592484446,6.00178233636,0,2,2
devilgamer,15.5907931065,4.06299306881,1,6,7
dadrizzler,15.5880541026,5.68867187464,0,2,2
rozrus,15.5707578907,5.83665306895,0,2,2
yata,15.56854778,5.81641464403,0,2,2
xu,15.5534990517,5.53270870061,0,4,4
milk monster,15.5476757937,5.85687345419,0,2,2
lee,15.544629615,4.54322098466,1,4,5
pirate,15.5428988377,5.99568504368,0,2,2
algel,15.5372428277,5.54351516874,0,2,2
true blue,15.5315204349,4.20076572436,1,5,6
bach,15.5267661612,4.20845505551,1,6,7
zerkris,15.52287092,5.747400456,0,2,2
inflatablethor,15.5170127886,5.79479444882,0,2,2
smba,15.5143950307,4.20953330316,1,6,7
nurse,15.5135241185,5.69574317707,0,2,2
tortuga milk,15.506507563,5.72110908815,0,2,2
trip,15.4976756743,5.36856860768,0,5,5
crimson,15.493260418,5.96225146442,0,2,2
pratmire,15.4788017374,5.72761700914,0,2,2
cortez,15.4666494848,5.76326445837,0,2,2
kutskoo,15.4649559145,5.97511791273,0,2,2
digdug,15.464551963,5.83994801143,0,2,2
pawn,15.461880013,3.76351790717,1,8,9
lonbach,15.4596903777,5.07218776639,0,6,6
choochoo,15.4364216567,4.29587268976,1,6,7
missingn0,15.43253739,5.95210719318,0,2,2
barrage,15.4221505259,5.82914938194,0,2,2
agouti,15.4215623239,5.61274123486,0,2,2
bobo,15.4091338748,3.87062947761,1,8,9
azula,15.4054234617,5.5726477718,0,2,2
tomp,15.4017406591,5.53435244795,0,4,4
batch,15.398770715,4.15669089303,1,6,7
scrublord,15.3946293538,5.58709056597,0,4,4
s-j,15.3909759398,5.71568064834,0,2,2
kitsuni,15.3906589861,5.46464206163,0,4,4
sun$,15.3881942723,5.0708200489,0,4,4
dyldobaggins,15.3794223022,5.9813216813,0,2,2
spitzlee,15.3741721959,5.77840195747,0,2,2
dannx,15.3727990365,5.75676195623,0,3,3
crabby,15.3676562084,5.95276411714,0,2,2
riseup93,15.3655040181,5.69479836565,0,2,2
phlops,15.3601170905,5.95485803403,0,2,2
jake97,15.3595041645,6.02087397493,0,2,2
actualgamerowned,15.3564672756,5.77522008515,0,2,2
2uq22c9u,15.3481812668,4.35740213478,1,4,5
kandyman,15.3459729216,5.86172338775,0,2,2
mistake,15.3446492288,5.58340067722,0,3,3
shinyralts,15.3385489859,5.95082851465,0,2,2
wixoz,15.3369974007,5.57172153579,0,4,4
kambos,15.3322448802,5.9310626635,0,2,2
italian stallion,15.3248211678,3.05260612403,2,11,13
draxsel,15.3170199912,5.95389933324,0,2,2
arexx,15.3098937785,5.94905531551,0,2,2
guru,15.304883609,5.67318256908,0,3,3
mort,15.3033679731,5.70596334819,0,4,4
mineshaft798,15.3029313749,6.01071567819,0,2,2
grizzlee,15.2705950537,5.71393144641,0,2,2
moonpuncher,15.2561394702,5.80651152302,0,2,2
squallette,15.2550973867,5.59919962373,0,4,4
wellpebbles,15.2489363417,5.24098957245,0,4,4
gkred,15.2469046224,5.90938202376,0,2,2
porpoise [gill],15.2411870583,5.9430294876,0,2,2
smalleoz,15.2381091067,4.1064248286,1,6,7
swerliie,15.2351071606,5.81633324173,0,2,2
tundra,15.233227272,5.28462330834,0,4,4
ilikeswamperts,15.2301071931,5.57901963,0,4,4
dankpank,15.2299510177,5.39837533122,0,4,4
thinking man,15.2253565092,5.48772955625,0,4,4
turkish delight,15.2173355773,4.85885870967,0,4,4
kjs,15.2168163001,5.79756511925,0,2,2
big brother,15.2083203697,5.2820808632,0,4,4
kush,15.2048904463,5.33541196434,0,4,4
day,15.199098529,5.57527220302,0,4,4
krus,15.1915354865,3.92842514049,1,7,8
asgtwe,15.1854432934,5.15837976794,0,5,5
ocelot,15.184884845,5.93740525949,0,2,2
tuck,15.1739825097,5.35098944242,0,4,4
jedisalazar,15.170137102,6.25415400604,0,1,1
rubberdougy,15.1690572461,5.43212128778,0,4,4
michael shorten,15.1383643862,5.85108982814,0,2,2
socalgohan,15.1222023182,5.94154968932,0,2,2
025,15.115537955,5.93072884891,0,2,2
pandaken,15.115537955,5.93072884891,0,2,2
xariot,15.115537955,5.93072884891,0,2,2
claymore,15.115537955,5.93072884891,0,2,2
lefty,15.115537955,5.93072884891,0,2,2
goldenpants,15.115537955,5.93072884891,0,2,2
echone,15.115537955,5.93072884891,0,2,2
smb,15.115537955,5.93072884891,0,2,2
ynot4k,15.1149737709,5.95478501062,0,2,2
flash,15.1085792518,5.57295024125,0,4,4
ad8,15.0883680475,3.06601177677,2,17,19
double0simon,15.0868197661,5.36814285105,0,4,4
grey,15.0846691042,5.76245826212,0,2,2
arcana,15.0700492625,5.42716606914,0,4,4
queso,15.0697059355,5.93598779639,0,2,2
leffen's visa,15.0527973597,5.67774967921,0,2,2
by_tor,15.0458826127,5.79485066321,0,2,2
fudgeface,15.0388247333,3.91509688543,1,8,9
kennel,15.0275451672,3.80832730928,1,7,8
bunk,15.0170999544,5.3260674241,0,4,4
henke,15.016390174,4.09520940832,1,6,7
crucialtoast8,15.0111042441,4.34650096575,1,5,6
deku_scrub,15.001837992,5.93672378255,0,2,2
tomago,14.9752692047,3.14991616858,2,15,17
gouda,14.9745842404,5.88894577204,0,2,2
alucard,14.9673566983,5.17113098096,0,4,4
bleem,14.9612986149,5.89399271417,0,2,2
genericgamer,14.957629214,5.84861453335,0,2,2
chuman,14.9292014862,5.09424979686,0,6,6
spry,14.9187265216,5.48017632926,0,4,4
kz,14.9181702244,3.5523001964,1,10,11
prozac,14.9141099288,5.88570312741,0,2,2
youngwolf97,14.8946373428,5.76545858363,0,2,2
kneel,14.8912938956,5.38833882984,0,4,4
slyben,14.8890888859,5.18050227744,0,4,4
namaste,14.882830234,5.88606940011,0,2,2
pinkieoats,14.8803218332,5.92432493665,0,2,2
butler,14.8627881068,4.01068599012,1,8,9
addict,14.8518398286,5.10901931764,0,4,4
disco wolf,14.8482286908,5.86793281027,0,2,2
maspect,14.8445110412,5.13673708134,0,4,4
goblin,14.842682196,5.27488187023,0,4,4
john_117,14.8331456257,5.74801151532,0,2,2
little bill,14.8099293854,5.87816555539,0,2,2
hiro,14.8087837444,5.91783466313,0,2,2
vheri,14.8087837444,5.91783466313,0,2,2
umeki,14.8087837444,5.91783466313,0,2,2
dps1,14.807942898,5.42569413526,0,4,4
tropicalsk,14.793431375,5.47225923679,0,4,4
buhlaine,14.7903143688,5.47455924823,0,4,4
bob thunder,14.7715843706,5.31433352871,0,4,4
mr. thee,14.739221601,5.29047475445,0,4,4
salz,14.7343446673,5.39912337161,0,4,4
vishy,14.7333817464,5.73888734753,0,2,2
sir.squanch,14.7303026557,5.72609739157,0,2,2
froge,14.7083557931,5.49450719264,0,4,4
camtwo,14.7006119946,5.3720350835,0,4,4
smile,14.6935019007,5.75878347391,0,2,2
cupnoodlez,14.690074371,5.63724654291,0,2,2
kampy,14.6835910174,5.44546687672,0,4,4
bojo,14.6791214852,5.39925822,0,4,4
onenightstanz,14.6773083612,5.2442827275,0,4,4
luna,14.6721989471,3.95393001494,1,8,9
stormcloud,14.6583281895,5.06561512423,0,4,4
khan71,14.652869564,5.62879289951,0,2,2
awkward,14.6368838959,5.28013921751,0,3,3
parkachu0,14.6305867845,5.27536226628,0,4,4
bicycle,14.6163796069,5.49431319433,0,4,4
hamalak,14.6093080246,4.64214117622,0,5,5
halo,14.6027282496,5.85413134677,0,2,2
landry,14.5914701691,5.39072227277,0,4,4
derek,14.5769033271,5.27578041965,0,4,4
federade,14.5651446572,5.46101349166,0,4,4
pibb,14.5586025967,4.84947833563,0,6,6
ninja,14.5483278381,5.77314970736,0,2,2
aquachu,14.5374363086,5.11200130232,0,4,4
filthy,14.5353405549,5.82527949955,0,2,2
macdougall,14.5277000707,5.83365268523,0,2,2
johnknight1,14.5227051607,5.59317406023,0,3,3
ghost_missingno,14.501260535,5.61142512694,0,2,2
iso,14.5011139115,3.80812769404,1,5,6
l3375,14.4897683125,5.04975645238,0,4,4
k1lllaag,14.4710049674,5.41659403149,0,2,2
rawdog,14.4700454026,5.83999572745,0,2,2
mrx,14.4646959547,5.89125763445,0,2,2
charlie harper,14.4458284627,5.37156501497,0,4,4
cheetos,14.4388364794,5.43973799849,0,4,4
losviken,14.4222601285,3.13798529741,3,10,13
varia_gamre,14.4190548986,5.44918860321,0,4,4
zachimon,14.4167223308,5.20407447544,0,4,4
fira n ice,14.4131091261,5.4438342709,0,4,4
themerman,14.4058050282,5.28746413914,0,4,4
racko,14.3922792789,5.77097527467,0,2,2
djnour,14.3918294325,5.43018370738,0,4,4
nofluxes,14.3791684671,4.35674358733,0,7,7
torm,14.3564271188,4.83000330195,0,5,5
allkizz,14.3552087452,5.1756259913,0,6,6
jonan,14.3494169314,5.80244526121,0,2,2
svenne,14.3243828714,5.31738294643,0,4,4
marteeen,14.3219428277,4.85057814215,0,6,6
oblomkov,14.3063078489,5.75694777799,0,2,2
rada,14.3045984558,5.14933289437,0,5,5
electric soldier,14.2884637352,5.371606661,0,4,4
czelt,14.2664467095,5.81088327929,0,2,2
peredido,14.2522845465,5.09156250913,0,4,4
worm,14.2402687917,2.58560283265,2,18,20
smish,14.2391316855,5.41342056246,0,4,4
sirreal,14.2321442205,5.29796278742,0,4,4
carai,14.2145810736,5.16330089456,0,4,4
wreckening,14.2117042944,5.18198875665,0,4,4
red squirrel,14.2083138646,4.00263188839,0,11,11
espio,14.2071496093,5.76347317504,0,2,2
sonachan,14.1985695864,5.21307092401,0,4,4
thehazman00,14.1982909961,5.47700161375,0,2,2
deckerstag,14.1847606122,5.84738858343,0,2,2
jucotastic,14.1731815404,5.10013969321,0,4,4
moggle,14.1650807716,3.95476528154,1,7,8
ghost of harambe,14.1637370695,5.71412628014,0,2,2
tweli,14.1608381839,5.73247260127,0,2,2
serenade,14.1366752756,5.32449214756,0,4,4
etmiv,14.1222592406,5.18076534763,0,4,4
weeee,14.1216773635,4.93192414439,0,4,4
saber,14.1019652977,5.02101545251,0,4,4
rävx,14.0989870243,5.19725657388,0,5,5
mommy,14.0829465435,4.05784700998,1,8,9
yahara,14.0622431451,5.09249029637,0,4,4
versaggi,14.0590732751,5.81359674914,0,2,2
dr. girlfriend,14.0582169925,5.26046023371,0,4,4
jv4lf,14.0556408403,5.77577892831,0,2,2
xen,14.0392993923,5.23208302778,0,4,4
austin,14.0312593841,5.35972224576,0,2,2
sam,14.0028188532,5.37642944668,0,4,4
bobman,14.0008455334,5.67988849151,0,2,2
deff,13.9911989305,5.09264829362,0,6,6
av1n,13.9883542844,5.21906058717,0,4,4
#chultzmack,13.9804935653,5.07551066666,0,4,4
ch0k0 nach0,13.9761286122,5.05532977243,0,4,4
eat it,13.9628147672,5.12990875945,0,4,4
dinkles,13.9586439622,5.2208439669,0,4,4
slowbro,13.9378066436,5.46051542621,0,2,2
ppsd,13.9222215542,2.97247017183,2,20,22
hyhy,13.9169120967,5.11147843634,0,5,5
skittlez,13.9157482655,5.3011105311,0,4,4
smoke,13.9022819443,5.04640424058,0,4,4
raver,13.899767219,5.70097209948,0,2,2
motive,13.8963070921,5.45540670024,0,3,3
squidkid,13.878006797,5.69310986352,0,2,2
wzrd,13.8746213416,5.74825943757,0,2,2
ebd,13.868893432,5.06329619678,0,5,5
silver_yy,13.8492320002,5.15135897424,0,4,4
wave,13.8218983311,5.49101245743,0,3,3
cha0s,13.8158471181,4.97491401558,0,6,6
hayzze,13.8053792391,5.5304405187,0,2,2
bolder,13.7924552945,5.60865034047,0,3,3
parts,13.7844624835,5.70409108388,0,2,2
fp9,13.7793103268,4.39094323963,0,6,6
ulf,13.769992386,4.93921676089,0,4,4
weirdrikka,13.7501164744,5.00350892518,0,6,6
phazeshift,13.7415363069,5.14647926252,0,4,4
drewgs,13.7368118013,3.95249682758,1,10,11
oops,13.7307531159,5.22230248733,0,4,4
hitomi j puff,13.7219489008,5.35583710384,0,4,4
doublec,13.7219489008,5.35583710384,0,4,4
master j.j.,13.7219489008,5.35583710384,0,4,4
pinch,13.7099436358,6.09852784842,0,2,2
tanking,13.69574552,4.77953850931,0,5,5
youmakeussick,13.6938828268,4.92243754255,0,4,4
stopthevok,13.6919817969,5.47003320958,0,3,3
ntf,13.6782978515,5.17501188418,0,5,5
grif,13.6707727971,5.05446590337,0,4,4
visuals,13.6672707353,5.68649521405,0,2,2
commantis,13.6232084937,5.41948348782,0,2,2
kevino,13.5949115404,5.29472890997,0,4,4
jimmynojohns,13.5578708556,4.93655793343,0,4,4
elliotxspeedruns,13.5547556352,3.95163973613,0,12,12
xanax,13.5312738992,5.22040501392,0,4,4
shank,13.5161471994,3.70422690854,1,12,13
porksoda,13.4863117621,4.48088205566,0,7,7
amaranthx,13.4713408623,5.35030447221,0,4,4
urist,13.469213713,5.08421618999,0,4,4
captain puff,13.4681276446,5.06120457353,0,4,4
rektangles,13.45646151,5.02424396454,0,6,6
crazycookie,13.4432423543,5.17589349095,0,5,5
deefly,13.4406790157,4.04346097239,1,6,7
vaatu,13.439238792,4.85495579641,0,6,6
beastly,13.4304662955,5.29788124947,0,4,4
stark,13.4291019821,5.18554214471,0,4,4
monsoon,13.4130414756,5.28281857499,0,4,4
vlanitak,13.4015831531,4.56892200716,0,7,7
phazermuffin,13.389587689,4.92279702974,0,6,6
n00b64,13.3722357012,4.70400181155,0,6,6
bustr,13.3638630973,4.43326399702,0,6,6
kennyc,13.3374267116,4.80472631001,0,6,6
sp3tsnaz,13.2900834738,5.73347711697,0,2,2
ferg,13.2832202062,5.35010442555,0,4,4
yimo,13.279950482,4.36660784878,1,4,5
darentei,13.2302074471,4.74209634637,0,6,6
holz!,13.2297351935,4.89645424396,0,5,5
chuck lubs,13.1805449866,4.89579077134,0,5,5
sputnik,13.1511147738,4.08642173884,0,11,11
appel,13.1430528828,3.63256073483,1,14,15
isifys,13.1034863164,4.37288746335,0,6,6
zantpowa,13.066505002,4.82130559337,0,7,7
bag of beetles,13.0626734733,5.20571821152,0,4,4
food,13.05010969,3.66693291325,1,8,9
zooka,13.0445561193,5.13522242195,0,4,4
avatar jillian,13.0387218462,4.89907530631,0,5,5
nomickok,13.0387218462,4.89907530631,0,5,5
shredflintstone,13.0235270904,5.3535041508,0,2,2
xane,12.9984370201,5.14576882971,0,4,4
whooie,12.97780362,4.85307391323,0,6,6
fluffmaestro,12.9421762392,4.16764910136,0,7,7
wulf,12.9238664446,4.25880147283,0,7,7
bjt,12.9169715705,5.02710151566,0,5,5
kexmannen,12.9169715705,5.02710151566,0,5,5
cfive,12.9169715705,5.02710151566,0,5,5
whidah,12.9169715705,5.02710151566,0,5,5
sennebogen,12.9169715705,5.02710151566,0,5,5
garbage can,12.9120193415,4.6736364171,0,6,6
linney,12.9003742072,4.81515594771,0,6,6
random,12.8841352611,4.8858844969,0,6,6
onesun,12.8818140174,5.48733965733,0,2,2
mrflibble,12.8714979268,5.05206545444,0,5,5
jeezy,12.8636728297,4.69580908733,0,6,6
murcaz,12.8341321339,4.61368324302,0,7,7
gk_,12.8332873256,4.83272776502,0,5,5
tp the destroyer,12.8316395114,4.75173570451,0,6,6
mr. toothbrush,12.8161322505,5.00230241268,0,6,6
sofa king,12.8063551379,5.10863907024,0,4,4
ultrabob,12.7374953625,5.20258298912,0,4,4
strawhatter,12.6927867076,4.9270734922,0,5,5
sophie the warrior,12.6927867076,4.9270734922,0,5,5
bloodwhale,12.6927867076,4.9270734922,0,5,5
sacred panda,12.6598712811,4.77539804937,0,6,6
satan,12.6274491825,5.15189100509,0,4,4
flyguy,12.6042117822,4.68027570266,0,6,6
boneless,12.49954718,4.67669731196,0,5,5
y3fffrsn,12.4893372031,4.85974614593,0,6,6
terrorcheese,12.4843489042,4.62977635179,0,7,7
bandit,12.4750307642,4.87586683248,0,6,6
royeric,12.4719254838,3.46171638872,1,10,11
proxer,12.4617780715,4.4195404194,0,7,7
jm,12.4414980658,4.59211916791,0,8,8
ahar,12.4361565859,4.44928482311,0,6,6
vetikke,12.4019214297,4.60369486635,0,6,6
ken allen tang,12.3790261622,4.73056336313,0,6,6
tharixer,12.326732154,4.79297957726,0,6,6
skeleton_inside_me,12.2635936318,4.67936996124,0,6,6
grieve,12.2628625741,4.21423233576,0,8,8
prohibition,12.2550239936,4.73506799764,0,7,7
ox,12.2417384041,2.87670335009,2,19,21
tagless,12.2105427173,5.18341154413,0,4,4
plums jr,12.2094207181,4.24144613247,0,9,9
sunwalker,12.1865626813,4.49874328736,0,8,8
raven,12.186380048,4.61737063718,0,7,7
20fu,12.1602964149,4.63954231616,0,6,6
starryskye,12.1565262943,4.50331260863,0,6,6
siggen,12.1439197488,4.64272850271,0,6,6
suitymcgee,12.1128415041,4.65783876376,0,6,6
#8cjvulro,12.1085565498,5.33998318842,0,4,4
bab,12.073510845,4.42664984467,0,7,7
yellow,12.0247121776,4.20042082745,0,7,7
yung funk,12.00577071,4.53876180984,0,7,7
radio,11.9997952528,4.55003729505,0,6,6
port,11.9942959755,4.6376914822,0,6,6
sloppy banana,11.9609141895,4.57584935787,0,6,6
lunetc,11.9598833949,3.96297981347,0,11,11
mumb1e,11.8917614519,4.51517147601,0,7,7
smithstonian,11.885209324,4.18775564303,0,11,11
taotau,11.8281707581,4.64234490477,0,6,6
snafu,11.8101318504,4.42258887889,0,7,7
samio25,11.7942951041,4.61180331911,0,6,6
wade,11.7907885079,4.46520984865,0,7,7
horse,11.7584888991,4.48767114671,0,7,7
risu,11.7185070527,3.02685899796,2,18,20
avr,11.7135539323,4.65494914136,0,5,5
rosilius,11.7069528984,5.05034471908,0,4,4
hurr,11.6231158886,4.04172925253,0,7,7
dethasarus rex,11.4721704586,4.36853005422,0,7,7
bear,11.4095095929,4.66547334226,0,6,6
philyo,11.3157833601,4.63188856911,0,7,7
rogue,11.2783246675,4.47736061755,0,8,8
spoopy,11.0800754658,4.45527525035,0,10,10
tophatpat,11.0592837597,4.534776771,0,6,6
rolflife,11.0146166017,4.38286743601,0,7,7
blakesterr,10.8527077023,4.37327505068,0,8,8
slothic,10.8062005359,4.48287855198,0,7,7
flims,10.6475204089,4.1336925382,0,7,7
chelly,10.2264291807,3.10712889889,1,18,19
shulkman,9.90977679045,4.33027615795,0,6,6
vikong,9.78255237383,4.24016671463,0,7,7
